orderId,strategyRunId,symbol,orderType,openTime,closeTime,openPrice,closePrice,size,profit,balance,closeType,comment,sl,tp,swap,commission
10_221101007_B,165,EURUSD,Sell,2015-01-20 18:00:00,2015-01-21 00:00:00,1.15684,1.15504,0.1,18,10018,Exit After X Bars,,None,None,None,None
1000_221101007_B,165,EURUSD,Buy,2020-07-17 17:00:00,2020-07-17 17:00:00,1.14417,1.14217,0.1,-20,10736.6,SL,,None,None,None,None
1002_221101007_B,165,EURUSD,Buy,2020-07-23 17:00:00,2020-07-23 20:00:00,1.16013,1.16074,0.1,6.1,10742.7,TrailingStop,,None,None,None,None
1004_221101007_B,165,EURUSD,Buy,2020-07-30 16:00:00,2020-07-30 17:00:00,1.18061,1.17861,0.1,-20,10722.7,SL,,None,None,None,None
101_221101007_B,165,EURUSD,Sell,2015-08-04 20:00:00,2015-08-05 02:00:00,1.09324,1.08913,0.1,41.1,10219.5,Exit After X Bars,,None,None,None,None
1012_221101007_B,165,EURUSD,Sell,2020-08-21 11:00:00,2020-08-21 15:00:00,1.18019,1.17914,0.1,10.5,10733.2,TrailingStop,,None,None,None,None
1016_221101007_B,165,EURUSD,Sell,2020-08-26 14:00:00,2020-08-26 16:00:00,1.17962,1.18053,0.1,-9.1,10724.1,TrailingStop,,None,None,None,None
1018_221101007_B,165,EURUSD,Sell,2020-08-27 17:00:00,2020-08-27 18:00:00,1.17721,1.17921,0.1,-20,10704.1,SL,,None,None,None,None
1022_221101007_B,165,EURUSD,Sell,2020-09-04 16:00:00,2020-09-04 18:00:00,1.18016,1.18141,0.1,-12.5,10691.6,TrailingStop,,None,None,None,None
1024_221101007_B,165,EURUSD,Sell,2020-09-15 17:00:00,2020-09-15 23:00:00,1.18587,1.18482,0.1,10.5,10702.1,Exit After X Bars,,None,None,None,None
1026_221101007_B,165,EURUSD,Sell,2020-09-16 17:00:00,2020-09-16 18:00:00,1.18286,1.18486,0.1,-20,10682.1,SL,,None,None,None,None
1028_221101007_B,165,EURUSD,Sell,2020-09-21 11:00:00,2020-09-21 17:00:00,1.1826,1.17519,0.1,74.1,10756.2,Exit After X Bars,,None,None,None,None
1029_221101007_B,165,EURUSD,Sell,2020-09-25 16:00:00,2020-09-25 21:00:00,1.16265,1.16279,0.1,-1.4,10754.8,End Of Friday (Time),,None,None,None,None
1033_221101007_B,165,EURUSD,Buy,2020-10-05 11:00:00,2020-10-05 17:00:00,1.1745,1.17864,0.1,41.4,10796.2,Exit After X Bars,,None,None,None,None
1034_221101007_B,165,EURUSD,Sell,2020-10-08 16:00:00,2020-10-08 20:00:00,1.17492,1.17614,0.1,-12.2,10784,TrailingStop,,None,None,None,None
1038_221101007_B,165,EURUSD,Buy,2020-10-27 15:00:00,2020-10-27 20:00:00,1.18358,1.18158,0.1,-20,10764,SL,,None,None,None,None
104_221101007_B,165,EURUSD,Buy,2015-08-10 17:00:00,2015-08-10 23:00:00,1.0981,1.1018,0.1,37,10256.5,Exit After X Bars,,None,None,None,None
1040_221101007_B,165,EURUSD,Sell,2020-11-11 11:00:00,2020-11-11 11:00:00,1.17799,1.17999,0.1,-20,10744,SL,,None,None,None,None
105_221101007_B,165,EURUSD,Buy,2015-08-11 11:00:00,2015-08-11 12:00:00,1.10414,1.10214,0.1,-20,10236.5,SL,,None,None,None,None
1054_221101007_B,165,EURUSD,Sell,2020-12-09 16:00:00,2020-12-09 22:00:00,1.20998,1.20747,0.1,25.1,10769.1,Exit After X Bars,,None,None,None,None
1060_221101007_B,165,EURUSD,Buy,2020-12-17 04:00:00,2020-12-17 10:00:00,1.22121,1.22331,0.1,21,10790.1,Exit After X Bars,,None,None,None,None
1062_221101007_B,165,EURUSD,Sell,2020-12-22 18:00:00,2020-12-23 00:00:00,1.21625,1.2163,0.1,-0.5,10789.6,Exit After X Bars,,None,None,None,None
1074_221101007_B,165,EURUSD,Sell,2021-01-08 20:00:00,2021-01-08 21:00:00,1.22132,1.2197,0.1,16.2,10805.8,End Of Friday (Time),,None,None,None,None
1080_221101007_B,165,EURUSD,Sell,2021-01-27 14:00:00,2021-01-27 17:00:00,1.21076,1.20852,0.1,22.4,10828.2,TrailingStop,,None,None,None,None
1084_221101007_B,165,EURUSD,Sell,2021-02-01 10:00:00,2021-02-01 11:00:00,1.20944,1.21058,0.1,-11.4,10816.8,TrailingStop,,None,None,None,None
1088_221101007_B,165,EURUSD,Buy,2021-02-22 13:00:00,2021-02-22 16:00:00,1.21444,1.21322,0.1,-12.2,10804.6,TrailingStop,,None,None,None,None
1090_221101007_B,165,EURUSD,Buy,2021-02-24 23:00:00,2021-02-25 05:00:00,1.21745,1.21599,0.1,-14.6,10790,Exit After X Bars,,None,None,None,None
1105_221101007_B,165,EURUSD,Buy,2021-04-05 16:00:00,2021-04-05 22:00:00,1.17861,1.1811,0.1,24.9,10814.9,Exit After X Bars,,None,None,None,None
1109_221101007_B,165,EURUSD,Buy,2021-04-12 13:00:00,2021-04-12 19:00:00,1.19103,1.19071,0.1,-3.2,10811.7,Exit After X Bars,,None,None,None,None
1110_221101007_B,165,EURUSD,Buy,2021-04-13 15:00:00,2021-04-13 21:00:00,1.1919,1.19422,0.1,23.2,10834.9,Exit After X Bars,,None,None,None,None
1113_221101007_B,165,EURUSD,Buy,2021-04-16 13:00:00,2021-04-16 19:00:00,1.19932,1.19784,0.1,-14.8,10820.1,Exit After X Bars,,None,None,None,None
1114_221101007_B,165,EURUSD,Buy,2021-04-19 10:00:00,2021-04-19 16:00:00,1.19946,1.20401,0.1,45.5,10865.6,Exit After X Bars,,None,None,None,None
1117_221101007_B,165,EURUSD,Sell,2021-04-22 21:00:00,2021-04-22 22:00:00,1.19989,1.20189,0.1,-20,10845.6,SL,,None,None,None,None
1118_221101007_B,165,EURUSD,Buy,2021-04-23 15:00:00,2021-04-23 17:00:00,1.20694,1.20564,0.1,-13,10832.6,TrailingStop,,None,None,None,None
1122_221101007_B,165,EURUSD,Buy,2021-04-28 18:00:00,2021-04-28 20:00:00,1.20927,1.20827,0.1,-10,10822.6,TrailingStop,,None,None,None,None
1125_221101007_B,165,EURUSD,Sell,2021-05-04 10:00:00,2021-05-04 14:00:00,1.2013,1.20203,0.1,-7.3,10815.3,TrailingStop,,None,None,None,None
1127_221101007_B,165,EURUSD,Buy,2021-05-11 16:00:00,2021-05-11 17:00:00,1.21782,1.21582,0.1,-20,10795.3,SL,,None,None,None,None
1129_221101007_B,165,EURUSD,Sell,2021-05-21 15:00:00,2021-05-21 15:00:00,1.2181,1.2201,0.1,-20,10775.3,SL,,None,None,None,None
1139_221101007_B,165,EURUSD,Buy,2021-06-07 17:00:00,2021-06-07 23:00:00,1.21856,1.21942,0.1,8.6,10783.9,Exit After X Bars,,None,None,None,None
1142_221101007_B,165,EURUSD,Buy,2021-06-09 11:00:00,2021-06-09 17:00:00,1.21941,1.22148,0.1,20.7,10804.6,Exit After X Bars,,None,None,None,None
1145_221101007_B,165,EURUSD,Sell,2021-06-11 14:00:00,2021-06-11 20:00:00,1.21433,1.20984,0.1,44.9,10849.5,Exit After X Bars,,None,None,None,None
1146_221101007_B,165,EURUSD,Sell,2021-06-15 14:00:00,2021-06-15 16:00:00,1.21063,1.21263,0.1,-20,10829.5,SL,,None,None,None,None
1149_221101007_B,165,EURUSD,Sell,2021-06-16 21:00:00,2021-06-16 21:00:00,1.21013,1.20263,0.1,75,10904.5,PT,,None,None,None,None
1166_221101007_B,165,EURUSD,Buy,2021-07-06 08:00:00,2021-07-06 10:00:00,1.18804,1.18752,0.1,-5.2,10899.3,TrailingStop,,None,None,None,None
1167_221101007_B,165,EURUSD,Buy,2021-07-09 15:00:00,2021-07-09 21:00:00,1.18678,1.18732,0.1,5.4,10904.7,End Of Friday (Time),,None,None,None,None
117_221101007_B,165,EURUSD,Sell,2015-09-09 09:00:00,2015-09-09 10:00:00,1.11525,1.11725,0.1,-20,10216.5,SL,,None,None,None,None
1173_221101007_B,165,EURUSD,Buy,2021-07-26 08:00:00,2021-07-26 14:00:00,1.17865,1.17917,0.1,5.2,10909.9,Exit After X Bars,,None,None,None,None
1174_221101007_B,165,EURUSD,Buy,2021-07-27 15:00:00,2021-07-27 16:00:00,1.18172,1.18035,0.1,-13.7,10896.2,TrailingStop,,None,None,None,None
1177_221101007_B,165,EURUSD,Buy,2021-07-28 21:00:00,2021-07-29 03:00:00,1.18409,1.18453,0.1,4.4,10900.6,Exit After X Bars,,None,None,None,None
1179_221101007_B,165,EURUSD,Sell,2021-08-03 17:00:00,2021-08-03 23:00:00,1.18652,1.18679,0.1,-2.7,10897.9,Exit After X Bars,,None,None,None,None
118_221101007_B,165,EURUSD,Buy,2015-09-10 18:00:00,2015-09-10 23:00:00,1.12446,1.12705,0.1,25.9,10242.4,TrailingStop,,None,None,None,None
1180_221101007_B,165,EURUSD,Sell,2021-08-04 18:00:00,2021-08-05 00:00:00,1.18419,1.18384,0.1,3.5,10901.4,Exit After X Bars,,None,None,None,None
1188_221101007_B,165,EURUSD,Buy,2021-08-13 12:00:00,2021-08-13 18:00:00,1.17481,1.17918,0.1,43.7,10945.1,Exit After X Bars,,None,None,None,None
1192_221101007_B,165,EURUSD,Buy,2021-08-25 19:00:00,2021-08-26 01:00:00,1.1765,1.17696,0.1,4.6,10949.7,Exit After X Bars,,None,None,None,None
1199_221101007_B,165,EURUSD,Buy,2021-09-01 16:00:00,2021-09-01 22:00:00,1.1845,1.18464,0.1,1.4,10951.1,Exit After X Bars,,None,None,None,None
1212_221101007_B,165,EURUSD,Sell,2021-09-17 17:00:00,2021-09-17 21:00:00,1.17504,1.17289,0.1,21.5,10972.6,End Of Friday (Time),,None,None,None,None
1217_221101007_B,165,EURUSD,Sell,2021-09-22 21:00:00,2021-09-22 22:00:00,1.17164,1.17106,0.1,5.8,10978.4,TrailingStop,,None,None,None,None
1223_221101007_B,165,EURUSD,Sell,2021-10-11 22:00:00,2021-10-12 04:00:00,1.15521,1.15512,0.1,0.9,10979.3,Exit After X Bars,,None,None,None,None
1225_221101007_B,165,EURUSD,Sell,2021-10-12 15:00:00,2021-10-12 21:00:00,1.15471,1.15274,0.1,19.7,10999,Exit After X Bars,,None,None,None,None
1232_221101007_B,165,EURUSD,Buy,2021-10-18 16:00:00,2021-10-18 22:00:00,1.16122,1.16104,0.1,-1.8,10997.2,Exit After X Bars,,None,None,None,None
1237_221101007_B,165,EURUSD,Buy,2021-10-22 18:00:00,2021-10-22 18:00:00,1.16567,1.16367,0.1,-20,10977.2,SL,,None,None,None,None
1238_221101007_B,165,EURUSD,Sell,2021-10-26 17:00:00,2021-10-26 23:00:00,1.15907,1.16004,0.1,-9.7,10967.5,Exit After X Bars,,None,None,None,None
1241_221101007_B,165,EURUSD,Sell,2021-10-28 11:00:00,2021-10-28 13:00:00,1.15849,1.16049,0.1,-20,10947.5,SL,,None,None,None,None
1245_221101007_B,165,EURUSD,Sell,2021-11-03 15:00:00,2021-11-03 17:00:00,1.15748,1.15879,0.1,-13.1,10934.4,TrailingStop,,None,None,None,None
1246_221101007_B,165,EURUSD,Sell,2021-11-04 10:00:00,2021-11-04 14:00:00,1.15622,1.15626,0.1,-0.4,10934,TrailingStop,,None,None,None,None
1251_221101007_B,165,EURUSD,Buy,2021-11-09 16:00:00,2021-11-09 17:00:00,1.16065,1.15865,0.1,-20,10914,SL,,None,None,None,None
1253_221101007_B,165,EURUSD,Sell,2021-11-19 11:00:00,2021-11-19 15:00:00,1.13137,1.12742,0.1,39.5,10953.5,TrailingStop,,None,None,None,None
1258_221101007_B,165,EURUSD,Sell,2021-12-02 18:00:00,2021-12-03 00:00:00,1.13071,1.1302,0.1,5.1,10958.6,Exit After X Bars,,None,None,None,None
1259_221101007_B,165,EURUSD,Sell,2021-12-03 17:00:00,2021-12-03 18:00:00,1.12815,1.12959,0.1,-14.4,10944.2,TrailingStop,,None,None,None,None
1261_221101007_B,165,EURUSD,Sell,2021-12-07 11:00:00,2021-12-07 17:00:00,1.12663,1.12476,0.1,18.7,10962.9,Exit After X Bars,,None,None,None,None
1264_221101007_B,165,EURUSD,Sell,2021-12-13 11:00:00,2021-12-13 14:00:00,1.12651,1.12851,0.1,-20,10942.9,SL,,None,None,None,None
1267_221101007_B,165,EURUSD,Sell,2021-12-14 18:00:00,2021-12-15 00:00:00,1.12662,1.12599,0.1,6.3,10949.2,Exit After X Bars,,None,None,None,None
1269_221101007_B,165,EURUSD,Sell,2021-12-21 17:00:00,2021-12-21 21:00:00,1.12684,1.12811,0.1,-12.7,10936.5,TrailingStop,,None,None,None,None
1285_221101007_B,165,EURUSD,Buy,2021-12-31 15:00:00,2021-12-31 21:00:00,1.13444,1.13848,0.1,40.4,10976.9,End Of Friday (Time),,None,None,None,None
1289_221101007_B,165,EURUSD,Buy,2022-01-07 16:00:00,2022-01-07 21:00:00,1.13318,1.13574,0.1,25.6,11002.5,End Of Friday (Time),,None,None,None,None
1291_221101007_B,165,EURUSD,Buy,2022-01-11 18:00:00,2022-01-12 00:00:00,1.13518,1.13659,0.1,14.1,11016.6,Exit After X Bars,,None,None,None,None
1292_221101007_B,165,EURUSD,Sell,2022-01-18 06:00:00,2022-01-18 12:00:00,1.13917,1.13968,0.1,-5.1,11011.5,Exit After X Bars,,None,None,None,None
1294_221101007_B,165,EURUSD,Sell,2022-01-20 17:00:00,2022-01-20 17:00:00,1.13289,1.13489,0.1,-20,10991.5,SL,,None,None,None,None
13_221101007_B,165,EURUSD,Sell,2015-01-22 16:00:00,2015-01-22 16:00:00,1.15621,1.14871,0.1,75,10093,PT,,None,None,None,None
1300_221101007_B,165,EURUSD,Buy,2022-02-03 15:00:00,2022-02-03 16:00:00,1.133,1.1405,0.1,75,11066.5,PT,,None,None,None,None
1306_221101007_B,165,EURUSD,Buy,2022-02-10 11:00:00,2022-02-10 15:00:00,1.14477,1.14277,0.1,-20,11046.5,SL,,None,None,None,None
1313_221101007_B,165,EURUSD,Buy,2022-02-21 09:00:00,2022-02-21 10:00:00,1.13769,1.13569,0.1,-20,11026.5,SL,,None,None,None,None
1316_221101007_B,165,EURUSD,Sell,2022-02-23 18:00:00,2022-02-24 00:00:00,1.13159,1.13056,0.1,10.3,11036.8,Exit After X Bars,,None,None,None,None
1321_221101007_B,165,EURUSD,Sell,2022-03-01 14:00:00,2022-03-01 19:00:00,1.11639,1.11201,0.1,43.8,11080.6,TrailingStop,,None,None,None,None
1332_221101007_B,165,EURUSD,Sell,2022-03-15 20:00:00,2022-03-15 21:00:00,1.09304,1.09504,0.1,-20,11060.6,SL,,None,None,None,None
1355_221101007_B,165,EURUSD,Sell,2022-04-12 19:00:00,2022-04-13 01:00:00,1.08507,1.08295,0.1,21.2,11081.8,Exit After X Bars,,None,None,None,None
1366_221101007_B,165,EURUSD,Sell,2022-05-11 15:00:00,2022-05-11 16:00:00,1.05253,1.05377,0.1,-12.4,11069.4,TrailingStop,,None,None,None,None
1371_221101007_B,165,EURUSD,Buy,2022-05-19 15:00:00,2022-05-19 18:00:00,1.0542,1.05757,0.1,33.7,11103.1,TrailingStop,,None,None,None,None
1374_221101007_B,165,EURUSD,Buy,2022-05-26 12:00:00,2022-05-26 14:00:00,1.07079,1.07042,0.1,-3.7,11099.4,TrailingStop,,None,None,None,None
1384_221101007_B,165,EURUSD,Buy,2022-06-09 14:00:00,2022-06-09 14:00:00,1.07484,1.07284,0.1,-20,11079.4,SL,,None,None,None,None
1386_221101007_B,165,EURUSD,Sell,2022-06-15 18:00:00,2022-06-15 20:00:00,1.03997,1.03986,0.1,1.1,11080.5,TrailingStop,,None,None,None,None
139_221101007_B,165,EURUSD,Buy,2015-10-08 10:00:00,2015-10-08 14:00:00,1.12841,1.12869,0.1,2.8,10245.2,TrailingStop,,None,None,None,None
1394_221101007_B,165,EURUSD,Buy,2022-06-24 17:00:00,2022-06-24 20:00:00,1.05547,1.05347,0.1,-20,11060.5,SL,,None,None,None,None
140_221101007_B,165,EURUSD,Buy,2015-10-08 21:00:00,2015-10-08 21:00:00,1.13148,1.12948,0.1,-20,10225.2,SL,,None,None,None,None
146_221101007_B,165,EURUSD,Sell,2015-10-22 03:00:00,2015-10-22 04:00:00,1.13325,1.13525,0.1,-20,10205.2,SL,,None,None,None,None
154_221101007_B,165,EURUSD,Sell,2015-11-12 10:00:00,2015-11-12 11:00:00,1.07059,1.07259,0.1,-20,10185.2,SL,,None,None,None,None
157_221101007_B,165,EURUSD,Sell,2015-11-18 18:00:00,2015-11-18 21:00:00,1.06308,1.06508,0.1,-20,10165.2,SL,,None,None,None,None
162_221101007_B,165,EURUSD,Sell,2015-11-27 11:00:00,2015-11-27 17:00:00,1.05999,1.05815,0.1,18.4,10183.6,Exit After X Bars,,None,None,None,None
166_221101007_B,165,EURUSD,Buy,2015-12-11 16:00:00,2015-12-11 17:00:00,1.10076,1.09876,0.1,-20,10163.6,SL,,None,None,None,None
168_221101007_B,165,EURUSD,Buy,2015-12-14 17:00:00,2015-12-14 20:00:00,1.10307,1.10107,0.1,-20,10143.6,SL,,None,None,None,None
169_221101007_B,165,EURUSD,Sell,2015-12-17 01:00:00,2015-12-17 06:00:00,1.08879,1.08565,0.1,31.4,10175,TrailingStop,,None,None,None,None
174_221101007_B,165,EURUSD,Buy,2015-12-29 11:00:00,2015-12-29 12:00:00,1.09923,1.09723,0.1,-20,10155,SL,,None,None,None,None
175_221101007_B,165,EURUSD,Sell,2015-12-31 12:00:00,2015-12-31 17:00:00,1.0902,1.08994,0.1,2.6,10157.6,TrailingStop,,None,None,None,None
176_221101007_B,165,EURUSD,Sell,2016-01-04 17:00:00,2016-01-04 19:00:00,1.08272,1.08186,0.1,8.6,10166.2,TrailingStop,,None,None,None,None
183_221101007_B,165,EURUSD,Buy,2016-01-13 17:00:00,2016-01-13 17:00:00,1.08774,1.08574,0.1,-20,10146.2,SL,,None,None,None,None
184_221101007_B,165,EURUSD,Buy,2016-01-13 21:00:00,2016-01-14 03:00:00,1.08821,1.0886,0.1,3.9,10150.1,Exit After X Bars,,None,None,None,None
191_221101007_B,165,EURUSD,Buy,2016-01-19 17:00:00,2016-01-19 22:00:00,1.09049,1.09123,0.1,7.4,10157.5,TrailingStop,,None,None,None,None
20_221101007_B,165,EURUSD,Buy,2015-02-02 17:00:00,2015-02-02 18:00:00,1.13546,1.13346,0.1,-20,10073,SL,,None,None,None,None
207_221101007_B,165,EURUSD,Sell,2016-02-22 12:00:00,2016-02-22 16:00:00,1.10669,1.10231,0.1,43.8,10201.3,TrailingStop,,None,None,None,None
21_221101007_B,165,EURUSD,Buy,2015-02-03 15:00:00,2015-02-03 15:00:00,1.13621,1.14371,0.1,75,10148,PT,,None,None,None,None
228_221101007_B,165,EURUSD,Buy,2016-03-29 16:00:00,2016-03-29 16:00:00,1.12198,1.11998,0.1,-20,10181.3,SL,,None,None,None,None
230_221101007_B,165,EURUSD,Sell,2016-04-06 14:00:00,2016-04-06 15:00:00,1.13359,1.13559,0.1,-20,10161.3,SL,,None,None,None,None
233_221101007_B,165,EURUSD,Buy,2016-04-08 17:00:00,2016-04-08 21:00:00,1.13998,1.13989,0.1,-0.9,10160.4,End Of Friday (Time),,None,None,None,None
235_221101007_B,165,EURUSD,Buy,2016-04-11 16:00:00,2016-04-11 18:00:00,1.1428,1.14278,0.1,-0.2,10160.2,TrailingStop,,None,None,None,None
237_221101007_B,165,EURUSD,Sell,2016-04-21 17:00:00,2016-04-21 18:00:00,1.12831,1.13031,0.1,-20,10140.2,SL,,None,None,None,None
241_221101007_B,165,EURUSD,Buy,2016-04-28 09:00:00,2016-04-28 10:00:00,1.1361,1.1341,0.1,-20,10120.2,SL,,None,None,None,None
242_221101007_B,165,EURUSD,Sell,2016-05-04 17:00:00,2016-05-04 17:00:00,1.14699,1.14899,0.1,-20,10100.2,SL,,None,None,None,None
247_221101007_B,165,EURUSD,Sell,2016-05-17 15:00:00,2016-05-17 16:00:00,1.13073,1.13273,0.1,-20,10080.2,SL,,None,None,None,None
248_221101007_B,165,EURUSD,Sell,2016-05-18 04:00:00,2016-05-18 10:00:00,1.1302,1.12784,0.1,23.6,10103.8,Exit After X Bars,,None,None,None,None
249_221101007_B,165,EURUSD,Sell,2016-05-23 11:00:00,2016-05-23 17:00:00,1.12044,1.11948,0.1,9.6,10113.4,Exit After X Bars,,None,None,None,None
250_221101007_B,165,EURUSD,Sell,2016-05-24 10:00:00,2016-05-24 16:00:00,1.11875,1.11628,0.1,24.7,10138.1,Exit After X Bars,,None,None,None,None
253_221101007_B,165,EURUSD,Sell,2016-06-01 03:00:00,2016-06-01 09:00:00,1.11222,1.11259,0.1,-3.7,10134.4,Exit After X Bars,,None,None,None,None
254_221101007_B,165,EURUSD,Buy,2016-06-01 14:00:00,2016-06-01 17:00:00,1.11734,1.11629,0.1,-10.5,10123.9,TrailingStop,,None,None,None,None
257_221101007_B,165,EURUSD,Sell,2016-06-14 11:00:00,2016-06-14 13:00:00,1.12378,1.12298,0.1,8,10131.9,TrailingStop,,None,None,None,None
264_221101007_B,165,EURUSD,Sell,2016-06-30 18:00:00,2016-06-30 19:00:00,1.10518,1.10507,0.1,1.1,10133,TrailingStop,,None,None,None,None
27_221101007_B,165,EURUSD,Buy,2015-02-19 03:00:00,2015-02-19 09:00:00,1.14203,1.14135,0.1,-6.8,10141.2,Exit After X Bars,,None,None,None,None
271_221101007_B,165,EURUSD,Sell,2016-07-08 15:00:00,2016-07-08 16:00:00,1.10526,1.10415,0.1,11.1,10144.1,TrailingStop,,None,None,None,None
274_221101007_B,165,EURUSD,Sell,2016-07-19 14:00:00,2016-07-19 20:00:00,1.10376,1.10161,0.1,21.5,10165.6,Exit After X Bars,,None,None,None,None
276_221101007_B,165,EURUSD,Sell,2016-07-21 17:00:00,2016-07-21 18:00:00,1.09815,1.10015,0.1,-20,10145.6,SL,,None,None,None,None
279_221101007_B,165,EURUSD,Sell,2016-07-22 17:00:00,2016-07-22 21:00:00,1.09796,1.09683,0.1,11.3,10156.9,End Of Friday (Time),,None,None,None,None
285_221101007_B,165,EURUSD,Sell,2016-07-27 21:00:00,2016-07-27 21:00:00,1.09783,1.09983,0.1,-20,10136.9,SL,,None,None,None,None
286_221101007_B,165,EURUSD,Sell,2016-08-05 15:00:00,2016-08-05 17:00:00,1.1114,1.10673,0.1,46.7,10183.6,TrailingStop,,None,None,None,None
288_221101007_B,165,EURUSD,Buy,2016-08-12 15:00:00,2016-08-12 16:00:00,1.11821,1.11939,0.1,11.8,10195.4,TrailingStop,,None,None,None,None
29_221101007_B,165,EURUSD,Buy,2015-02-26 12:00:00,2015-02-26 12:00:00,1.13816,1.13616,0.1,-20,10121.2,SL,,None,None,None,None
293_221101007_B,165,EURUSD,Sell,2016-08-26 18:00:00,2016-08-26 21:00:00,1.12712,1.12156,0.1,55.6,10251,End Of Friday (Time),,None,None,None,None
297_221101007_B,165,EURUSD,Buy,2016-09-06 17:00:00,2016-09-06 20:00:00,1.11824,1.12574,0.1,75,10326,PT,,None,None,None,None
303_221101007_B,165,EURUSD,Sell,2016-09-13 21:00:00,2016-09-14 03:00:00,1.12139,1.12211,0.1,-7.2,10318.8,Exit After X Bars,,None,None,None,None
307_221101007_B,165,EURUSD,Sell,2016-09-20 21:00:00,2016-09-21 03:00:00,1.11585,1.1155,0.1,3.5,10322.3,Exit After X Bars,,None,None,None,None
314_221101007_B,165,EURUSD,Sell,2016-09-30 10:00:00,2016-09-30 15:00:00,1.11968,1.11775,0.1,19.3,10341.6,TrailingStop,,None,None,None,None
320_221101007_B,165,EURUSD,Sell,2016-10-18 15:00:00,2016-10-18 18:00:00,1.09859,1.09895,0.1,-3.6,10338,TrailingStop,,None,None,None,None
321_221101007_B,165,EURUSD,Sell,2016-10-19 15:00:00,2016-10-19 21:00:00,1.097,1.0966,0.1,4,10342,Exit After X Bars,,None,None,None,None
322_221101007_B,165,EURUSD,Sell,2016-10-25 15:00:00,2016-10-25 18:00:00,1.0868,1.08716,0.1,-3.6,10338.4,TrailingStop,,None,None,None,None
329_221101007_B,165,EURUSD,Buy,2016-10-28 17:00:00,2016-10-28 17:00:00,1.09422,1.09222,0.1,-20,10318.4,SL,,None,None,None,None
334_221101007_B,165,EURUSD,Sell,2016-11-17 17:00:00,2016-11-17 23:00:00,1.06661,1.06267,0.1,39.4,10357.8,Exit After X Bars,,None,None,None,None
337_221101007_B,165,EURUSD,Sell,2016-11-22 17:00:00,2016-11-22 18:00:00,1.05898,1.06006,0.1,-10.8,10347,TrailingStop,,None,None,None,None
339_221101007_B,165,EURUSD,Sell,2016-11-23 15:00:00,2016-11-23 18:00:00,1.05836,1.05497,0.1,33.9,10380.9,TrailingStop,,None,None,None,None
343_221101007_B,165,EURUSD,Buy,2016-11-29 17:00:00,2016-11-29 23:00:00,1.06218,1.06454,0.1,23.6,10404.5,Exit After X Bars,,None,None,None,None
345_221101007_B,165,EURUSD,Buy,2016-12-01 20:00:00,2016-12-02 02:00:00,1.06398,1.06621,0.1,22.3,10426.8,Exit After X Bars,,None,None,None,None
350_221101007_B,165,EURUSD,Buy,2016-12-13 17:00:00,2016-12-13 17:00:00,1.06517,1.06317,0.1,-20,10406.8,SL,,None,None,None,None
353_221101007_B,165,EURUSD,Buy,2016-12-14 19:00:00,2016-12-14 20:00:00,1.06671,1.06471,0.1,-20,10386.8,SL,,None,None,None,None
365_221101007_B,165,EURUSD,Buy,2017-01-09 18:00:00,2017-01-09 19:00:00,1.05827,1.05627,0.1,-20,10366.8,SL,,None,None,None,None
378_221101007_B,165,EURUSD,Sell,2017-01-30 13:00:00,2017-01-30 15:00:00,1.06584,1.06465,0.1,11.9,10378.7,TrailingStop,,None,None,None,None
38_221101007_B,165,EURUSD,Buy,2015-03-18 18:00:00,2015-03-18 19:00:00,1.06507,1.06415,0.1,-9.2,10112,TrailingStop,,None,None,None,None
388_221101007_B,165,EURUSD,Sell,2017-02-13 16:00:00,2017-02-13 22:00:00,1.06077,1.0601,0.1,6.7,10385.4,Exit After X Bars,,None,None,None,None
390_221101007_B,165,EURUSD,Sell,2017-02-14 17:00:00,2017-02-14 18:00:00,1.05914,1.05806,0.1,10.8,10396.2,TrailingStop,,None,None,None,None
393_221101007_B,165,EURUSD,Buy,2017-02-23 15:00:00,2017-02-23 18:00:00,1.0574,1.0579,0.1,5,10401.2,TrailingStop,,None,None,None,None
395_221101007_B,165,EURUSD,Buy,2017-02-27 18:00:00,2017-02-27 19:00:00,1.06179,1.06102,0.1,-7.7,10393.5,TrailingStop,,None,None,None,None
403_221101007_B,165,EURUSD,Buy,2017-03-21 09:00:00,2017-03-21 14:00:00,1.07772,1.07938,0.1,16.6,10410.1,TrailingStop,,None,None,None,None
407_221101007_B,165,EURUSD,Buy,2017-03-24 11:00:00,2017-03-24 16:00:00,1.08034,1.07911,0.1,-12.3,10397.8,TrailingStop,,None,None,None,None
408_221101007_B,165,EURUSD,Sell,2017-04-05 21:00:00,2017-04-05 21:00:00,1.06355,1.06555,0.1,-20,10377.8,SL,,None,None,None,None
414_221101007_B,165,EURUSD,Sell,2017-04-12 20:00:00,2017-04-12 22:00:00,1.05949,1.06149,0.1,-20,10357.8,SL,,None,None,None,None
416_221101007_B,165,EURUSD,Buy,2017-04-17 10:00:00,2017-04-17 12:00:00,1.06294,1.06229,0.1,-6.5,10351.3,TrailingStop,,None,None,None,None
421_221101007_B,165,EURUSD,Sell,2017-05-11 15:00:00,2017-05-11 17:00:00,1.08532,1.08732,0.1,-20,10331.3,SL,,None,None,None,None
425_221101007_B,165,EURUSD,Buy,2017-05-19 11:00:00,2017-05-19 17:00:00,1.1162,1.11886,0.1,26.6,10357.9,Exit After X Bars,,None,None,None,None
426_221101007_B,165,EURUSD,Sell,2017-05-24 18:00:00,2017-05-24 20:00:00,1.117,1.119,0.1,-20,10337.9,SL,,None,None,None,None
428_221101007_B,165,EURUSD,Sell,2017-05-26 15:00:00,2017-05-26 17:00:00,1.1185,1.11847,0.1,0.3,10338.2,TrailingStop,,None,None,None,None
431_221101007_B,165,EURUSD,Buy,2017-05-31 13:00:00,2017-05-31 18:00:00,1.12054,1.12308,0.1,25.4,10363.6,TrailingStop,,None,None,None,None
436_221101007_B,165,EURUSD,Buy,2017-06-06 16:00:00,2017-06-06 22:00:00,1.12775,1.12689,0.1,-8.6,10355,Exit After X Bars,,None,None,None,None
438_221101007_B,165,EURUSD,Buy,2017-06-07 17:00:00,2017-06-07 17:00:00,1.12842,1.12642,0.1,-20,10335,SL,,None,None,None,None
445_221101007_B,165,EURUSD,Sell,2017-06-08 15:00:00,2017-06-08 15:00:00,1.12039,1.12239,0.1,-20,10315,SL,,None,None,None,None
45_221101007_B,165,EURUSD,Buy,2015-04-15 20:00:00,2015-04-15 20:00:00,1.07009,1.06809,0.1,-20,10092,SL,,None,None,None,None
454_221101007_B,165,EURUSD,Buy,2017-06-26 15:00:00,2017-06-26 18:00:00,1.12089,1.11961,0.1,-12.8,10302.2,TrailingStop,,None,None,None,None
457_221101007_B,165,EURUSD,Buy,2017-06-27 11:00:00,2017-06-27 16:00:00,1.12198,1.12948,0.1,75,10377.2,PT,,None,None,None,None
458_221101007_B,165,EURUSD,Sell,2017-07-05 12:00:00,2017-07-05 14:00:00,1.13359,1.13381,0.1,-2.2,10375,TrailingStop,,None,None,None,None
46_221101007_B,165,EURUSD,Buy,2015-04-16 14:00:00,2015-04-16 15:00:00,1.07466,1.07266,0.1,-20,10072,SL,,None,None,None,None
463_221101007_B,165,EURUSD,Buy,2017-07-11 15:00:00,2017-07-11 21:00:00,1.14078,1.14665,0.1,58.7,10433.7,Exit After X Bars,,None,None,None,None
469_221101007_B,165,EURUSD,Buy,2017-07-20 15:00:00,2017-07-20 16:00:00,1.15475,1.15468,0.1,-0.7,10433,TrailingStop,,None,None,None,None
474_221101007_B,165,EURUSD,Sell,2017-08-08 17:00:00,2017-08-08 19:00:00,1.1778,1.17413,0.1,36.7,10469.7,TrailingStop,,None,None,None,None
480_221101007_B,165,EURUSD,Buy,2017-08-18 12:00:00,2017-08-18 12:00:00,1.17656,1.17456,0.1,-20,10449.7,SL,,None,None,None,None
483_221101007_B,165,EURUSD,Buy,2017-08-21 15:00:00,2017-08-21 21:00:00,1.17743,1.18186,0.1,44.3,10494,Exit After X Bars,,None,None,None,None
486_221101007_B,165,EURUSD,Buy,2017-08-25 13:00:00,2017-08-25 15:00:00,1.18146,1.18022,0.1,-12.4,10481.6,TrailingStop,,None,None,None,None
499_221101007_B,165,EURUSD,Sell,2017-09-13 17:00:00,2017-09-13 23:00:00,1.19262,1.18862,0.1,40,10521.6,Exit After X Bars,,None,None,None,None
505_221101007_B,165,EURUSD,Buy,2017-09-19 04:00:00,2017-09-19 10:00:00,1.19692,1.19946,0.1,25.4,10547,Exit After X Bars,,None,None,None,None
52_221101007_B,165,EURUSD,Buy,2015-04-23 17:00:00,2015-04-23 23:00:00,1.08008,1.08255,0.1,24.7,10096.7,Exit After X Bars,,None,None,None,None
521_221101007_B,165,EURUSD,Buy,2017-10-13 16:00:00,2017-10-13 17:00:00,1.18618,1.18512,0.1,-10.6,10536.4,TrailingStop,,None,None,None,None
531_221101007_B,165,EURUSD,Sell,2017-11-01 14:00:00,2017-11-01 16:00:00,1.16248,1.1629,0.1,-4.2,10532.2,TrailingStop,,None,None,None,None
546_221101007_B,165,EURUSD,Sell,2017-11-20 01:00:00,2017-11-20 02:00:00,1.17653,1.17514,0.1,13.9,10546.1,TrailingStop,,None,None,None,None
552_221101007_B,165,EURUSD,Sell,2017-11-30 12:00:00,2017-11-30 13:00:00,1.18167,1.18367,0.1,-20,10526.1,SL,,None,None,None,None
564_221101007_B,165,EURUSD,Buy,2017-12-27 06:00:00,2017-12-27 12:00:00,1.18787,1.18878,0.1,9.1,10535.2,Exit After X Bars,,None,None,None,None
567_221101007_B,165,EURUSD,Buy,2018-01-04 13:00:00,2018-01-04 15:00:00,1.20604,1.20555,0.1,-4.9,10530.3,TrailingStop,,None,None,None,None
571_221101007_B,165,EURUSD,Buy,2018-01-11 15:00:00,2018-01-11 18:00:00,1.20179,1.20341,0.1,16.2,10546.5,TrailingStop,,None,None,None,None
572_221101007_B,165,EURUSD,Buy,2018-01-17 02:00:00,2018-01-17 03:00:00,1.22937,1.22884,0.1,-5.3,10541.2,TrailingStop,,None,None,None,None
576_221101007_B,165,EURUSD,Sell,2018-01-19 20:00:00,2018-01-19 21:00:00,1.22198,1.22346,0.1,-14.8,10526.4,End Of Friday (Time),,None,None,None,None
581_221101007_B,165,EURUSD,Buy,2018-01-30 13:00:00,2018-01-30 14:00:00,1.24278,1.24242,0.1,-3.6,10522.8,TrailingStop,,None,None,None,None
583_221101007_B,165,EURUSD,Buy,2018-01-31 09:00:00,2018-01-31 10:00:00,1.24538,1.24338,0.1,-20,10502.8,SL,,None,None,None,None
586_221101007_B,165,EURUSD,Buy,2018-02-01 17:00:00,2018-02-01 23:00:00,1.24748,1.25146,0.1,39.8,10542.6,Exit After X Bars,,None,None,None,None
591_221101007_B,165,EURUSD,Sell,2018-02-09 19:00:00,2018-02-09 20:00:00,1.2212,1.2232,0.1,-20,10522.6,SL,,None,None,None,None
596_221101007_B,165,EURUSD,Sell,2018-02-26 17:00:00,2018-02-26 18:00:00,1.22801,1.23001,0.1,-20,10502.6,SL,,None,None,None,None
598_221101007_B,165,EURUSD,Sell,2018-02-27 16:00:00,2018-02-27 20:00:00,1.22776,1.22558,0.1,21.8,10524.4,TrailingStop,,None,None,None,None
600_221101007_B,165,EURUSD,Buy,2018-03-08 15:00:00,2018-03-08 15:00:00,1.24367,1.24167,0.1,-20,10504.4,SL,,None,None,None,None
611_221101007_B,165,EURUSD,Sell,2018-03-28 16:00:00,2018-03-28 18:00:00,1.23723,1.23598,0.1,12.5,10516.9,TrailingStop,,None,None,None,None
613_221101007_B,165,EURUSD,Sell,2018-04-02 17:00:00,2018-04-02 20:00:00,1.23107,1.23048,0.1,5.9,10522.8,TrailingStop,,None,None,None,None
614_221101007_B,165,EURUSD,Sell,2018-04-03 16:00:00,2018-04-03 17:00:00,1.2282,1.22749,0.1,7.1,10529.9,TrailingStop,,None,None,None,None
623_221101007_B,165,EURUSD,Buy,2018-04-18 14:00:00,2018-04-18 17:00:00,1.23869,1.23763,0.1,-10.6,10519.3,TrailingStop,,None,None,None,None
624_221101007_B,165,EURUSD,Buy,2018-04-19 10:00:00,2018-04-19 11:00:00,1.23971,1.23771,0.1,-20,10499.3,SL,,None,None,None,None
627_221101007_B,165,EURUSD,Sell,2018-04-26 17:00:00,2018-04-26 19:00:00,1.21451,1.21303,0.1,14.8,10514.1,TrailingStop,,None,None,None,None
633_221101007_B,165,EURUSD,Sell,2018-05-04 16:00:00,2018-05-04 17:00:00,1.19492,1.19456,0.1,3.6,10517.7,TrailingStop,,None,None,None,None
637_221101007_B,165,EURUSD,Sell,2018-05-18 12:00:00,2018-05-18 17:00:00,1.17765,1.17737,0.1,2.8,10520.5,TrailingStop,,None,None,None,None
64_221101007_B,165,EURUSD,Buy,2015-06-02 10:00:00,2015-06-02 10:00:00,1.0979,1.0959,0.1,-20,10076.7,SL,,None,None,None,None
644_221101007_B,165,EURUSD,Sell,2018-05-28 13:00:00,2018-05-28 16:00:00,1.16455,1.16261,0.1,19.4,10539.9,TrailingStop,,None,None,None,None
648_221101007_B,165,EURUSD,Buy,2018-06-04 11:00:00,2018-06-04 15:00:00,1.17178,1.17223,0.1,4.5,10544.4,TrailingStop,,None,None,None,None
65_221101007_B,165,EURUSD,Sell,2015-06-05 15:00:00,2015-06-05 15:00:00,1.11798,1.11048,0.1,75,10151.7,PT,,None,None,None,None
650_221101007_B,165,EURUSD,Sell,2018-06-12 03:00:00,2018-06-12 05:00:00,1.17644,1.17698,0.1,-5.4,10539,TrailingStop,,None,None,None,None
651_221101007_B,165,EURUSD,Sell,2018-06-12 20:00:00,2018-06-13 02:00:00,1.1741,1.17478,0.1,-6.8,10532.2,Exit After X Bars,,None,None,None,None
653_221101007_B,165,EURUSD,Sell,2018-06-19 11:00:00,2018-06-19 15:00:00,1.15653,1.1562,0.1,3.3,10535.5,TrailingStop,,None,None,None,None
664_221101007_B,165,EURUSD,Sell,2018-07-11 20:00:00,2018-07-12 02:00:00,1.16949,1.16777,0.1,17.2,10552.7,Exit After X Bars,,None,None,None,None
672_221101007_B,165,EURUSD,Buy,2018-07-25 21:00:00,2018-07-26 03:00:00,1.17119,1.17379,0.1,26,10578.7,Exit After X Bars,,None,None,None,None
680_221101007_B,165,EURUSD,Buy,2018-08-24 14:00:00,2018-08-24 20:00:00,1.15906,1.16239,0.1,33.3,10612,Exit After X Bars,,None,None,None,None
684_221101007_B,165,EURUSD,Sell,2018-08-31 15:00:00,2018-08-31 17:00:00,1.16417,1.16528,0.1,-11.1,10600.9,TrailingStop,,None,None,None,None
691_221101007_B,165,EURUSD,Buy,2018-09-12 17:00:00,2018-09-12 22:00:00,1.16126,1.16241,0.1,11.5,10612.4,TrailingStop,,None,None,None,None
695_221101007_B,165,EURUSD,Buy,2018-09-20 13:00:00,2018-09-20 16:00:00,1.17149,1.17549,0.1,40,10652.4,TrailingStop,,None,None,None,None
698_221101007_B,165,EURUSD,Buy,2018-09-24 16:00:00,2018-09-24 17:00:00,1.18027,1.17827,0.1,-20,10632.4,SL,,None,None,None,None
702_221101007_B,165,EURUSD,Buy,2018-09-26 21:00:00,2018-09-26 21:00:00,1.17757,1.17557,0.1,-20,10612.4,SL,,None,None,None,None
705_221101007_B,165,EURUSD,Sell,2018-10-08 11:00:00,2018-10-08 17:00:00,1.14838,1.14743,0.1,9.5,10621.9,Exit After X Bars,,None,None,None,None
706_221101007_B,165,EURUSD,Sell,2018-10-09 12:00:00,2018-10-09 15:00:00,1.14599,1.14513,0.1,8.6,10630.5,TrailingStop,,None,None,None,None
710_221101007_B,165,EURUSD,Buy,2018-10-16 16:00:00,2018-10-16 17:00:00,1.16061,1.15861,0.1,-20,10610.5,SL,,None,None,None,None
714_221101007_B,165,EURUSD,Sell,2018-10-25 17:00:00,2018-10-25 23:00:00,1.13789,1.13734,0.1,5.5,10616,Exit After X Bars,,None,None,None,None
72_221101007_B,165,EURUSD,Buy,2015-06-17 21:00:00,2015-06-18 02:00:00,1.12922,1.13672,0.1,75,10226.7,PT,,None,None,None,None
721_221101007_B,165,EURUSD,Buy,2018-11-14 16:00:00,2018-11-14 17:00:00,1.13212,1.13187,0.1,-2.5,10613.5,TrailingStop,,None,None,None,None
723_221101007_B,165,EURUSD,Buy,2018-11-15 21:00:00,2018-11-15 22:00:00,1.13516,1.13316,0.1,-20,10593.5,SL,,None,None,None,None
726_221101007_B,165,EURUSD,Sell,2018-11-26 20:00:00,2018-11-27 02:00:00,1.13264,1.13351,0.1,-8.7,10584.8,Exit After X Bars,,None,None,None,None
729_221101007_B,165,EURUSD,Buy,2018-12-04 06:00:00,2018-12-04 12:00:00,1.13796,1.14105,0.1,30.9,10615.7,Exit After X Bars,,None,None,None,None
730_221101007_B,165,EURUSD,Sell,2018-12-05 17:00:00,2018-12-05 17:00:00,1.13168,1.13368,0.1,-20,10595.7,SL,,None,None,None,None
737_221101007_B,165,EURUSD,Sell,2018-12-14 10:00:00,2018-12-14 13:00:00,1.1331,1.13086,0.1,22.4,10618.1,TrailingStop,,None,None,None,None
740_221101007_B,165,EURUSD,Buy,2018-12-20 11:00:00,2018-12-20 14:00:00,1.14392,1.14631,0.1,23.9,10642,TrailingStop,,None,None,None,None
745_221101007_B,165,EURUSD,Sell,2018-12-26 10:00:00,2018-12-26 16:00:00,1.13892,1.1391,0.1,-1.8,10640.2,Exit After X Bars,,None,None,None,None
748_221101007_B,165,EURUSD,Buy,2018-12-31 23:00:00,2019-01-02 03:00:00,1.14659,1.14459,0.1,-20,10620.2,SL,,None,None,None,None
75_221101007_B,165,EURUSD,Buy,2015-06-22 17:00:00,2015-06-22 18:00:00,1.14035,1.13835,0.1,-20,10206.7,SL,,None,None,None,None
754_221101007_B,165,EURUSD,Sell,2019-01-15 11:00:00,2019-01-15 16:00:00,1.14506,1.14463,0.1,4.3,10624.5,TrailingStop,,None,None,None,None
755_221101007_B,165,EURUSD,Sell,2019-01-18 17:00:00,2019-01-18 21:00:00,1.137,1.13672,0.1,2.8,10627.3,End Of Friday (Time),,None,None,None,None
760_221101007_B,165,EURUSD,Buy,2019-01-30 21:00:00,2019-01-30 22:00:00,1.14499,1.1477,0.1,27.1,10654.4,TrailingStop,,None,None,None,None
766_221101007_B,165,EURUSD,Buy,2019-02-19 17:00:00,2019-02-19 23:00:00,1.1331,1.13426,0.1,11.6,10666,Exit After X Bars,,None,None,None,None
77_221101007_B,165,EURUSD,Sell,2015-06-26 16:00:00,2015-06-26 16:00:00,1.11643,1.11843,0.1,-20,10186.7,SL,,None,None,None,None
774_221101007_B,165,EURUSD,Buy,2019-02-25 09:00:00,2019-02-25 15:00:00,1.13556,1.13573,0.1,1.7,10667.7,Exit After X Bars,,None,None,None,None
777_221101007_B,165,EURUSD,Buy,2019-02-28 12:00:00,2019-02-28 15:00:00,1.14036,1.14019,0.1,-1.7,10666,TrailingStop,,None,None,None,None
781_221101007_B,165,EURUSD,Sell,2019-03-07 14:00:00,2019-03-07 18:00:00,1.12855,1.12105,0.1,75,10741,PT,,None,None,None,None
783_221101007_B,165,EURUSD,Sell,2019-03-11 18:00:00,2019-03-11 19:00:00,1.12229,1.12429,0.1,-20,10721,SL,,None,None,None,None
787_221101007_B,165,EURUSD,Buy,2019-03-20 14:00:00,2019-03-20 20:00:00,1.13615,1.13575,0.1,-4,10717,Exit After X Bars,,None,None,None,None
788_221101007_B,165,EURUSD,Sell,2019-03-26 14:00:00,2019-03-26 19:00:00,1.13029,1.12962,0.1,6.7,10723.7,TrailingStop,,None,None,None,None
791_221101007_B,165,EURUSD,Sell,2019-04-01 18:00:00,2019-04-02 00:00:00,1.12131,1.1214,0.1,-0.9,10722.8,Exit After X Bars,,None,None,None,None
792_221101007_B,165,EURUSD,Buy,2019-04-08 13:00:00,2019-04-08 19:00:00,1.12472,1.12612,0.1,14,10736.8,Exit After X Bars,,None,None,None,None
793_221101007_B,165,EURUSD,Buy,2019-04-10 15:00:00,2019-04-10 15:00:00,1.12842,1.12642,0.1,-20,10716.8,SL,,None,None,None,None
796_221101007_B,165,EURUSD,Buy,2019-04-12 04:00:00,2019-04-12 10:00:00,1.12873,1.12841,0.1,-3.2,10713.6,Exit After X Bars,,None,None,None,None
798_221101007_B,165,EURUSD,Buy,2019-04-17 09:00:00,2019-04-17 14:00:00,1.13139,1.13019,0.1,-12,10701.6,TrailingStop,,None,None,None,None
801_221101007_B,165,EURUSD,Buy,2019-04-23 12:00:00,2019-04-23 15:00:00,1.1262,1.1242,0.1,-20,10681.6,SL,,None,None,None,None
805_221101007_B,165,EURUSD,Buy,2019-05-06 14:00:00,2019-05-06 15:00:00,1.12047,1.11847,0.1,-20,10661.6,SL,,None,None,None,None
811_221101007_B,165,EURUSD,Buy,2019-05-09 16:00:00,2019-05-09 19:00:00,1.12136,1.122,0.1,6.4,10668,TrailingStop,,None,None,None,None
813_221101007_B,165,EURUSD,Sell,2019-05-16 17:00:00,2019-05-16 23:00:00,1.11779,1.11789,0.1,-1,10667,Exit After X Bars,,None,None,None,None
820_221101007_B,165,EURUSD,Sell,2019-06-06 14:00:00,2019-06-06 14:00:00,1.122,1.124,0.1,-20,10647,SL,,None,None,None,None
821_221101007_B,165,EURUSD,Buy,2019-06-07 15:00:00,2019-06-07 21:00:00,1.1309,1.13431,0.1,34.1,10681.1,End Of Friday (Time),,None,None,None,None
836_221101007_B,165,EURUSD,Buy,2019-07-30 11:00:00,2019-07-30 17:00:00,1.11509,1.11497,0.1,-1.2,10679.9,Exit After X Bars,,None,None,None,None
841_221101007_B,165,EURUSD,Buy,2019-08-07 16:00:00,2019-08-07 17:00:00,1.12195,1.12193,0.1,-0.2,10679.7,TrailingStop,,None,None,None,None
846_221101007_B,165,EURUSD,Buy,2019-08-12 18:00:00,2019-08-13 00:00:00,1.12229,1.12129,0.1,-10,10669.7,Exit After X Bars,,None,None,None,None
852_221101007_B,165,EURUSD,Sell,2019-08-21 21:00:00,2019-08-22 03:00:00,1.10879,1.10923,0.1,-4.4,10665.3,Exit After X Bars,,None,None,None,None
856_221101007_B,165,EURUSD,Buy,2019-09-09 15:00:00,2019-09-09 21:00:00,1.10572,1.10562,0.1,-1,10664.3,Exit After X Bars,,None,None,None,None
863_221101007_B,165,EURUSD,Buy,2019-09-19 12:00:00,2019-09-19 18:00:00,1.10685,1.10553,0.1,-13.2,10651.1,Exit After X Bars,,None,None,None,None
867_221101007_B,165,EURUSD,Sell,2019-09-25 14:00:00,2019-09-25 20:00:00,1.09837,1.09451,0.1,38.6,10689.7,Exit After X Bars,,None,None,None,None
871_221101007_B,165,EURUSD,Buy,2019-10-02 16:00:00,2019-10-02 22:00:00,1.09428,1.09591,0.1,16.3,10706,Exit After X Bars,,None,None,None,None
872_221101007_B,165,EURUSD,Buy,2019-10-07 15:00:00,2019-10-07 19:00:00,1.0999,1.0979,0.1,-20,10686,SL,,None,None,None,None
874_221101007_B,165,EURUSD,Buy,2019-10-10 02:00:00,2019-10-10 08:00:00,1.099,1.0986,0.1,-4,10682,Exit After X Bars,,None,None,None,None
876_221101007_B,165,EURUSD,Buy,2019-10-15 18:00:00,2019-10-15 19:00:00,1.10459,1.10259,0.1,-20,10662,SL,,None,None,None,None
879_221101007_B,165,EURUSD,Sell,2019-10-24 17:00:00,2019-10-24 23:00:00,1.11061,1.11018,0.1,4.3,10666.3,Exit After X Bars,,None,None,None,None
880_221101007_B,165,EURUSD,Sell,2019-10-25 16:00:00,2019-10-25 21:00:00,1.1093,1.10789,0.1,14.1,10680.4,End Of Friday (Time),,None,None,None,None
881_221101007_B,165,EURUSD,Sell,2019-10-29 12:00:00,2019-10-29 14:00:00,1.1076,1.1096,0.1,-20,10660.4,SL,,None,None,None,None
882_221101007_B,165,EURUSD,Buy,2019-11-01 16:00:00,2019-11-01 21:00:00,1.11688,1.11634,0.1,-5.4,10655,End Of Friday (Time),,None,None,None,None
883_221101007_B,165,EURUSD,Sell,2019-11-07 17:00:00,2019-11-07 23:00:00,1.10548,1.1048,0.1,6.8,10661.8,Exit After X Bars,,None,None,None,None
89_221101007_B,165,EURUSD,Buy,2015-07-10 08:00:00,2015-07-10 09:00:00,1.11249,1.11049,0.1,-20,10166.7,SL,,None,None,None,None
892_221101007_B,165,EURUSD,Sell,2019-11-27 10:00:00,2019-11-27 16:00:00,1.10071,1.10042,0.1,2.9,10664.7,Exit After X Bars,,None,None,None,None
895_221101007_B,165,EURUSD,Sell,2019-11-29 13:00:00,2019-11-29 17:00:00,1.10003,1.10094,0.1,-9.1,10655.6,TrailingStop,,None,None,None,None
896_221101007_B,165,EURUSD,Buy,2019-12-02 15:00:00,2019-12-02 21:00:00,1.10282,1.10786,0.1,50.4,10706,Exit After X Bars,,None,None,None,None
898_221101007_B,165,EURUSD,Buy,2019-12-11 16:00:00,2019-12-11 22:00:00,1.10977,1.11394,0.1,41.7,10747.7,Exit After X Bars,,None,None,None,None
899_221101007_B,165,EURUSD,Buy,2019-12-13 00:00:00,2019-12-13 02:00:00,1.11541,1.11683,0.1,14.2,10761.9,TrailingStop,,None,None,None,None
902_221101007_B,165,EURUSD,Buy,2019-12-17 12:00:00,2019-12-17 15:00:00,1.11581,1.11548,0.1,-3.3,10758.6,TrailingStop,,None,None,None,None
903_221101007_B,165,EURUSD,Sell,2019-12-19 15:00:00,2019-12-19 18:00:00,1.11105,1.11305,0.1,-20,10738.6,SL,,None,None,None,None
910_221101007_B,165,EURUSD,Buy,2020-01-13 17:00:00,2020-01-13 23:00:00,1.11361,1.11376,0.1,1.5,10740.1,Exit After X Bars,,None,None,None,None
913_221101007_B,165,EURUSD,Sell,2020-01-29 11:00:00,2020-01-29 17:00:00,1.09978,1.09979,0.1,-0.1,10740,Exit After X Bars,,None,None,None,None
918_221101007_B,165,EURUSD,Buy,2020-01-31 13:00:00,2020-01-31 19:00:00,1.10393,1.10816,0.1,42.3,10782.3,Exit After X Bars,,None,None,None,None
92_221101007_B,165,EURUSD,Sell,2015-07-15 15:00:00,2015-07-15 17:00:00,1.09867,1.0975,0.1,11.7,10178.4,TrailingStop,,None,None,None,None
921_221101007_B,165,EURUSD,Sell,2020-02-20 09:00:00,2020-02-20 11:00:00,1.07822,1.08022,0.1,-20,10762.3,SL,,None,None,None,None
927_221101007_B,165,EURUSD,Buy,2020-02-24 18:00:00,2020-02-24 21:00:00,1.08635,1.08558,0.1,-7.7,10754.6,TrailingStop,,None,None,None,None
929_221101007_B,165,EURUSD,Buy,2020-02-25 18:00:00,2020-02-26 00:00:00,1.0872,1.08806,0.1,8.6,10763.2,Exit After X Bars,,None,None,None,None
930_221101007_B,165,EURUSD,Buy,2020-02-27 02:00:00,2020-02-27 08:00:00,1.09086,1.09074,0.1,-1.2,10762,Exit After X Bars,,None,None,None,None
941_221101007_B,165,EURUSD,Sell,2020-03-17 11:00:00,2020-03-17 13:00:00,1.10942,1.10192,0.1,75,10837,PT,,None,None,None,None
945_221101007_B,165,EURUSD,Sell,2020-04-01 12:00:00,2020-04-01 13:00:00,1.09265,1.09465,0.1,-20,10817,SL,,None,None,None,None
950_221101007_B,165,EURUSD,Buy,2020-04-09 12:00:00,2020-04-09 13:00:00,1.08883,1.08683,0.1,-20,10797,SL,,None,None,None,None
956_221101007_B,165,EURUSD,Sell,2020-04-21 05:00:00,2020-04-21 11:00:00,1.08411,1.08324,0.1,8.7,10805.7,Exit After X Bars,,None,None,None,None
960_221101007_B,165,EURUSD,Sell,2020-04-22 19:00:00,2020-04-23 01:00:00,1.08165,1.08247,0.1,-8.2,10797.5,Exit After X Bars,,None,None,None,None
963_221101007_B,165,EURUSD,Buy,2020-04-28 11:00:00,2020-04-28 15:00:00,1.08602,1.08716,0.1,11.4,10808.9,TrailingStop,,None,None,None,None
971_221101007_B,165,EURUSD,Buy,2020-05-13 16:00:00,2020-05-13 16:00:00,1.08851,1.08651,0.1,-20,10788.9,SL,,None,None,None,None
984_221101007_B,165,EURUSD,Buy,2020-06-09 16:00:00,2020-06-09 17:00:00,1.13185,1.13337,0.1,15.2,10804.1,TrailingStop,,None,None,None,None
986_221101007_B,165,EURUSD,Sell,2020-06-16 17:00:00,2020-06-16 18:00:00,1.12404,1.12544,0.1,-14,10790.1,TrailingStop,,None,None,None,None
987_221101007_B,165,EURUSD,Sell,2020-06-19 17:00:00,2020-06-19 18:00:00,1.11854,1.11989,0.1,-13.5,10776.6,TrailingStop,,None,None,None,None
996_221101007_B,165,EURUSD,Sell,2020-07-01 14:00:00,2020-07-01 15:00:00,1.1191,1.1211,0.1,-20,10756.6,SL,,None,None,None,None
