orderId,strategyRunId,symbol,orderType,openTime,closeTime,openPrice,closePrice,size,profit,balance,closeType,comment,sl,tp,swap,commission
4_240616001_B,178,WS30,Buy,2014-02-11 19:00:00,2014-02-13 07:00:00,15954.0,15904.0,0.3,-19.64,9980.36,SL,,None,None,None,None
5_240616001_B,178,WS30,Buy,2014-02-14 17:00:00,2014-02-18 17:00:00,16070.0,16123.0,0.3,6.83,9987.2,TrailingStop,,None,None,None,None
6_240616001_B,178,WS30,Buy,2014-02-24 07:00:00,2014-02-24 23:00:00,16078.0,16206.0,0.3,38.19,10025.39,TrailingStop,,None,None,None,None
8_240616001_B,178,WS30,Buy,2014-02-27 13:00:00,2014-02-28 21:00:00,16135.0,16309.0,0.3,49.78,10075.16,TrailingStop,,None,None,None,None
9_240616001_B,178,WS30,Buy,2014-02-28 23:00:00,2014-03-03 02:00:00,16340.0,16290.0,0.3,-17.42,10057.74,SL,,None,None,None,None
10_240616001_B,178,WS30,Buy,2014-03-18 16:00:00,2014-03-19 20:00:00,16338.0,16288.0,0.3,-17.42,10040.31,SL,,None,None,None,None
12_240616001_B,178,WS30,Buy,2014-03-21 15:00:00,2014-03-21 19:00:00,16404.0,16354.0,0.3,-15.21,10025.1,SL,,None,None,None,None
13_240616001_B,178,WS30,Buy,2014-04-01 16:00:00,2014-04-03 16:00:00,16515.0,16567.0,0.3,10.96,10036.07,Exit After X Bars,,None,None,None,None
15_240616001_B,178,WS30,Buy,2014-04-04 15:00:00,2014-04-04 16:00:00,16632.0,16582.0,0.3,-15.21,10020.86,SL,,None,None,None,None
16_240616001_B,178,WS30,Buy,2014-04-15 16:00:00,2014-04-15 17:00:00,16237.0,16187.0,0.3,-15.21,10005.65,SL,,None,None,None,None
17_240616001_B,178,WS30,Buy,2014-04-16 16:00:00,2014-04-16 17:00:00,16380.0,16330.0,0.3,-15.21,9990.44,SL,,None,None,None,None
18_240616001_B,178,WS30,Buy,2014-04-22 16:00:00,2014-04-23 16:00:00,16464.0,16491.0,0.3,5.68,9996.11,TrailingStop,,None,None,None,None
19_240616001_B,178,WS30,Buy,2014-04-30 21:00:00,2014-05-01 17:00:00,16592.0,16542.0,0.3,-17.42,9978.69,SL,,None,None,None,None
21_240616001_B,178,WS30,Buy,2014-05-02 21:00:00,2014-05-05 11:00:00,16510.0,16460.0,0.3,-17.42,9961.26,SL,,None,None,None,None
23_240616001_B,178,WS30,Buy,2014-05-23 22:00:00,2014-05-28 03:00:00,16604.0,16671.0,0.3,8.82,9970.08,Exit After X Bars,,None,None,None,None
26_240616001_B,178,WS30,Buy,2014-06-18 22:00:00,2014-06-20 22:00:00,16860.0,16946.0,0.3,21.16,9991.25,Exit After X Bars,,None,None,None,None
27_240616001_B,178,WS30,Buy,2014-07-01 16:00:00,2014-07-03 16:00:00,16893.0,17011.0,0.3,30.76,10022.01,Exit After X Bars,,None,None,None,None
32_240616001_B,178,WS30,Buy,2014-07-18 02:00:00,2014-07-21 16:00:00,16911.0,17029.0,0.3,32.98,10054.98,TrailingStop,,None,None,None,None
33_240616001_B,178,WS30,Buy,2014-07-29 16:00:00,2014-07-29 18:00:00,17040.0,16990.0,0.3,-15.21,10039.77,SL,,None,None,None,None
34_240616001_B,178,WS30,Buy,2014-07-30 21:00:00,2014-07-31 10:00:00,16872.0,16822.0,0.3,-17.42,10022.35,SL,,None,None,None,None
37_240616001_B,178,WS30,Buy,2014-08-08 06:00:00,2014-08-12 07:00:00,16297.0,16582.0,0.3,76.43,10098.78,Exit After X Bars,,None,None,None,None
38_240616001_B,178,WS30,Buy,2014-08-14 20:00:00,2014-08-15 17:00:00,16704.0,16654.0,0.3,-17.42,10081.36,SL,,None,None,None,None
39_240616001_B,178,WS30,Buy,2014-08-18 14:00:00,2014-08-20 14:00:00,16754.0,16898.0,0.3,34.13,10115.49,Exit After X Bars,,None,None,None,None
40_240616001_B,178,WS30,Buy,2014-08-20 18:00:00,2014-08-22 13:00:00,16957.0,17021.0,0.3,14.56,10130.06,TrailingStop,,None,None,None,None
41_240616001_B,178,WS30,Buy,2014-08-25 17:00:00,2014-08-26 12:00:00,17109.0,17059.0,0.3,-21.85,10108.2,SL,,None,None,None,None
42_240616001_B,178,WS30,Buy,2014-09-16 18:00:00,2014-09-17 21:00:00,17088.0,17109.0,0.3,3.88,10112.08,TrailingStop,,None,None,None,None
43_240616001_B,178,WS30,Buy,2014-09-17 22:00:00,2014-09-17 22:00:00,17217.0,17167.0,0.3,-15.21,10096.87,SL,,None,None,None,None
44_240616001_B,178,WS30,Buy,2014-09-18 21:00:00,2014-09-19 19:00:00,17255.0,17291.0,0.3,8.38,10105.25,TrailingStop,,None,None,None,None
45_240616001_B,178,WS30,Buy,2014-09-19 22:00:00,2014-09-22 04:00:00,17316.0,17266.0,0.3,-17.42,10087.82,SL,,None,None,None,None
46_240616001_B,178,WS30,Buy,2014-10-03 19:00:00,2014-10-06 18:00:00,16989.0,16992.0,0.3,-1.52,10086.3,TrailingStop,,None,None,None,None
47_240616001_B,178,WS30,Buy,2014-10-13 02:00:00,2014-10-13 22:00:00,16450.0,16400.0,0.3,-15.21,10071.09,SL,,None,None,None,None
48_240616001_B,178,WS30,Buy,2014-10-21 13:00:00,2014-10-21 14:00:00,16514.0,16464.0,0.3,-15.21,10055.88,SL,,None,None,None,None
49_240616001_B,178,WS30,Buy,2014-10-27 01:00:00,2014-10-27 11:00:00,16842.0,16792.0,0.3,-15.21,10040.67,SL,,None,None,None,None
50_240616001_B,178,WS30,Buy,2014-12-05 15:00:00,2014-12-05 15:00:00,17950.0,17900.0,0.3,-15.21,10025.46,SL,,None,None,None,None
51_240616001_B,178,WS30,Buy,2014-12-15 19:00:00,2014-12-16 13:00:00,17176.0,17126.0,0.3,-21.85,10003.61,SL,,None,None,None,None
52_240616001_B,178,WS30,Buy,2014-12-18 09:00:00,2014-12-18 10:00:00,17459.0,17409.0,0.3,-15.21,9988.4,SL,,None,None,None,None
53_240616001_B,178,WS30,Buy,2014-12-22 17:00:00,2014-12-24 17:00:00,17919.0,18067.0,0.3,35.33,10023.73,Exit After X Bars,,None,None,None,None
54_240616001_B,178,WS30,Buy,2015-01-08 03:00:00,2015-01-09 16:00:00,17670.0,17799.0,0.3,36.28,10060.01,TrailingStop,,None,None,None,None
55_240616001_B,178,WS30,Buy,2015-01-12 17:00:00,2015-01-13 19:00:00,17631.0,17790.0,0.3,40.85,10100.85,TrailingStop,,None,None,None,None
56_240616001_B,178,WS30,Buy,2015-01-20 19:00:00,2015-01-22 16:00:00,17380.0,17507.0,0.3,33.46,10134.32,TrailingStop,,None,None,None,None
57_240616001_B,178,WS30,Buy,2015-01-22 17:00:00,2015-01-23 22:00:00,17657.0,17708.0,0.3,12.88,10147.19,TrailingStop,,None,None,None,None
58_240616001_B,178,WS30,Buy,2015-02-03 16:00:00,2015-02-04 23:00:00,17474.0,17587.0,0.3,31.48,10178.67,TrailingStop,,None,None,None,None
59_240616001_B,178,WS30,Buy,2015-02-11 23:00:00,2015-02-12 00:00:00,17973.0,17923.0,0.3,-17.42,10161.24,SL,,None,None,None,None
62_240616001_B,178,WS30,Buy,2015-03-18 19:00:00,2015-03-19 11:00:00,17746.0,18014.0,0.3,77.98,10239.22,TrailingStop,,None,None,None,None
64_240616001_B,178,WS30,Buy,2015-03-30 10:00:00,2015-03-31 12:00:00,17803.0,17896.0,0.3,21.05,10260.27,TrailingStop,,None,None,None,None
66_240616001_B,178,WS30,Buy,2015-04-01 10:00:00,2015-04-01 16:00:00,17704.0,17654.0,0.3,-15.21,10245.06,SL,,None,None,None,None
68_240616001_B,178,WS30,Buy,2015-04-10 17:00:00,2015-04-13 22:00:00,18028.0,17978.0,0.3,-17.42,10227.63,SL,,None,None,None,None
69_240616001_B,178,WS30,Buy,2015-04-21 10:00:00,2015-04-21 12:00:00,18150.0,18100.0,0.3,-15.21,10212.42,SL,,None,None,None,None
70_240616001_B,178,WS30,Buy,2015-04-22 12:00:00,2015-04-23 11:00:00,17880.0,17920.0,0.3,9.58,10222,TrailingStop,,None,None,None,None
71_240616001_B,178,WS30,Buy,2015-04-23 19:00:00,2015-04-24 09:00:00,18109.0,18059.0,0.3,-17.42,10204.58,SL,,None,None,None,None
73_240616001_B,178,WS30,Buy,2015-05-08 16:00:00,2015-05-11 21:00:00,18173.0,18123.0,0.3,-17.42,10187.15,SL,,None,None,None,None
74_240616001_B,178,WS30,Buy,2015-06-02 13:00:00,2015-06-04 10:00:00,17952.0,18037.0,0.3,20.86,10208.01,TrailingStop,,None,None,None,None
76_240616001_B,178,WS30,Buy,2015-06-08 21:00:00,2015-06-09 12:00:00,17789.0,17739.0,0.3,-21.85,10186.16,SL,,None,None,None,None
77_240616001_B,178,WS30,Buy,2015-06-09 13:00:00,2015-06-12 14:00:00,17739.0,17980.0,0.3,65.45,10251.61,TrailingStop,,None,None,None,None
78_240616001_B,178,WS30,Buy,2015-06-18 18:00:00,2015-06-19 16:00:00,18144.0,18094.0,0.3,-17.42,10234.19,SL,,None,None,None,None
79_240616001_B,178,WS30,Buy,2015-06-24 13:00:00,2015-06-24 19:00:00,18089.0,18039.0,0.3,-15.21,10218.98,SL,,None,None,None,None
81_240616001_B,178,WS30,Buy,2015-07-16 09:00:00,2015-07-17 16:00:00,18107.0,18057.0,0.3,-17.42,10201.55,SL,,None,None,None,None
82_240616001_B,178,WS30,Buy,2015-07-17 18:00:00,2015-07-21 16:00:00,18048.0,17998.0,0.3,-24.07,10177.49,SL,,None,None,None,None
83_240616001_B,178,WS30,Buy,2015-07-28 09:00:00,2015-07-28 17:00:00,17500.0,17450.0,0.3,-15.21,10162.28,SL,,None,None,None,None
84_240616001_B,178,WS30,Buy,2015-07-29 17:00:00,2015-07-30 16:00:00,17702.0,17652.0,0.3,-17.42,10144.85,SL,,None,None,None,None
88_240616001_B,178,WS30,Buy,2015-08-12 20:00:00,2015-08-17 16:00:00,17307.0,17365.0,0.3,10.55,10155.4,TrailingStop,,None,None,None,None
89_240616001_B,178,WS30,Buy,2015-08-24 19:00:00,2015-08-24 19:00:00,16348.0,16298.0,0.3,-15.21,10140.19,SL,,None,None,None,None
92_240616001_B,178,WS30,Buy,2015-09-17 21:00:00,2015-09-17 22:00:00,16803.0,16753.0,0.3,-15.21,10124.98,SL,,None,None,None,None
93_240616001_B,178,WS30,Buy,2015-09-21 17:00:00,2015-09-21 18:00:00,16574.0,16524.0,0.3,-15.21,10109.77,SL,,None,None,None,None
94_240616001_B,178,WS30,Buy,2015-10-05 16:00:00,2015-10-08 19:00:00,16636.0,16936.0,0.3,78.72,10188.49,Exit After X Bars,,None,None,None,None
95_240616001_B,178,WS30,Buy,2015-10-08 21:00:00,2015-10-14 09:00:00,17017.0,17064.0,0.3,0.61,10189.1,Exit After X Bars,,None,None,None,None
97_240616001_B,178,WS30,Buy,2015-11-05 18:00:00,2015-11-09 17:00:00,17798.0,17748.0,0.3,-19.64,10169.46,SL,,None,None,None,None
98_240616001_B,178,WS30,Buy,2015-11-16 09:00:00,2015-11-19 12:00:00,17183.0,17801.0,0.3,174.12,10343.58,Exit After X Bars,,None,None,None,None
100_240616001_B,178,WS30,Buy,2015-12-15 11:00:00,2015-12-15 15:00:00,17468.0,17418.0,0.3,-15.21,10328.37,SL,,None,None,None,None
101_240616001_B,178,WS30,Buy,2015-12-16 21:00:00,2015-12-17 17:00:00,17701.0,17651.0,0.3,-17.42,10310.94,SL,,None,None,None,None
103_240616001_B,178,WS30,Buy,2015-12-18 12:00:00,2015-12-18 13:00:00,17419.0,17369.0,0.3,-15.21,10295.73,SL,,None,None,None,None
104_240616001_B,178,WS30,Buy,2015-12-22 09:00:00,2015-12-22 10:00:00,17323.0,17273.0,0.3,-15.21,10280.52,SL,,None,None,None,None
105_240616001_B,178,WS30,Buy,2015-12-23 13:00:00,2015-12-28 13:00:00,17515.0,17465.0,0.3,-21.85,10258.67,SL,,None,None,None,None
106_240616001_B,178,WS30,Buy,2016-01-12 14:00:00,2016-01-12 17:00:00,16524.0,16474.0,0.3,-15.21,10243.46,SL,,None,None,None,None
109_240616001_B,178,WS30,Buy,2016-01-20 22:00:00,2016-01-20 23:00:00,15816.0,15766.0,0.3,-15.21,10228.25,SL,,None,None,None,None
110_240616001_B,178,WS30,Buy,2016-02-08 22:00:00,2016-02-09 09:00:00,16054.0,16004.0,0.3,-21.85,10206.4,SL,,None,None,None,None
113_240616001_B,178,WS30,Buy,2016-02-19 14:00:00,2016-02-19 16:00:00,16357.0,16307.0,0.3,-15.21,10191.19,SL,,None,None,None,None
114_240616001_B,178,WS30,Buy,2016-03-04 14:00:00,2016-03-04 16:00:00,16979.0,16929.0,0.3,-15.21,10175.98,SL,,None,None,None,None
116_240616001_B,178,WS30,Buy,2016-04-01 11:00:00,2016-04-01 15:00:00,17644.0,17594.0,0.3,-15.21,10160.77,SL,,None,None,None,None
117_240616001_B,178,WS30,Buy,2016-04-13 10:00:00,2016-04-18 09:00:00,17799.0,17830.0,0.3,2.45,10163.22,TrailingStop,,None,None,None,None
122_240616001_B,178,WS30,Buy,2016-05-25 16:00:00,2016-05-30 19:00:00,17816.0,17912.0,0.3,21.95,10185.17,Exit After X Bars,,None,None,None,None
123_240616001_B,178,WS30,Buy,2016-06-07 11:00:00,2016-06-07 22:00:00,17990.0,17940.0,0.3,-15.21,10169.96,SL,,None,None,None,None
129_240616001_B,178,WS30,Buy,2016-06-29 09:00:00,2016-07-04 12:00:00,17454.0,17971.0,0.3,148.25,10318.2,Exit After X Bars,,None,None,None,None
131_240616001_B,178,WS30,Buy,2016-07-14 09:00:00,2016-07-19 12:00:00,18414.0,18499.0,0.3,14.22,10332.42,Exit After X Bars,,None,None,None,None
134_240616001_B,178,WS30,Buy,2016-08-31 18:00:00,2016-08-31 19:00:00,18386.0,18336.0,0.3,-15.21,10317.21,SL,,None,None,None,None
135_240616001_B,178,WS30,Buy,2016-09-12 15:00:00,2016-09-13 10:00:00,18001.0,18220.0,0.3,58.85,10376.06,TrailingStop,,None,None,None,None
137_240616001_B,178,WS30,Buy,2016-09-22 12:00:00,2016-09-23 19:00:00,18314.0,18324.0,0.3,0.58,10376.64,TrailingStop,,None,None,None,None
143_240616001_B,178,WS30,Buy,2016-10-21 18:00:00,2016-10-25 19:00:00,18104.0,18159.0,0.3,7.43,10384.07,TrailingStop,,None,None,None,None
145_240616001_B,178,WS30,Buy,2016-11-08 18:00:00,2016-11-09 09:00:00,18311.0,18261.0,0.3,-17.42,10366.65,SL,,None,None,None,None
146_240616001_B,178,WS30,Buy,2016-11-09 18:00:00,2016-11-14 21:00:00,18457.0,18847.0,0.3,110.15,10476.8,Exit After X Bars,,None,None,None,None
147_240616001_B,178,WS30,Buy,2016-11-22 18:00:00,2016-11-28 13:00:00,18983.0,19111.0,0.3,29.33,10506.13,Exit After X Bars,,None,None,None,None
148_240616001_B,178,WS30,Buy,2016-12-08 19:00:00,2016-12-13 22:00:00,19645.0,19914.0,0.3,69.42,10575.55,Exit After X Bars,,None,None,None,None
150_240616001_B,178,WS30,Buy,2016-12-22 10:00:00,2016-12-28 13:00:00,19934.0,19967.0,0.3,-3.59,10571.96,Exit After X Bars,,None,None,None,None
152_240616001_B,178,WS30,Buy,2017-01-24 19:00:00,2017-01-27 22:00:00,19897.0,20087.0,0.3,50.15,10622.1,Exit After X Bars,,None,None,None,None
154_240616001_B,178,WS30,Buy,2017-03-03 09:00:00,2017-03-06 10:00:00,20965.0,20915.0,0.3,-17.42,10604.68,SL,,None,None,None,None
155_240616001_B,178,WS30,Buy,2017-03-27 11:00:00,2017-03-27 16:00:00,20491.0,20441.0,0.3,-15.21,10589.47,SL,,None,None,None,None
157_240616001_B,178,WS30,Buy,2017-04-05 16:00:00,2017-04-05 22:00:00,20788.0,20738.0,0.3,-15.21,10574.26,SL,,None,None,None,None
160_240616001_B,178,WS30,Buy,2017-04-24 09:00:00,2017-04-27 12:00:00,20690.0,20971.0,0.3,73.02,10647.28,Exit After X Bars,,None,None,None,None
161_240616001_B,178,WS30,Buy,2017-04-27 18:00:00,2017-05-01 19:00:00,20955.0,20905.0,0.3,-19.64,10627.64,SL,,None,None,None,None
162_240616001_B,178,WS30,Buy,2017-05-16 16:00:00,2017-05-16 17:00:00,21030.0,20980.0,0.3,-15.21,10612.43,SL,,None,None,None,None
164_240616001_B,178,WS30,Buy,2017-05-23 14:00:00,2017-05-23 16:00:00,20951.0,20901.0,0.3,-15.21,10597.22,SL,,None,None,None,None
165_240616001_B,178,WS30,Buy,2017-05-24 21:00:00,2017-05-30 12:00:00,20991.0,21067.0,0.3,9.31,10606.53,Exit After X Bars,,None,None,None,None
168_240616001_B,178,WS30,Buy,2017-07-06 18:00:00,2017-07-06 22:00:00,21379.0,21329.0,0.3,-15.21,10591.32,SL,,None,None,None,None
169_240616001_B,178,WS30,Buy,2017-07-14 19:00:00,2017-07-18 17:00:00,21585.0,21535.0,0.3,-24.07,10567.25,SL,,None,None,None,None
170_240616001_B,178,WS30,Buy,2017-07-27 16:00:00,2017-07-27 19:00:00,21778.0,21728.0,0.3,-15.21,10552.04,SL,,None,None,None,None
171_240616001_B,178,WS30,Buy,2017-07-28 22:00:00,2017-08-03 10:00:00,21821.0,21999.0,0.3,39.91,10591.95,Exit After X Bars,,None,None,None,None
172_240616001_B,178,WS30,Buy,2017-08-15 10:00:00,2017-08-15 17:00:00,22035.0,21985.0,0.3,-15.21,10576.74,SL,,None,None,None,None
174_240616001_B,178,WS30,Buy,2017-08-18 17:00:00,2017-08-21 16:00:00,21687.0,21637.0,0.3,-17.42,10559.31,SL,,None,None,None,None
175_240616001_B,178,WS30,Buy,2017-08-22 13:00:00,2017-08-23 16:00:00,21750.0,21806.0,0.3,14.38,10573.69,TrailingStop,,None,None,None,None
177_240616001_B,178,WS30,Buy,2017-09-12 14:00:00,2017-09-15 20:00:00,22109.0,22239.0,0.3,32.15,10605.84,Exit After X Bars,,None,None,None,None
178_240616001_B,178,WS30,Buy,2017-09-15 20:00:00,2017-09-20 21:00:00,22242.0,22331.0,0.3,15.42,10621.26,TrailingStop,,None,None,None,None
179_240616001_B,178,WS30,Buy,2017-10-04 18:00:00,2017-10-09 22:00:00,22666.0,22740.0,0.3,15.35,10636.61,TrailingStop,,None,None,None,None
180_240616001_B,178,WS30,Buy,2017-10-20 09:00:00,2017-10-23 22:00:00,23212.0,23288.0,0.3,20.38,10656.98,TrailingStop,,None,None,None,None
181_240616001_B,178,WS30,Buy,2017-11-13 16:00:00,2017-11-14 17:00:00,23363.0,23313.0,0.3,-21.85,10635.13,SL,,None,None,None,None
182_240616001_B,178,WS30,Buy,2017-11-20 12:00:00,2017-11-22 18:00:00,23334.0,23543.0,0.3,53.63,10688.76,TrailingStop,,None,None,None,None
184_240616001_B,178,WS30,Buy,2017-11-23 10:00:00,2017-11-27 18:00:00,23481.0,23551.0,0.3,16.36,10705.13,TrailingStop,,None,None,None,None
185_240616001_B,178,WS30,Buy,2017-11-30 12:00:00,2017-12-01 12:00:00,23994.0,24187.0,0.3,55.48,10760.6,TrailingStop,,None,None,None,None
186_240616001_B,178,WS30,Buy,2017-12-04 09:00:00,2017-12-04 21:00:00,24421.0,24371.0,0.3,-15.21,10745.39,SL,,None,None,None,None
187_240616001_B,178,WS30,Buy,2017-12-12 10:00:00,2017-12-14 20:00:00,24413.0,24557.0,0.3,38.56,10783.95,TrailingStop,,None,None,None,None
189_240616001_B,178,WS30,Buy,2017-12-29 09:00:00,2017-12-29 17:00:00,24854.0,24804.0,0.3,-15.21,10768.74,SL,,None,None,None,None
190_240616001_B,178,WS30,Buy,2018-01-04 11:00:00,2018-01-08 14:00:00,24971.0,25276.0,0.3,86.86,10855.61,TrailingStop,,None,None,None,None
191_240616001_B,178,WS30,Buy,2018-01-26 19:00:00,2018-01-29 18:00:00,26511.0,26461.0,0.3,-17.42,10838.18,SL,,None,None,None,None
192_240616001_B,178,WS30,Buy,2018-02-05 16:00:00,2018-02-05 17:00:00,25332.0,25282.0,0.3,-15.21,10822.97,SL,,None,None,None,None
194_240616001_B,178,WS30,Buy,2018-02-14 09:00:00,2018-02-14 15:00:00,24789.0,24739.0,0.3,-15.21,10807.76,SL,,None,None,None,None
195_240616001_B,178,WS30,Buy,2018-02-15 10:00:00,2018-02-15 15:00:00,25078.0,25028.0,0.3,-15.21,10792.55,SL,,None,None,None,None
196_240616001_B,178,WS30,Buy,2018-02-16 09:00:00,2018-02-16 15:00:00,25301.0,25251.0,0.3,-15.21,10777.34,SL,,None,None,None,None
200_240616001_B,178,WS30,Buy,2018-03-07 15:00:00,2018-03-07 15:00:00,24629.0,24579.0,0.3,-15.21,10762.13,SL,,None,None,None,None
201_240616001_B,178,WS30,Buy,2018-03-08 16:00:00,2018-03-08 16:00:00,24944.0,24894.0,0.3,-15.21,10746.92,SL,,None,None,None,None
202_240616001_B,178,WS30,Buy,2018-03-09 15:00:00,2018-03-12 17:00:00,25016.0,25196.0,0.3,51.58,10798.5,TrailingStop,,None,None,None,None
204_240616001_B,178,WS30,Buy,2018-03-22 10:00:00,2018-03-22 11:00:00,24578.0,24528.0,0.3,-15.21,10783.29,SL,,None,None,None,None
205_240616001_B,178,WS30,Buy,2018-03-27 09:00:00,2018-03-27 11:00:00,24356.0,24306.0,0.3,-15.21,10768.08,SL,,None,None,None,None
207_240616001_B,178,WS30,Buy,2018-04-17 08:00:00,2018-04-19 10:00:00,24696.0,24773.0,0.3,18.46,10786.54,Exit After X Bars,,None,None,None,None
209_240616001_B,178,WS30,Buy,2018-04-20 19:00:00,2018-04-20 19:00:00,24494.0,24444.0,0.3,-15.21,10771.33,SL,,None,None,None,None
210_240616001_B,178,WS30,Buy,2018-05-10 17:00:00,2018-05-14 19:00:00,24659.0,24949.0,0.3,82.36,10853.69,Exit After X Bars,,None,None,None,None
212_240616001_B,178,WS30,Buy,2018-05-23 16:00:00,2018-05-23 17:00:00,24757.0,24707.0,0.3,-15.21,10838.48,SL,,None,None,None,None
213_240616001_B,178,WS30,Buy,2018-05-30 20:00:00,2018-05-30 22:00:00,24690.0,24640.0,0.3,-15.21,10823.27,SL,,None,None,None,None
215_240616001_B,178,WS30,Buy,2018-06-06 07:00:00,2018-06-08 09:00:00,24898.0,25206.0,0.3,87.76,10911.03,Exit After X Bars,,None,None,None,None
216_240616001_B,178,WS30,Buy,2018-06-11 10:00:00,2018-06-11 13:00:00,25377.0,25327.0,0.3,-15.21,10895.82,SL,,None,None,None,None
219_240616001_B,178,WS30,Buy,2018-07-05 12:00:00,2018-07-05 17:00:00,24308.0,24258.0,0.3,-15.21,10880.61,SL,,None,None,None,None
220_240616001_B,178,WS30,Buy,2018-07-06 18:00:00,2018-07-10 20:00:00,24439.0,24901.0,0.3,129.53,11010.15,Exit After X Bars,,None,None,None,None
222_240616001_B,178,WS30,Buy,2018-07-13 07:00:00,2018-07-13 10:00:00,25006.0,24956.0,0.3,-15.21,10994.94,SL,,None,None,None,None
223_240616001_B,178,WS30,Buy,2018-07-25 22:00:00,2018-07-27 19:00:00,25349.0,25462.0,0.3,29.26,11024.2,TrailingStop,,None,None,None,None
226_240616001_B,178,WS30,Buy,2018-08-09 04:00:00,2018-08-10 01:00:00,25533.0,25483.0,0.3,-17.42,11006.78,SL,,None,None,None,None
227_240616001_B,178,WS30,Buy,2018-08-10 04:00:00,2018-08-10 08:00:00,25467.0,25417.0,0.3,-15.21,10991.57,SL,,None,None,None,None
231_240616001_B,178,WS30,Buy,2018-09-18 20:00:00,2018-09-20 22:00:00,26247.0,26679.0,0.3,124.96,11116.53,Exit After X Bars,,None,None,None,None
232_240616001_B,178,WS30,Buy,2018-09-21 10:00:00,2018-09-21 14:00:00,26772.0,26722.0,0.3,-15.21,11101.32,SL,,None,None,None,None
233_240616001_B,178,WS30,Buy,2018-10-02 19:00:00,2018-10-02 22:00:00,26795.0,26745.0,0.3,-15.21,11086.11,SL,,None,None,None,None
234_240616001_B,178,WS30,Buy,2018-10-03 15:00:00,2018-10-03 21:00:00,26901.0,26851.0,0.3,-15.21,11070.9,SL,,None,None,None,None
236_240616001_B,178,WS30,Buy,2018-10-05 19:00:00,2018-10-05 20:00:00,26396.0,26346.0,0.3,-15.21,11055.69,SL,,None,None,None,None
241_240616001_B,178,WS30,Buy,2018-11-02 06:00:00,2018-11-02 16:00:00,25481.0,25431.0,0.3,-15.21,11040.48,SL,,None,None,None,None
243_240616001_B,178,WS30,Buy,2018-11-28 01:00:00,2018-11-30 03:00:00,24769.0,25345.0,0.3,168.16,11208.64,Exit After X Bars,,None,None,None,None
244_240616001_B,178,WS30,Buy,2018-11-30 23:00:00,2018-12-03 16:00:00,25552.0,25875.0,0.3,94.48,11303.12,TrailingStop,,None,None,None,None
245_240616001_B,178,WS30,Buy,2018-12-10 19:00:00,2018-12-11 18:00:00,24095.0,24480.0,0.3,108.65,11411.76,TrailingStop,,None,None,None,None
248_240616001_B,178,WS30,Buy,2018-12-14 04:00:00,2018-12-14 07:00:00,24414.0,24364.0,0.3,-15.21,11396.55,SL,,None,None,None,None
249_240616001_B,178,WS30,Buy,2018-12-17 17:00:00,2018-12-17 19:00:00,23904.0,23854.0,0.3,-15.21,11381.34,SL,,None,None,None,None
250_240616001_B,178,WS30,Buy,2018-12-24 17:00:00,2018-12-24 18:00:00,22174.0,22124.0,0.3,-15.21,11366.13,SL,,None,None,None,None
252_240616001_B,178,WS30,Buy,2019-01-04 19:00:00,2019-01-04 20:00:00,23449.0,23399.0,0.3,-15.21,11350.92,SL,,None,None,None,None
254_240616001_B,178,WS30,Buy,2019-01-16 09:00:00,2019-01-16 11:00:00,24116.0,24066.0,0.3,-15.21,11335.71,SL,,None,None,None,None
255_240616001_B,178,WS30,Buy,2019-02-01 17:00:00,2019-02-01 17:00:00,25140.0,25090.0,0.3,-15.21,11320.5,SL,,None,None,None,None
256_240616001_B,178,WS30,Buy,2019-02-13 02:00:00,2019-02-14 15:00:00,25477.0,25427.0,0.3,-17.42,11303.08,SL,,None,None,None,None
258_240616001_B,178,WS30,Buy,2019-03-11 19:00:00,2019-03-12 13:00:00,25579.0,25591.0,0.3,-3.25,11299.83,TrailingStop,,None,None,None,None
261_240616001_B,178,WS30,Buy,2019-03-25 09:00:00,2019-03-26 18:00:00,25390.0,25606.0,0.3,57.95,11357.78,TrailingStop,,None,None,None,None
263_240616001_B,178,WS30,Buy,2019-03-29 02:00:00,2019-03-29 03:00:00,25803.0,25753.0,0.3,-15.21,11342.57,SL,,None,None,None,None
264_240616001_B,178,WS30,Buy,2019-04-05 15:00:00,2019-04-05 17:00:00,26455.0,26405.0,0.3,-15.21,11327.36,SL,,None,None,None,None
266_240616001_B,178,WS30,Buy,2019-06-03 04:00:00,2019-06-03 07:00:00,24694.0,24644.0,0.3,-15.21,11312.15,SL,,None,None,None,None
267_240616001_B,178,WS30,Buy,2019-06-04 14:00:00,2019-06-06 16:00:00,25015.0,25557.0,0.3,157.96,11470.11,Exit After X Bars,,None,None,None,None
268_240616001_B,178,WS30,Buy,2019-06-06 17:00:00,2019-06-10 03:00:00,25608.0,26091.0,0.3,140.26,11610.37,TrailingStop,,None,None,None,None
269_240616001_B,178,WS30,Buy,2019-06-18 13:00:00,2019-06-20 15:00:00,26239.0,26743.0,0.3,146.56,11756.93,Exit After X Bars,,None,None,None,None
270_240616001_B,178,WS30,Buy,2019-06-21 18:00:00,2019-06-21 18:00:00,26877.0,26827.0,0.3,-15.21,11741.72,SL,,None,None,None,None
272_240616001_B,178,WS30,Buy,2019-07-11 18:00:00,2019-07-15 20:00:00,27021.0,27300.0,0.3,79.06,11820.78,Exit After X Bars,,None,None,None,None
273_240616001_B,178,WS30,Buy,2019-07-23 13:00:00,2019-07-23 18:00:00,27259.0,27209.0,0.3,-15.21,11805.57,SL,,None,None,None,None
275_240616001_B,178,WS30,Buy,2019-07-25 17:00:00,2019-07-25 19:00:00,27154.0,27104.0,0.3,-15.21,11790.36,SL,,None,None,None,None
276_240616001_B,178,WS30,Buy,2019-08-05 12:00:00,2019-08-05 14:00:00,26146.0,26096.0,0.3,-15.21,11775.15,SL,,None,None,None,None
278_240616001_B,178,WS30,Buy,2019-08-22 16:00:00,2019-08-22 17:00:00,26367.0,26317.0,0.3,-15.21,11759.94,SL,,None,None,None,None
279_240616001_B,178,WS30,Buy,2019-08-27 15:00:00,2019-08-27 16:00:00,26035.0,25985.0,0.3,-15.21,11744.73,SL,,None,None,None,None
280_240616001_B,178,WS30,Buy,2019-08-29 10:00:00,2019-08-30 18:00:00,26160.0,26345.0,0.3,53.08,11797.81,TrailingStop,,None,None,None,None
281_240616001_B,178,WS30,Buy,2019-09-05 04:00:00,2019-09-09 06:00:00,26526.0,26839.0,0.3,89.26,11887.07,Exit After X Bars,,None,None,None,None
282_240616001_B,178,WS30,Buy,2019-09-23 12:00:00,2019-09-24 18:00:00,26841.0,26942.0,0.3,23.45,11910.52,TrailingStop,,None,None,None,None
283_240616001_B,178,WS30,Buy,2019-10-01 04:00:00,2019-10-01 12:00:00,27044.0,26994.0,0.3,-15.21,11895.31,SL,,None,None,None,None
284_240616001_B,178,WS30,Buy,2019-10-11 11:00:00,2019-10-11 23:00:00,26725.0,26769.0,0.3,12.99,11908.3,TrailingStop,,None,None,None,None
285_240616001_B,178,WS30,Buy,2019-10-23 05:00:00,2019-10-23 14:00:00,26749.0,26699.0,0.3,-15.21,11893.09,SL,,None,None,None,None
286_240616001_B,178,WS30,Buy,2019-11-26 03:00:00,2019-11-26 10:00:00,28106.0,28056.0,0.3,-15.21,11877.88,SL,,None,None,None,None
289_240616001_B,178,WS30,Buy,2019-12-19 18:00:00,2019-12-23 20:00:00,28343.0,28559.0,0.3,60.16,11938.04,Exit After X Bars,,None,None,None,None
290_240616001_B,178,WS30,Buy,2020-01-10 06:00:00,2020-01-10 15:00:00,29041.0,28991.0,0.3,-15.21,11922.83,SL,,None,None,None,None
291_240616001_B,178,WS30,Buy,2020-01-17 10:00:00,2020-01-17 16:00:00,29370.0,29320.0,0.3,-15.21,11907.62,SL,,None,None,None,None
292_240616001_B,178,WS30,Buy,2020-01-27 02:00:00,2020-01-27 04:00:00,28742.0,28692.0,0.3,-15.21,11892.41,SL,,None,None,None,None
293_240616001_B,178,WS30,Buy,2020-02-04 11:00:00,2020-02-06 13:00:00,28741.0,29367.0,0.3,183.16,12075.57,Exit After X Bars,,None,None,None,None
294_240616001_B,178,WS30,Buy,2020-02-06 13:00:00,2020-02-06 14:00:00,29448.0,29398.0,0.3,-15.21,12060.36,SL,,None,None,None,None
297_240616001_B,178,WS30,Buy,2020-03-02 18:00:00,2020-03-02 20:00:00,26038.0,25988.0,0.3,-15.21,12045.15,SL,,None,None,None,None
300_240616001_B,178,WS30,Buy,2020-03-06 17:00:00,2020-03-06 18:00:00,25699.0,25649.0,0.3,-15.21,12029.94,SL,,None,None,None,None
301_240616001_B,178,WS30,Buy,2020-03-23 11:00:00,2020-03-23 11:00:00,18647.0,18597.0,0.3,-15.21,12014.73,SL,,None,None,None,None
302_240616001_B,178,WS30,Buy,2020-03-24 18:00:00,2020-03-24 18:00:00,20341.0,20291.0,0.3,-15.21,11999.52,SL,,None,None,None,None
303_240616001_B,178,WS30,Buy,2020-03-25 09:00:00,2020-03-25 10:00:00,21233.0,21183.0,0.3,-15.21,11984.31,SL,,None,None,None,None
304_240616001_B,178,WS30,Buy,2020-03-26 17:00:00,2020-03-26 18:00:00,22411.0,22361.0,0.3,-15.21,11969.1,SL,,None,None,None,None
307_240616001_B,178,WS30,Buy,2020-04-09 16:00:00,2020-04-09 17:00:00,23787.0,23737.0,0.3,-15.21,11953.89,SL,,None,None,None,None
308_240616001_B,178,WS30,Buy,2020-04-28 12:00:00,2020-04-28 17:00:00,24351.0,24301.0,0.3,-15.21,11938.68,SL,,None,None,None,None
309_240616001_B,178,WS30,Buy,2020-04-29 19:00:00,2020-04-29 21:00:00,24683.0,24633.0,0.3,-15.21,11923.47,SL,,None,None,None,None
311_240616001_B,178,WS30,Buy,2020-05-01 16:00:00,2020-05-01 16:00:00,24022.0,23972.0,0.3,-15.21,11908.26,SL,,None,None,None,None
312_240616001_B,178,WS30,Buy,2020-05-08 22:00:00,2020-05-11 13:00:00,24290.0,24240.0,0.3,-17.42,11890.84,SL,,None,None,None,None
313_240616001_B,178,WS30,Buy,2020-05-18 05:00:00,2020-05-19 09:00:00,23866.0,24821.0,0.3,279.65,12170.49,PT,,None,None,None,None
316_240616001_B,178,WS30,Buy,2020-05-22 09:00:00,2020-05-22 10:00:00,24278.0,24228.0,0.3,-15.21,12155.28,SL,,None,None,None,None
317_240616001_B,178,WS30,Buy,2020-05-29 19:00:00,2020-05-29 19:00:00,25248.0,25198.0,0.3,-15.21,12140.07,SL,,None,None,None,None
318_240616001_B,178,WS30,Buy,2020-06-16 05:00:00,2020-06-16 09:00:00,26176.0,26126.0,0.3,-15.21,12124.86,SL,,None,None,None,None
320_240616001_B,178,WS30,Buy,2020-06-18 06:00:00,2020-06-18 15:00:00,25932.0,25882.0,0.3,-15.21,12109.65,SL,,None,None,None,None
321_240616001_B,178,WS30,Buy,2020-06-30 22:00:00,2020-06-30 22:00:00,25824.0,25774.0,0.3,-15.21,12094.44,SL,,None,None,None,None
322_240616001_B,178,WS30,Buy,2020-07-01 16:00:00,2020-07-01 16:00:00,26022.0,25972.0,0.3,-15.21,12079.23,SL,,None,None,None,None
323_240616001_B,178,WS30,Buy,2020-07-07 02:00:00,2020-07-07 04:00:00,26351.0,26301.0,0.3,-15.21,12064.02,SL,,None,None,None,None
326_240616001_B,178,WS30,Buy,2020-08-03 18:00:00,2020-08-03 19:00:00,26684.0,26634.0,0.3,-15.21,12048.81,SL,,None,None,None,None
327_240616001_B,178,WS30,Buy,2020-08-05 09:00:00,2020-08-06 13:00:00,26909.0,27066.0,0.3,44.68,12093.48,TrailingStop,,None,None,None,None
328_240616001_B,178,WS30,Buy,2020-08-06 21:00:00,2020-08-07 05:00:00,27329.0,27279.0,0.3,-17.42,12076.06,SL,,None,None,None,None
329_240616001_B,178,WS30,Buy,2020-08-10 06:00:00,2020-08-11 22:00:00,27498.0,27923.0,0.3,120.65,12196.71,TrailingStop,,None,None,None,None
330_240616001_B,178,WS30,Buy,2020-08-25 04:00:00,2020-08-25 16:00:00,28416.0,28366.0,0.3,-15.21,12181.5,SL,,None,None,None,None
331_240616001_B,178,WS30,Buy,2020-08-27 16:00:00,2020-08-27 19:00:00,28423.0,28373.0,0.3,-15.21,12166.29,SL,,None,None,None,None
332_240616001_B,178,WS30,Buy,2020-08-28 06:00:00,2020-08-28 07:00:00,28738.0,28688.0,0.3,-15.21,12151.08,SL,,None,None,None,None
334_240616001_B,178,WS30,Buy,2020-09-14 08:00:00,2020-09-14 11:00:00,27929.0,27879.0,0.3,-15.21,12135.87,SL,,None,None,None,None
335_240616001_B,178,WS30,Buy,2020-09-15 12:00:00,2020-09-15 16:00:00,28176.0,28126.0,0.3,-15.21,12120.66,SL,,None,None,None,None
336_240616001_B,178,WS30,Buy,2020-09-16 21:00:00,2020-09-16 21:00:00,28323.0,28273.0,0.3,-15.21,12105.45,SL,,None,None,None,None
339_240616001_B,178,WS30,Buy,2020-09-30 09:00:00,2020-09-30 22:00:00,27246.0,27671.0,0.3,127.29,12232.74,TrailingStop,,None,None,None,None
341_240616001_B,178,WS30,Buy,2020-10-06 04:00:00,2020-10-06 09:00:00,28184.0,28134.0,0.3,-15.21,12217.53,SL,,None,None,None,None
342_240616001_B,178,WS30,Buy,2020-10-09 18:00:00,2020-10-09 19:00:00,28640.0,28590.0,0.3,-15.21,12202.32,SL,,None,None,None,None
344_240616001_B,178,WS30,Buy,2020-11-02 11:00:00,2020-11-02 16:00:00,26768.0,26718.0,0.3,-15.21,12187.11,SL,,None,None,None,None
345_240616001_B,178,WS30,Buy,2020-11-03 10:00:00,2020-11-04 02:00:00,27236.0,27304.0,0.3,17.98,12205.08,TrailingStop,,None,None,None,None
346_240616001_B,178,WS30,Buy,2020-11-04 16:00:00,2020-11-05 01:00:00,27815.0,27765.0,0.3,-17.42,12187.66,SL,,None,None,None,None
348_240616001_B,178,WS30,Buy,2020-11-09 03:00:00,2020-11-09 04:00:00,28674.0,28624.0,0.3,-15.21,12172.45,SL,,None,None,None,None
349_240616001_B,178,WS30,Buy,2020-11-24 03:00:00,2020-11-25 16:00:00,29793.0,29948.0,0.3,44.08,12216.53,TrailingStop,,None,None,None,None
351_240616001_B,178,WS30,Buy,2020-12-21 01:00:00,2020-12-21 01:00:00,30377.0,30327.0,0.3,-15.21,12201.32,SL,,None,None,None,None
352_240616001_B,178,WS30,Buy,2020-12-28 03:00:00,2020-12-29 17:00:00,30296.0,30414.0,0.3,28.55,12229.86,TrailingStop,,None,None,None,None
354_240616001_B,178,WS30,Buy,2020-12-31 22:00:00,2021-01-04 02:00:00,30575.0,30525.0,0.3,-19.64,12210.23,SL,,None,None,None,None
355_240616001_B,178,WS30,Buy,2021-01-19 02:00:00,2021-01-21 04:00:00,30894.0,31211.0,0.3,90.46,12300.69,Exit After X Bars,,None,None,None,None
358_240616001_B,178,WS30,Buy,2021-02-02 16:00:00,2021-02-03 17:00:00,30505.0,30517.0,0.3,1.18,12301.86,TrailingStop,,None,None,None,None
360_240616001_B,178,WS30,Buy,2021-02-04 16:00:00,2021-02-08 18:00:00,30886.0,31300.0,0.3,119.56,12421.43,Exit After X Bars,,None,None,None,None
362_240616001_B,178,WS30,Buy,2021-03-04 02:00:00,2021-03-04 05:00:00,31161.0,31111.0,0.3,-15.21,12406.22,SL,,None,None,None,None
363_240616001_B,178,WS30,Buy,2021-03-12 22:00:00,2021-03-15 17:00:00,32757.0,32707.0,0.3,-17.42,12388.79,SL,,None,None,None,None
364_240616001_B,178,WS30,Buy,2021-05-05 18:00:00,2021-05-05 19:00:00,34293.0,34243.0,0.3,-15.21,12373.58,SL,,None,None,None,None
365_240616001_B,178,WS30,Buy,2021-05-06 18:00:00,2021-05-06 21:00:00,34405.0,34355.0,0.3,-15.21,12358.37,SL,,None,None,None,None
366_240616001_B,178,WS30,Buy,2021-05-07 14:00:00,2021-05-07 15:00:00,34652.0,34602.0,0.3,-15.21,12343.16,SL,,None,None,None,None
367_240616001_B,178,WS30,Buy,2021-06-01 12:00:00,2021-06-01 16:00:00,34718.0,34668.0,0.3,-15.21,12327.95,SL,,None,None,None,None
368_240616001_B,178,WS30,Buy,2021-06-14 19:00:00,2021-06-14 19:00:00,34257.0,34207.0,0.3,-15.21,12312.74,SL,,None,None,None,None
369_240616001_B,178,WS30,Buy,2021-06-21 07:00:00,2021-06-22 16:00:00,33109.0,33763.0,0.3,189.35,12502.09,TrailingStop,,None,None,None,None
372_240616001_B,178,WS30,Buy,2021-06-25 04:00:00,2021-06-25 09:00:00,34327.0,34277.0,0.3,-15.21,12486.88,SL,,None,None,None,None
373_240616001_B,178,WS30,Buy,2021-07-19 08:00:00,2021-07-19 10:00:00,34543.0,34493.0,0.3,-15.21,12471.67,SL,,None,None,None,None
374_240616001_B,178,WS30,Buy,2021-07-23 12:00:00,2021-07-26 04:00:00,34957.0,34907.0,0.3,-17.42,12454.25,SL,,None,None,None,None
375_240616001_B,178,WS30,Buy,2021-08-13 15:00:00,2021-08-13 17:00:00,35569.0,35519.0,0.3,-15.21,12439.04,SL,,None,None,None,None
377_240616001_B,178,WS30,Buy,2021-08-25 08:00:00,2021-08-26 18:00:00,35322.0,35272.0,0.3,-17.42,12421.61,SL,,None,None,None,None
381_240616001_B,178,WS30,Buy,2021-09-22 21:00:00,2021-09-22 21:00:00,34438.0,34388.0,0.3,-15.21,12406.4,SL,,None,None,None,None
382_240616001_B,178,WS30,Buy,2021-10-15 15:00:00,2021-10-18 16:00:00,35117.0,35067.0,0.3,-17.42,12388.98,SL,,None,None,None,None
385_240616001_B,178,WS30,Buy,2021-11-25 03:00:00,2021-11-25 15:00:00,35896.0,35846.0,0.3,-15.21,12373.77,SL,,None,None,None,None
388_240616001_B,178,WS30,Buy,2021-12-07 11:00:00,2021-12-09 13:00:00,35541.0,35645.0,0.3,26.56,12400.33,Exit After X Bars,,None,None,None,None
389_240616001_B,178,WS30,Buy,2021-12-20 06:00:00,2021-12-20 07:00:00,35109.0,35059.0,0.3,-15.21,12385.12,SL,,None,None,None,None
390_240616001_B,178,WS30,Buy,2021-12-23 14:00:00,2021-12-23 15:00:00,35877.0,35827.0,0.3,-15.21,12369.91,SL,,None,None,None,None
391_240616001_B,178,WS30,Buy,2021-12-30 16:00:00,2021-12-30 17:00:00,36627.0,36577.0,0.3,-15.21,12354.7,SL,,None,None,None,None
392_240616001_B,178,WS30,Buy,2021-12-31 03:00:00,2022-01-03 16:00:00,36305.0,36376.0,0.3,18.88,12373.58,TrailingStop,,None,None,None,None
395_240616001_B,178,WS30,Buy,2022-01-24 22:00:00,2022-01-25 06:00:00,34063.0,34013.0,0.3,-21.85,12351.72,SL,,None,None,None,None
397_240616001_B,178,WS30,Buy,2022-01-31 22:00:00,2022-02-01 03:00:00,35046.0,34996.0,0.3,-21.85,12329.87,SL,,None,None,None,None
398_240616001_B,178,WS30,Buy,2022-02-02 20:00:00,2022-02-02 20:00:00,35558.0,35508.0,0.3,-15.21,12314.66,SL,,None,None,None,None
400_240616001_B,178,WS30,Buy,2022-02-04 14:00:00,2022-02-04 15:00:00,34924.0,34874.0,0.3,-15.21,12299.45,SL,,None,None,None,None
402_240616001_B,178,WS30,Buy,2022-02-14 12:00:00,2022-02-14 17:00:00,34433.0,34383.0,0.3,-15.21,12284.24,SL,,None,None,None,None
403_240616001_B,178,WS30,Buy,2022-02-17 17:00:00,2022-02-17 21:00:00,34531.0,34481.0,0.3,-15.21,12269.03,SL,,None,None,None,None
404_240616001_B,178,WS30,Buy,2022-02-21 19:00:00,2022-02-21 19:00:00,33835.0,33785.0,0.3,-15.21,12253.82,SL,,None,None,None,None
405_240616001_B,178,WS30,Buy,2022-03-17 19:00:00,2022-03-18 13:00:00,34262.0,34212.0,0.3,-17.42,12236.4,SL,,None,None,None,None
406_240616001_B,178,WS30,Buy,2022-03-18 21:00:00,2022-03-21 07:00:00,34652.0,34602.0,0.3,-17.42,12218.97,SL,,None,None,None,None
408_240616001_B,178,WS30,Buy,2022-04-18 03:00:00,2022-04-18 04:00:00,34336.0,34286.0,0.3,-15.21,12203.76,SL,,None,None,None,None
409_240616001_B,178,WS30,Buy,2022-04-19 16:00:00,2022-04-21 18:00:00,34712.0,35377.0,0.3,194.86,12398.63,Exit After X Bars,,None,None,None,None
412_240616001_B,178,WS30,Buy,2022-04-25 17:00:00,2022-04-25 17:00:00,33437.0,33387.0,0.3,-15.21,12383.42,SL,,None,None,None,None
414_240616001_B,178,WS30,Buy,2022-05-02 21:00:00,2022-05-02 21:00:00,32660.0,32610.0,0.3,-15.21,12368.21,SL,,None,None,None,None
415_240616001_B,178,WS30,Buy,2022-05-04 21:00:00,2022-05-05 16:00:00,33455.0,33723.0,0.3,77.98,12446.18,TrailingStop,,None,None,None,None
419_240616001_B,178,WS30,Buy,2022-05-25 22:00:00,2022-05-25 23:00:00,32177.0,32127.0,0.3,-15.21,12430.97,SL,,None,None,None,None
420_240616001_B,178,WS30,Buy,2022-05-26 16:00:00,2022-05-30 18:00:00,32387.0,33307.0,0.3,271.36,12702.33,Exit After X Bars,,None,None,None,None
421_240616001_B,178,WS30,Buy,2022-06-07 09:00:00,2022-06-07 14:00:00,32721.0,32671.0,0.3,-15.21,12687.12,SL,,None,None,None,None
424_240616001_B,178,WS30,Buy,2022-06-21 10:00:00,2022-06-21 14:00:00,30346.0,30296.0,0.3,-15.21,12671.91,SL,,None,None,None,None
427_240616001_B,178,WS30,Buy,2022-06-24 05:00:00,2022-06-24 06:00:00,30823.0,30773.0,0.3,-15.21,12656.7,SL,,None,None,None,None
428_240616001_B,178,WS30,Buy,2022-07-05 21:00:00,2022-07-07 23:00:00,30775.0,31383.0,0.3,177.76,12834.47,Exit After X Bars,,None,None,None,None
430_240616001_B,178,WS30,Buy,2022-07-22 16:00:00,2022-07-22 16:00:00,32183.0,32133.0,0.3,-15.21,12819.26,SL,,None,None,None,None
432_240616001_B,178,WS30,Buy,2022-08-11 15:00:00,2022-08-11 18:00:00,33523.0,33473.0,0.3,-15.21,12804.05,SL,,None,None,None,None
433_240616001_B,178,WS30,Buy,2022-08-12 22:00:00,2022-08-15 01:00:00,33744.0,33694.0,0.3,-17.42,12786.62,SL,,None,None,None,None
435_240616001_B,178,WS30,Buy,2022-09-01 07:00:00,2022-09-01 11:00:00,31385.0,31335.0,0.3,-15.21,12771.41,SL,,None,None,None,None
436_240616001_B,178,WS30,Buy,2022-09-06 03:00:00,2022-09-06 04:00:00,31515.0,31465.0,0.3,-15.21,12756.2,SL,,None,None,None,None
438_240616001_B,178,WS30,Buy,2022-09-09 10:00:00,2022-09-13 12:00:00,31929.0,32515.0,0.3,166.73,12922.94,Exit After X Bars,,None,None,None,None
439_240616001_B,178,WS30,Buy,2022-09-19 22:00:00,2022-09-20 12:00:00,30954.0,30904.0,0.3,-21.85,12901.08,SL,,None,None,None,None
441_240616001_B,178,WS30,Buy,2022-09-27 21:00:00,2022-09-28 04:00:00,29045.0,28995.0,0.3,-17.42,12883.66,SL,,None,None,None,None
443_240616001_B,178,WS30,Buy,2022-10-04 13:00:00,2022-10-04 14:00:00,29903.0,29853.0,0.3,-15.21,12868.45,SL,,None,None,None,None
446_240616001_B,178,WS30,Buy,2022-10-07 16:00:00,2022-10-07 16:00:00,29727.0,29677.0,0.3,-15.21,12853.24,SL,,None,None,None,None
448_240616001_B,178,WS30,Buy,2022-11-08 17:00:00,2022-11-08 20:00:00,33086.0,33036.0,0.3,-15.21,12838.03,SL,,None,None,None,None
452_240616001_B,178,WS30,Buy,2022-11-25 16:00:00,2022-11-28 01:00:00,34312.0,34262.0,0.3,-17.42,12820.61,SL,,None,None,None,None
453_240616001_B,178,WS30,Buy,2022-12-13 13:00:00,2022-12-13 16:00:00,34144.0,34523.0,0.3,113.49,12934.1,TrailingStop,,None,None,None,None
456_240616001_B,178,WS30,Buy,2022-12-16 19:00:00,2022-12-16 19:00:00,32755.0,32705.0,0.3,-15.21,12918.89,SL,,None,None,None,None
458_240616001_B,178,WS30,Buy,2023-01-23 17:00:00,2023-01-24 16:00:00,33498.0,33448.0,0.3,-21.85,12897.03,SL,,None,None,None,None
461_240616001_B,178,WS30,Buy,2023-01-27 17:00:00,2023-01-27 17:00:00,34056.0,34006.0,0.3,-15.21,12881.82,SL,,None,None,None,None
463_240616001_B,178,WS30,Buy,2023-03-02 02:00:00,2023-03-02 02:00:00,32851.0,32801.0,0.3,-15.21,12866.61,SL,,None,None,None,None
464_240616001_B,178,WS30,Buy,2023-03-03 18:00:00,2023-03-07 17:00:00,33203.0,33316.0,0.3,24.83,12891.45,TrailingStop,,None,None,None,None
467_240616001_B,178,WS30,Buy,2023-03-20 10:00:00,2023-03-22 12:00:00,31584.0,32531.0,0.3,275.03,13166.48,Exit After X Bars,,None,None,None,None
468_240616001_B,178,WS30,Buy,2023-03-22 20:00:00,2023-03-22 20:00:00,32693.0,32643.0,0.3,-15.21,13151.27,SL,,None,None,None,None
469_240616001_B,178,WS30,Buy,2023-03-31 15:00:00,2023-04-04 17:00:00,32999.0,33583.0,0.3,166.13,13317.41,Exit After X Bars,,None,None,None,None
470_240616001_B,178,WS30,Buy,2023-05-10 21:00:00,2023-05-11 16:00:00,33425.0,33375.0,0.3,-17.42,13299.98,SL,,None,None,None,None
471_240616001_B,178,WS30,Buy,2023-05-18 22:00:00,2023-05-19 18:00:00,33521.0,33471.0,0.3,-17.42,13282.56,SL,,None,None,None,None
473_240616001_B,178,WS30,Buy,2023-05-30 15:00:00,2023-05-30 16:00:00,33093.0,33043.0,0.3,-15.21,13267.35,SL,,None,None,None,None
474_240616001_B,178,WS30,Buy,2023-06-15 19:00:00,2023-06-15 20:00:00,34389.0,34339.0,0.3,-15.21,13252.14,SL,,None,None,None,None
475_240616001_B,178,WS30,Buy,2023-06-27 18:00:00,2023-06-28 16:00:00,33877.0,33827.0,0.3,-17.42,13234.71,SL,,None,None,None,None
477_240616001_B,178,WS30,Buy,2023-06-30 13:00:00,2023-07-03 16:00:00,34240.0,34301.0,0.3,15.88,13250.59,TrailingStop,,None,None,None,None
478_240616001_B,178,WS30,Buy,2023-07-10 10:00:00,2023-07-12 12:00:00,33644.0,34311.0,0.3,191.03,13441.62,Exit After X Bars,,None,None,None,None
479_240616001_B,178,WS30,Buy,2023-07-12 15:00:00,2023-07-12 22:00:00,34409.0,34359.0,0.3,-15.21,13426.41,SL,,None,None,None,None
481_240616001_B,178,WS30,Buy,2023-07-14 13:00:00,2023-07-14 17:00:00,34506.0,34456.0,0.3,-15.21,13411.2,SL,,None,None,None,None
482_240616001_B,178,WS30,Buy,2023-07-24 21:00:00,2023-07-24 21:00:00,35464.0,35414.0,0.3,-15.21,13395.99,SL,,None,None,None,None
485_240616001_B,178,WS30,Buy,2023-08-24 16:00:00,2023-08-24 17:00:00,34601.0,34551.0,0.3,-15.21,13380.78,SL,,None,None,None,None
486_240616001_B,178,WS30,Buy,2023-08-29 17:00:00,2023-08-29 17:00:00,34728.0,34678.0,0.3,-15.21,13365.57,SL,,None,None,None,None
487_240616001_B,178,WS30,Buy,2023-08-30 16:00:00,2023-08-30 17:00:00,34958.0,34908.0,0.3,-15.21,13350.36,SL,,None,None,None,None
488_240616001_B,178,WS30,Buy,2023-08-31 15:00:00,2023-08-31 16:00:00,35088.0,35038.0,0.3,-15.21,13335.15,SL,,None,None,None,None
489_240616001_B,178,WS30,Buy,2023-09-12 20:00:00,2023-09-12 20:00:00,34845.0,34795.0,0.3,-15.21,13319.94,SL,,None,None,None,None
492_240616001_B,178,WS30,Buy,2023-09-25 15:00:00,2023-09-25 16:00:00,33900.0,33850.0,0.3,-15.21,13304.73,SL,,None,None,None,None
494_240616001_B,178,WS30,Buy,2023-10-02 20:00:00,2023-10-03 15:00:00,33290.0,33240.0,0.3,-21.85,13282.88,SL,,None,None,None,None
496_240616001_B,178,WS30,Buy,2023-10-12 15:00:00,2023-10-12 15:00:00,33961.0,33911.0,0.3,-15.21,13267.67,SL,,None,None,None,None
497_240616001_B,178,WS30,Buy,2023-10-23 16:00:00,2023-10-23 22:00:00,33025.0,32975.0,0.3,-15.21,13252.46,SL,,None,None,None,None
499_240616001_B,178,WS30,Buy,2023-10-26 14:00:00,2023-10-26 19:00:00,32922.0,32872.0,0.3,-15.21,13237.25,SL,,None,None,None,None
501_240616001_B,178,WS30,Buy,2023-11-01 16:00:00,2023-11-01 17:00:00,33225.0,33175.0,0.3,-15.21,13222.04,SL,,None,None,None,None
502_240616001_B,178,WS30,Buy,2023-11-02 14:00:00,2023-11-06 17:00:00,33445.0,34072.0,0.3,183.46,13405.5,Exit After X Bars,,None,None,None,None
504_240616001_B,178,WS30,Buy,2023-12-12 11:00:00,2023-12-12 16:00:00,36469.0,36419.0,0.3,-15.21,13390.29,SL,,None,None,None,None
505_240616001_B,178,WS30,Buy,2023-12-13 21:00:00,2023-12-14 16:00:00,36705.0,37166.0,0.3,135.88,13526.17,TrailingStop,,None,None,None,None
507_240616001_B,178,WS30,Buy,2023-12-15 12:00:00,2023-12-15 14:00:00,37393.0,37343.0,0.3,-15.21,13510.96,SL,,None,None,None,None
508_240616001_B,178,WS30,Buy,2023-12-28 19:00:00,2023-12-28 20:00:00,37742.0,37692.0,0.3,-15.21,13495.75,SL,,None,None,None,None
511_240616001_B,178,WS30,Buy,2024-01-19 21:00:00,2024-01-19 22:00:00,37908.0,37858.0,0.3,-15.21,13480.54,SL,,None,None,None,None
512_240616001_B,178,WS30,Buy,2024-01-31 16:00:00,2024-01-31 16:00:00,38571.0,38521.0,0.3,-15.21,13465.33,SL,,None,None,None,None
