orderId,strategyRunId,symbol,orderType,openTime,closeTime,openPrice,closePrice,size,profit,balance,closeType,comment,sl,tp,swap,commission
6_240621002_B,181,WS30,Buy,2014-01-15 17:00:00,2014-01-16 16:00:00,16472.0,16422.0,0.3,-17.42,9982.58,SL,,None,None,None,None
21_240621002_B,181,WS30,Buy,2014-02-07 15:00:00,2014-02-10 23:00:00,15576.0,15796.0,0.3,63.58,10046.15,Exit After X Bars,,None,None,None,None
22_240621002_B,181,WS30,Buy,2014-02-11 18:00:00,2014-02-12 18:00:00,15902.0,15948.0,0.3,11.38,10057.53,TrailingStop,,None,None,None,None
25_240621002_B,181,WS30,Buy,2014-02-14 20:00:00,2014-02-18 10:00:00,16138.0,16193.0,0.3,7.43,10064.96,Exit After X Bars,,None,None,None,None
30_240621002_B,181,WS30,Buy,2014-02-24 18:00:00,2014-02-24 22:00:00,16289.0,16239.0,0.3,-15.21,10049.75,SL,,None,None,None,None
34_240621002_B,181,WS30,Buy,2014-02-28 18:00:00,2014-02-28 21:00:00,16389.0,16339.0,0.3,-15.21,10034.54,SL,,None,None,None,None
36_240621002_B,181,WS30,Buy,2014-03-04 12:00:00,2014-03-05 18:00:00,16331.0,16371.0,0.3,9.58,10044.12,Exit After X Bars,,None,None,None,None
45_240621002_B,181,WS30,Buy,2014-03-17 16:00:00,2014-03-17 16:00:00,16264.0,16214.0,0.3,-15.21,10028.91,SL,,None,None,None,None
49_240621002_B,181,WS30,Buy,2014-03-21 17:00:00,2014-03-21 19:00:00,16448.0,16398.0,0.3,-15.21,10013.7,SL,,None,None,None,None
54_240621002_B,181,WS30,Buy,2014-03-28 16:00:00,2014-03-28 19:00:00,16403.0,16353.0,0.3,-15.21,9998.49,SL,,None,None,None,None
62_240621002_B,181,WS30,Buy,2014-04-09 21:00:00,2014-04-10 12:00:00,16394.0,16394.0,0.3,-2.42,9996.06,MoveSL2BE,,None,None,None,None
66_240621002_B,181,WS30,Buy,2014-04-15 23:00:00,2014-04-17 05:00:00,16286.0,16368.0,0.3,19.96,10016.03,Exit After X Bars,,None,None,None,None
69_240621002_B,181,WS30,Buy,2014-04-22 19:00:00,2014-04-23 13:00:00,16559.0,16509.0,0.3,-17.42,9998.6,SL,,None,None,None,None
83_240621002_B,181,WS30,Buy,2014-05-12 16:00:00,2014-05-13 22:00:00,16687.0,16719.0,0.3,2.75,10001.35,Exit After X Bars,,None,None,None,None
100_240621002_B,181,WS30,Buy,2014-06-05 19:00:00,2014-06-09 02:00:00,16840.0,16933.0,0.3,23.26,10024.61,Exit After X Bars,,None,None,None,None
117_240621002_B,181,WS30,Buy,2014-07-01 18:00:00,2014-07-03 00:00:00,16968.0,16975.0,0.3,-2.54,10022.07,Exit After X Bars,,None,None,None,None
125_240621002_B,181,WS30,Buy,2014-07-14 16:00:00,2014-07-15 18:00:00,17062.0,17012.0,0.3,-21.85,10000.22,SL,,None,None,None,None
170_240621002_B,181,WS30,Buy,2014-09-16 20:00:00,2014-09-17 21:00:00,17150.0,17100.0,0.3,-17.42,9982.8,SL,,None,None,None,None
182_240621002_B,181,WS30,Buy,2014-10-03 16:00:00,2014-10-06 18:00:00,16953.0,16990.0,0.3,8.68,9991.47,TrailingStop,,None,None,None,None
191_240621002_B,181,WS30,Buy,2014-10-17 17:00:00,2014-10-20 14:00:00,16311.0,16311.0,0.3,-2.42,9989.05,MoveSL2BE,,None,None,None,None
193_240621002_B,181,WS30,Buy,2014-10-21 21:00:00,2014-10-22 19:00:00,16593.0,16543.0,0.3,-17.42,9971.63,SL,,None,None,None,None
198_240621002_B,181,WS30,Buy,2014-10-28 21:00:00,2014-10-29 19:00:00,16969.0,16969.0,0.3,-2.42,9969.2,MoveSL2BE,,None,None,None,None
199_240621002_B,181,WS30,Buy,2014-10-30 19:00:00,2014-11-03 02:00:00,17164.0,17378.0,0.3,59.56,10028.76,Exit After X Bars,,None,None,None,None
214_240621002_B,181,WS30,Buy,2014-11-21 12:00:00,2014-11-21 18:00:00,17829.0,17829.0,0.3,-0.21,10028.55,MoveSL2BE,,None,None,None,None
233_240621002_B,181,WS30,Buy,2014-12-18 11:00:00,2014-12-19 17:00:00,17479.0,17797.0,0.3,92.98,10121.53,Exit After X Bars,,None,None,None,None
246_240621002_B,181,WS30,Buy,2015-01-08 03:00:00,2015-01-09 09:00:00,17693.0,17871.0,0.3,50.98,10172.51,Exit After X Bars,,None,None,None,None
249_240621002_B,181,WS30,Buy,2015-01-13 16:00:00,2015-01-13 17:00:00,17920.0,17870.0,0.3,-15.21,10157.3,SL,,None,None,None,None
256_240621002_B,181,WS30,Buy,2015-01-22 15:00:00,2015-01-22 15:00:00,17699.0,17649.0,0.3,-15.21,10142.09,SL,,None,None,None,None
264_240621002_B,181,WS30,Buy,2015-02-03 16:00:00,2015-02-04 22:00:00,17483.0,17718.0,0.3,68.08,10210.16,Exit After X Bars,,None,None,None,None
265_240621002_B,181,WS30,Buy,2015-02-05 22:00:00,2015-02-06 05:00:00,17881.0,17831.0,0.3,-17.42,10192.74,SL,,None,None,None,None
278_240621002_B,181,WS30,Buy,2015-02-24 22:00:00,2015-02-26 04:00:00,18228.0,18202.0,0.3,-12.44,10180.3,Exit After X Bars,,None,None,None,None
289_240621002_B,181,WS30,Buy,2015-03-12 17:00:00,2015-03-13 13:00:00,17837.0,17837.0,0.3,-2.42,10177.88,MoveSL2BE,,None,None,None,None
293_240621002_B,181,WS30,Buy,2015-03-18 21:00:00,2015-03-19 10:00:00,18051.0,18051.0,0.3,-2.42,10175.45,MoveSL2BE,,None,None,None,None
301_240621002_B,181,WS30,Buy,2015-03-30 16:00:00,2015-03-31 12:00:00,17861.0,17881.0,0.3,-0.85,10174.6,TrailingStop,,None,None,None,None
305_240621002_B,181,WS30,Buy,2015-04-06 17:00:00,2015-04-07 23:00:00,17864.0,17869.0,0.3,-5.35,10169.25,Exit After X Bars,,None,None,None,None
324_240621002_B,181,WS30,Buy,2015-05-04 16:00:00,2015-05-04 19:00:00,18124.0,18074.0,0.3,-15.21,10154.04,SL,,None,None,None,None
328_240621002_B,181,WS30,Buy,2015-05-08 15:00:00,2015-05-12 09:00:00,18072.0,18072.0,0.3,-9.07,10144.97,MoveSL2BE,,None,None,None,None
331_240621002_B,181,WS30,Buy,2015-05-15 09:00:00,2015-05-19 09:00:00,18259.0,18310.0,0.3,6.23,10151.21,Exit After X Bars,,None,None,None,None
348_240621002_B,181,WS30,Buy,2015-06-10 16:00:00,2015-06-12 14:00:00,17914.0,17985.0,0.3,16.66,10167.87,TrailingStop,,None,None,None,None
351_240621002_B,181,WS30,Buy,2015-06-17 10:00:00,2015-06-17 18:00:00,17964.0,17914.0,0.3,-15.21,10152.66,SL,,None,None,None,None
352_240621002_B,181,WS30,Buy,2015-06-18 17:00:00,2015-06-19 21:00:00,18096.0,18046.0,0.3,-17.42,10135.23,SL,,None,None,None,None
369_240621002_B,181,WS30,Buy,2015-07-13 12:00:00,2015-07-15 12:00:00,17898.0,18064.0,0.3,40.73,10175.97,Exit After X Bars,,None,None,None,None
380_240621002_B,181,WS30,Buy,2015-07-29 21:00:00,2015-07-30 15:00:00,17747.0,17697.0,0.3,-17.42,10158.54,SL,,None,None,None,None
388_240621002_B,181,WS30,Buy,2015-08-10 16:00:00,2015-08-11 12:00:00,17546.0,17496.0,0.3,-21.85,10136.69,SL,,None,None,None,None
401_240621002_B,181,WS30,Buy,2015-08-27 10:00:00,2015-08-27 21:00:00,16403.0,16403.0,0.3,-0.21,10136.48,MoveSL2BE,,None,None,None,None
405_240621002_B,181,WS30,Buy,2015-09-03 10:00:00,2015-09-03 20:00:00,16418.0,16368.0,0.3,-15.21,10121.27,SL,,None,None,None,None
408_240621002_B,181,WS30,Buy,2015-09-08 10:00:00,2015-09-08 17:00:00,16382.0,16332.0,0.3,-15.21,10106.06,SL,,None,None,None,None
413_240621002_B,181,WS30,Buy,2015-09-15 20:00:00,2015-09-17 20:00:00,16592.0,16764.0,0.3,46.96,10153.02,Exit After X Bars,,None,None,None,None
419_240621002_B,181,WS30,Buy,2015-09-25 14:00:00,2015-09-25 16:00:00,16441.0,16391.0,0.3,-15.21,10137.81,SL,,None,None,None,None
422_240621002_B,181,WS30,Buy,2015-09-30 10:00:00,2015-09-30 10:00:00,16215.0,16165.0,0.3,-15.21,10122.6,SL,,None,None,None,None
423_240621002_B,181,WS30,Buy,2015-10-01 12:00:00,2015-10-01 14:00:00,16395.0,16345.0,0.3,-15.21,10107.39,SL,,None,None,None,None
425_240621002_B,181,WS30,Buy,2015-10-05 13:00:00,2015-10-07 13:00:00,16569.0,16849.0,0.3,74.93,10182.33,Exit After X Bars,,None,None,None,None
426_240621002_B,181,WS30,Buy,2015-10-07 17:00:00,2015-10-07 17:00:00,16959.0,16909.0,0.3,-15.21,10167.12,SL,,None,None,None,None
427_240621002_B,181,WS30,Buy,2015-10-08 22:00:00,2015-10-09 10:00:00,17062.0,17012.0,0.3,-17.42,10149.69,SL,,None,None,None,None
437_240621002_B,181,WS30,Buy,2015-10-22 18:00:00,2015-10-26 17:00:00,17412.0,17638.0,0.3,63.16,10212.86,Exit After X Bars,,None,None,None,None
440_240621002_B,181,WS30,Buy,2015-10-28 21:00:00,2015-10-29 17:00:00,17734.0,17684.0,0.3,-17.42,10195.43,SL,,None,None,None,None
444_240621002_B,181,WS30,Buy,2015-11-03 18:00:00,2015-11-04 18:00:00,17913.0,17863.0,0.3,-17.42,10178.01,SL,,None,None,None,None
454_240621002_B,181,WS30,Buy,2015-11-17 17:00:00,2015-11-17 19:00:00,17577.0,17527.0,0.3,-15.21,10162.8,SL,,None,None,None,None
455_240621002_B,181,WS30,Buy,2015-11-18 22:00:00,2015-11-19 16:00:00,17696.0,17696.0,0.3,-2.42,10160.37,MoveSL2BE,,None,None,None,None
457_240621002_B,181,WS30,Buy,2015-11-20 17:00:00,2015-11-20 18:00:00,17902.0,17852.0,0.3,-15.21,10145.16,SL,,None,None,None,None
474_240621002_B,181,WS30,Buy,2015-12-15 15:00:00,2015-12-16 21:00:00,17497.0,17497.0,0.3,-2.42,10142.74,MoveSL2BE,,None,None,None,None
478_240621002_B,181,WS30,Buy,2015-12-22 19:00:00,2015-12-24 19:00:00,17376.0,17584.0,0.3,57.76,10200.5,Exit After X Bars,,None,None,None,None
480_240621002_B,181,WS30,Buy,2015-12-29 15:00:00,2015-12-30 22:00:00,17644.0,17594.0,0.3,-17.42,10183.08,SL,,None,None,None,None
488_240621002_B,181,WS30,Buy,2016-01-12 15:00:00,2016-01-12 16:00:00,16561.0,16511.0,0.3,-15.21,10167.87,SL,,None,None,None,None
493_240621002_B,181,WS30,Buy,2016-01-19 09:00:00,2016-01-19 11:00:00,16235.0,16185.0,0.3,-15.21,10152.66,SL,,None,None,None,None
495_240621002_B,181,WS30,Buy,2016-01-21 19:00:00,2016-01-21 20:00:00,15995.0,15945.0,0.3,-15.21,10137.45,SL,,None,None,None,None
501_240621002_B,181,WS30,Buy,2016-01-29 16:00:00,2016-02-02 16:00:00,16237.0,16265.0,0.3,-0.67,10136.78,Exit After X Bars,,None,None,None,None
504_240621002_B,181,WS30,Buy,2016-02-04 17:00:00,2016-02-04 18:00:00,16482.0,16432.0,0.3,-15.21,10121.57,SL,,None,None,None,None
510_240621002_B,181,WS30,Buy,2016-02-12 22:00:00,2016-02-16 17:00:00,15956.0,16040.0,0.3,16.13,10137.71,TrailingStop,,None,None,None,None
512_240621002_B,181,WS30,Buy,2016-02-17 16:00:00,2016-02-19 13:00:00,16326.0,16363.0,0.3,6.46,10144.17,TrailingStop,,None,None,None,None
516_240621002_B,181,WS30,Buy,2016-02-25 20:00:00,2016-02-26 21:00:00,16605.0,16652.0,0.3,11.68,10155.84,TrailingStop,,None,None,None,None
518_240621002_B,181,WS30,Buy,2016-03-01 20:00:00,2016-03-02 17:00:00,16824.0,16774.0,0.3,-17.42,10138.42,SL,,None,None,None,None
521_240621002_B,181,WS30,Buy,2016-03-04 20:00:00,2016-03-04 21:00:00,17041.0,16991.0,0.3,-15.21,10123.21,SL,,None,None,None,None
529_240621002_B,181,WS30,Buy,2016-03-16 20:00:00,2016-03-17 12:00:00,17349.0,17299.0,0.3,-17.42,10105.79,SL,,None,None,None,None
535_240621002_B,181,WS30,Buy,2016-03-28 10:00:00,2016-03-28 14:00:00,17615.0,17565.0,0.3,-15.21,10090.58,SL,,None,None,None,None
536_240621002_B,181,WS30,Buy,2016-03-30 10:00:00,2016-03-31 11:00:00,17719.0,17669.0,0.3,-17.42,10073.15,SL,,None,None,None,None
546_240621002_B,181,WS30,Buy,2016-04-13 16:00:00,2016-04-15 16:00:00,17841.0,17906.0,0.3,14.86,10088.01,Exit After X Bars,,None,None,None,None
548_240621002_B,181,WS30,Buy,2016-04-19 10:00:00,2016-04-19 19:00:00,18034.0,17984.0,0.3,-15.21,10072.8,SL,,None,None,None,None
563_240621002_B,181,WS30,Buy,2016-05-10 18:00:00,2016-05-11 10:00:00,17892.0,17842.0,0.3,-17.42,10055.38,SL,,None,None,None,None
573_240621002_B,181,WS30,Buy,2016-05-24 16:00:00,2016-05-26 16:00:00,17656.0,17872.0,0.3,60.16,10115.54,Exit After X Bars,,None,None,None,None
581_240621002_B,181,WS30,Buy,2016-06-07 10:00:00,2016-06-09 10:00:00,17956.0,17984.0,0.3,3.76,10119.3,Exit After X Bars,,None,None,None,None
588_240621002_B,181,WS30,Buy,2016-06-20 09:00:00,2016-06-21 17:00:00,17846.0,17796.0,0.3,-21.85,10097.45,SL,,None,None,None,None
594_240621002_B,181,WS30,Buy,2016-06-29 09:00:00,2016-07-01 09:00:00,17470.0,17905.0,0.3,125.86,10223.31,Exit After X Bars,,None,None,None,None
600_240621002_B,181,WS30,Buy,2016-07-08 18:00:00,2016-07-12 18:00:00,18079.0,18313.0,0.3,61.13,10284.45,Exit After X Bars,,None,None,None,None
602_240621002_B,181,WS30,Buy,2016-07-14 09:00:00,2016-07-14 20:00:00,18471.0,18471.0,0.3,-0.21,10284.24,MoveSL2BE,,None,None,None,None
618_240621002_B,181,WS30,Buy,2016-08-05 17:00:00,2016-08-08 21:00:00,18504.0,18504.0,0.3,-2.42,10281.81,MoveSL2BE,,None,None,None,None
650_240621002_B,181,WS30,Buy,2016-09-22 16:00:00,2016-09-23 11:00:00,18402.0,18352.0,0.3,-17.42,10264.39,SL,,None,None,None,None
654_240621002_B,181,WS30,Buy,2016-09-28 22:00:00,2016-09-29 15:00:00,18340.0,18290.0,0.3,-17.42,10246.97,SL,,None,None,None,None
666_240621002_B,181,WS30,Buy,2016-10-14 16:00:00,2016-10-14 18:00:00,18234.0,18184.0,0.3,-15.21,10231.76,SL,,None,None,None,None
672_240621002_B,181,WS30,Buy,2016-10-24 16:00:00,2016-10-24 17:00:00,18270.0,18220.0,0.3,-15.21,10216.55,SL,,None,None,None,None
681_240621002_B,181,WS30,Buy,2016-11-07 09:00:00,2016-11-09 09:00:00,18112.0,18280.0,0.3,41.33,10257.88,TrailingStop,,None,None,None,None
682_240621002_B,181,WS30,Buy,2016-11-09 18:00:00,2016-11-11 18:00:00,18500.0,18762.0,0.3,73.96,10331.84,Exit After X Bars,,None,None,None,None
701_240621002_B,181,WS30,Buy,2016-12-07 19:00:00,2016-12-09 19:00:00,19349.0,19666.0,0.3,90.46,10422.3,Exit After X Bars,,None,None,None,None
702_240621002_B,181,WS30,Buy,2016-12-12 09:00:00,2016-12-14 09:00:00,19762.0,19902.0,0.3,32.93,10455.24,Exit After X Bars,,None,None,None,None
730_240621002_B,181,WS30,Buy,2017-01-24 20:00:00,2017-01-26 20:00:00,19935.0,20101.0,0.3,45.16,10500.4,Exit After X Bars,,None,None,None,None
736_240621002_B,181,WS30,Buy,2017-02-03 17:00:00,2017-02-06 15:00:00,20017.0,20017.0,0.3,-2.42,10497.98,MoveSL2BE,,None,None,None,None
740_240621002_B,181,WS30,Buy,2017-02-09 21:00:00,2017-02-13 21:00:00,20198.0,20427.0,0.3,64.06,10562.04,Exit After X Bars,,None,None,None,None
742_240621002_B,181,WS30,Buy,2017-02-15 18:00:00,2017-02-17 12:00:00,20600.0,20550.0,0.3,-19.64,10542.4,SL,,None,None,None,None
751_240621002_B,181,WS30,Buy,2017-03-01 15:00:00,2017-03-02 18:00:00,20934.0,21061.0,0.3,35.68,10578.08,TrailingStop,,None,None,None,None
760_240621002_B,181,WS30,Buy,2017-03-15 21:00:00,2017-03-16 17:00:00,20970.0,20920.0,0.3,-17.42,10560.65,SL,,None,None,None,None
769_240621002_B,181,WS30,Buy,2017-03-28 20:00:00,2017-03-29 18:00:00,20675.0,20625.0,0.3,-17.42,10543.23,SL,,None,None,None,None
774_240621002_B,181,WS30,Buy,2017-04-05 16:00:00,2017-04-05 18:00:00,20797.0,20797.0,0.3,-0.21,10543.02,MoveSL2BE,,None,None,None,None
785_240621002_B,181,WS30,Buy,2017-04-24 09:00:00,2017-04-26 09:00:00,20727.0,21017.0,0.3,77.93,10620.95,Exit After X Bars,,None,None,None,None
803_240621002_B,181,WS30,Buy,2017-05-19 21:00:00,2017-05-19 22:00:00,20858.0,20808.0,0.3,-15.21,10605.74,SL,,None,None,None,None
806_240621002_B,181,WS30,Buy,2017-05-25 09:00:00,2017-05-29 09:00:00,21061.0,21084.0,0.3,2.26,10608,Exit After X Bars,,None,None,None,None
810_240621002_B,181,WS30,Buy,2017-06-02 09:00:00,2017-06-02 15:00:00,21164.0,21164.0,0.3,-0.21,10607.79,MoveSL2BE,,None,None,None,None
817_240621002_B,181,WS30,Buy,2017-06-14 14:00:00,2017-06-14 16:00:00,21375.0,21325.0,0.3,-15.21,10592.58,SL,,None,None,None,None
820_240621002_B,181,WS30,Buy,2017-06-19 19:00:00,2017-06-21 10:00:00,21505.0,21455.0,0.3,-24.07,10568.52,SL,,None,None,None,None
829_240621002_B,181,WS30,Buy,2017-07-03 17:00:00,2017-07-04 09:00:00,21525.0,21475.0,0.3,-21.85,10546.67,SL,,None,None,None,None
836_240621002_B,181,WS30,Buy,2017-07-12 16:00:00,2017-07-14 16:00:00,21539.0,21574.0,0.3,5.86,10552.53,Exit After X Bars,,None,None,None,None
837_240621002_B,181,WS30,Buy,2017-07-14 22:00:00,2017-07-17 17:00:00,21663.0,21613.0,0.3,-17.42,10535.1,SL,,None,None,None,None
844_240621002_B,181,WS30,Buy,2017-07-25 16:00:00,2017-07-25 16:00:00,21677.0,21627.0,0.3,-15.21,10519.89,SL,,None,None,None,None
848_240621002_B,181,WS30,Buy,2017-08-01 09:00:00,2017-08-03 09:00:00,21927.0,22001.0,0.3,17.56,10537.46,Exit After X Bars,,None,None,None,None
856_240621002_B,181,WS30,Buy,2017-08-14 17:00:00,2017-08-16 17:00:00,22009.0,22056.0,0.3,5.03,10542.49,Exit After X Bars,,None,None,None,None
861_240621002_B,181,WS30,Buy,2017-08-22 16:00:00,2017-08-23 16:00:00,21814.0,21814.0,0.3,-2.42,10540.07,MoveSL2BE,,None,None,None,None
875_240621002_B,181,WS30,Buy,2017-09-11 12:00:00,2017-09-13 14:00:00,21939.0,22102.0,0.3,39.83,10579.9,Exit After X Bars,,None,None,None,None
878_240621002_B,181,WS30,Buy,2017-09-18 09:00:00,2017-09-20 11:00:00,22309.0,22384.0,0.3,13.43,10593.33,Exit After X Bars,,None,None,None,None
887_240621002_B,181,WS30,Buy,2017-10-02 19:00:00,2017-10-04 21:00:00,22496.0,22668.0,0.3,42.53,10635.87,Exit After X Bars,,None,None,None,None
888_240621002_B,181,WS30,Buy,2017-10-06 09:00:00,2017-10-06 17:00:00,22782.0,22732.0,0.3,-15.21,10620.66,SL,,None,None,None,None
896_240621002_B,181,WS30,Buy,2017-10-18 15:00:00,2017-10-19 10:00:00,23094.0,23094.0,0.3,-2.42,10618.23,MoveSL2BE,,None,None,None,None
898_240621002_B,181,WS30,Buy,2017-10-20 16:00:00,2017-10-20 16:00:00,23263.0,23213.0,0.3,-15.21,10603.02,SL,,None,None,None,None
899_240621002_B,181,WS30,Buy,2017-10-24 14:00:00,2017-10-25 14:00:00,23423.0,23423.0,0.3,-2.42,10600.6,MoveSL2BE,,None,None,None,None
905_240621002_B,181,WS30,Buy,2017-11-01 12:00:00,2017-11-01 17:00:00,23504.0,23454.0,0.3,-15.21,10585.39,SL,,None,None,None,None
916_240621002_B,181,WS30,Buy,2017-11-16 17:00:00,2017-11-17 15:00:00,23446.0,23396.0,0.3,-17.42,10567.97,SL,,None,None,None,None
918_240621002_B,181,WS30,Buy,2017-11-21 16:00:00,2017-11-22 17:00:00,23551.0,23551.0,0.3,-2.42,10565.54,MoveSL2BE,,None,None,None,None
922_240621002_B,181,WS30,Buy,2017-11-28 19:00:00,2017-11-28 20:00:00,23737.0,23687.0,0.3,-15.21,10550.33,SL,,None,None,None,None
923_240621002_B,181,WS30,Buy,2017-11-29 16:00:00,2017-11-29 17:00:00,23949.0,23899.0,0.3,-15.21,10535.12,SL,,None,None,None,None
924_240621002_B,181,WS30,Buy,2017-11-30 16:00:00,2017-12-01 12:00:00,24058.0,24152.0,0.3,25.78,10560.9,TrailingStop,,None,None,None,None
925_240621002_B,181,WS30,Buy,2017-12-04 09:00:00,2017-12-04 21:00:00,24425.0,24375.0,0.3,-15.21,10545.69,SL,,None,None,None,None
929_240621002_B,181,WS30,Buy,2017-12-11 09:00:00,2017-12-13 11:00:00,24356.0,24520.0,0.3,40.13,10585.82,Exit After X Bars,,None,None,None,None
930_240621002_B,181,WS30,Buy,2017-12-13 18:00:00,2017-12-13 20:00:00,24651.0,24601.0,0.3,-15.21,10570.61,SL,,None,None,None,None
932_240621002_B,181,WS30,Buy,2017-12-18 09:00:00,2017-12-18 20:00:00,24775.0,24775.0,0.3,-0.21,10570.4,MoveSL2BE,,None,None,None,None
942_240621002_B,181,WS30,Buy,2018-01-04 11:00:00,2018-01-08 13:00:00,24974.0,25341.0,0.3,105.46,10675.86,Exit After X Bars,,None,None,None,None
946_240621002_B,181,WS30,Buy,2018-01-11 19:00:00,2018-01-16 10:00:00,25502.0,26026.0,0.3,145.92,10821.78,Exit After X Bars,,None,None,None,None
951_240621002_B,181,WS30,Buy,2018-01-22 22:00:00,2018-01-23 13:00:00,26168.0,26168.0,0.3,-6.85,10814.93,MoveSL2BE,,None,None,None,None
955_240621002_B,181,WS30,Buy,2018-01-26 22:00:00,2018-01-29 11:00:00,26553.0,26553.0,0.3,-2.42,10812.51,MoveSL2BE,,None,None,None,None
963_240621002_B,181,WS30,Buy,2018-02-07 16:00:00,2018-02-07 20:00:00,25044.0,24994.0,0.3,-15.21,10797.3,SL,,None,None,None,None
966_240621002_B,181,WS30,Buy,2018-02-12 16:00:00,2018-02-12 16:00:00,24480.0,24430.0,0.3,-15.21,10782.09,SL,,None,None,None,None
968_240621002_B,181,WS30,Buy,2018-02-14 09:00:00,2018-02-14 12:00:00,24809.0,24759.0,0.3,-15.21,10766.88,SL,,None,None,None,None
969_240621002_B,181,WS30,Buy,2018-02-15 20:00:00,2018-02-20 11:00:00,25026.0,25118.0,0.3,16.32,10783.2,Exit After X Bars,,None,None,None,None
973_240621002_B,181,WS30,Buy,2018-02-23 22:00:00,2018-02-27 22:00:00,25256.0,25502.0,0.3,64.73,10847.93,TrailingStop,,None,None,None,None
977_240621002_B,181,WS30,Buy,2018-03-05 18:00:00,2018-03-06 18:00:00,24727.0,24727.0,0.3,-6.85,10841.08,MoveSL2BE,,None,None,None,None
980_240621002_B,181,WS30,Buy,2018-03-08 16:00:00,2018-03-08 16:00:00,24948.0,24898.0,0.3,-15.21,10825.87,SL,,None,None,None,None
981_240621002_B,181,WS30,Buy,2018-03-09 15:00:00,2018-03-12 17:00:00,25049.0,25209.0,0.3,45.58,10871.45,TrailingStop,,None,None,None,None
988_240621002_B,181,WS30,Buy,2018-03-21 20:00:00,2018-03-21 20:00:00,24904.0,24854.0,0.3,-15.21,10856.24,SL,,None,None,None,None
991_240621002_B,181,WS30,Buy,2018-03-26 22:00:00,2018-03-27 16:00:00,24208.0,24158.0,0.3,-21.85,10834.38,SL,,None,None,None,None
994_240621002_B,181,WS30,Buy,2018-03-29 20:00:00,2018-04-02 09:00:00,24192.0,24142.0,0.3,-19.64,10814.75,SL,,None,None,None,None
997_240621002_B,181,WS30,Buy,2018-04-04 21:00:00,2018-04-06 09:00:00,24143.0,24234.0,0.3,22.66,10837.41,TrailingStop,,None,None,None,None
1000_240621002_B,181,WS30,Buy,2018-04-10 18:00:00,2018-04-10 19:00:00,24472.0,24422.0,0.3,-15.21,10822.2,SL,,None,None,None,None
1002_240621002_B,181,WS30,Buy,2018-04-12 16:00:00,2018-04-12 20:00:00,24464.0,24414.0,0.3,-15.21,10806.99,SL,,None,None,None,None
1005_240621002_B,181,WS30,Buy,2018-04-17 14:00:00,2018-04-18 17:00:00,24772.0,24722.0,0.3,-17.42,10789.56,SL,,None,None,None,None
1012_240621002_B,181,WS30,Buy,2018-04-26 17:00:00,2018-04-27 12:00:00,24245.0,24245.0,0.3,-2.42,10787.14,MoveSL2BE,,None,None,None,None
1014_240621002_B,181,WS30,Buy,2018-04-30 15:00:00,2018-04-30 17:00:00,24456.0,24406.0,0.3,-15.21,10771.93,SL,,None,None,None,None
1018_240621002_B,181,WS30,Buy,2018-05-04 17:00:00,2018-05-07 22:00:00,24098.0,24287.0,0.3,54.28,10826.21,TrailingStop,,None,None,None,None
1020_240621002_B,181,WS30,Buy,2018-05-09 19:00:00,2018-05-11 03:00:00,24511.0,24739.0,0.3,63.76,10889.97,Exit After X Bars,,None,None,None,None
1021_240621002_B,181,WS30,Buy,2018-05-14 01:00:00,2018-05-15 08:00:00,24893.0,24875.0,0.3,-12.25,10877.72,Exit After X Bars,,None,None,None,None
1025_240621002_B,181,WS30,Buy,2018-05-21 01:00:00,2018-05-22 08:00:00,24939.0,25039.0,0.3,23.15,10900.86,Exit After X Bars,,None,None,None,None
1035_240621002_B,181,WS30,Buy,2018-06-04 12:00:00,2018-06-05 18:00:00,24775.0,24725.0,0.3,-21.85,10879.01,SL,,None,None,None,None
1037_240621002_B,181,WS30,Buy,2018-06-06 15:00:00,2018-06-06 16:00:00,24956.0,24906.0,0.3,-15.21,10863.8,SL,,None,None,None,None
1038_240621002_B,181,WS30,Buy,2018-06-07 16:00:00,2018-06-07 20:00:00,25247.0,25197.0,0.3,-15.21,10848.59,SL,,None,None,None,None
1052_240621002_B,181,WS30,Buy,2018-06-27 17:00:00,2018-06-27 18:00:00,24481.0,24431.0,0.3,-15.21,10833.38,SL,,None,None,None,None
1054_240621002_B,181,WS30,Buy,2018-06-29 10:00:00,2018-06-29 13:00:00,24407.0,24357.0,0.3,-15.21,10818.17,SL,,None,None,None,None
1056_240621002_B,181,WS30,Buy,2018-07-03 13:00:00,2018-07-03 16:00:00,24435.0,24385.0,0.3,-15.21,10802.96,SL,,None,None,None,None
1058_240621002_B,181,WS30,Buy,2018-07-05 14:00:00,2018-07-05 16:00:00,24370.0,24320.0,0.3,-15.21,10787.75,SL,,None,None,None,None
1059_240621002_B,181,WS30,Buy,2018-07-06 18:00:00,2018-07-06 22:00:00,24473.0,24423.0,0.3,-15.21,10772.54,SL,,None,None,None,None
1060_240621002_B,181,WS30,Buy,2018-07-09 16:00:00,2018-07-10 23:00:00,24619.0,24913.0,0.3,81.35,10853.89,Exit After X Bars,,None,None,None,None
1062_240621002_B,181,WS30,Buy,2018-07-12 18:00:00,2018-07-16 02:00:00,24913.0,25086.0,0.3,47.26,10901.15,Exit After X Bars,,None,None,None,None
1069_240621002_B,181,WS30,Buy,2018-07-24 15:00:00,2018-07-24 16:00:00,25191.0,25141.0,0.3,-15.21,10885.94,SL,,None,None,None,None
1070_240621002_B,181,WS30,Buy,2018-07-25 22:00:00,2018-07-27 06:00:00,25383.0,25558.0,0.3,47.86,10933.8,Exit After X Bars,,None,None,None,None
1076_240621002_B,181,WS30,Buy,2018-08-03 22:00:00,2018-08-06 12:00:00,25459.0,25409.0,0.3,-17.42,10916.38,SL,,None,None,None,None
1078_240621002_B,181,WS30,Buy,2018-08-07 16:00:00,2018-08-08 16:00:00,25640.0,25590.0,0.3,-17.42,10898.96,SL,,None,None,None,None
1085_240621002_B,181,WS30,Buy,2018-08-16 16:00:00,2018-08-17 23:00:00,25420.0,25668.0,0.3,71.98,10970.93,Exit After X Bars,,None,None,None,None
1090_240621002_B,181,WS30,Buy,2018-08-27 02:00:00,2018-08-28 09:00:00,25861.0,26076.0,0.3,57.65,11028.58,Exit After X Bars,,None,None,None,None
1102_240621002_B,181,WS30,Buy,2018-09-12 18:00:00,2018-09-12 18:00:00,26118.0,26068.0,0.3,-15.21,11013.37,SL,,None,None,None,None
1106_240621002_B,181,WS30,Buy,2018-09-18 21:00:00,2018-09-19 15:00:00,26282.0,26232.0,0.3,-17.42,10995.95,SL,,None,None,None,None
1107_240621002_B,181,WS30,Buy,2018-09-19 22:00:00,2018-09-21 06:00:00,26417.0,26725.0,0.3,87.76,11083.71,Exit After X Bars,,None,None,None,None
1114_240621002_B,181,WS30,Buy,2018-10-01 05:00:00,2018-10-01 22:00:00,26614.0,26614.0,0.3,-0.21,11083.5,MoveSL2BE,,None,None,None,None
1116_240621002_B,181,WS30,Buy,2018-10-03 17:00:00,2018-10-03 21:00:00,26925.0,26875.0,0.3,-15.21,11068.29,SL,,None,None,None,None
1125_240621002_B,181,WS30,Buy,2018-10-16 17:00:00,2018-10-17 16:00:00,25582.0,25640.0,0.3,14.98,11083.26,TrailingStop,,None,None,None,None
1134_240621002_B,181,WS30,Buy,2018-10-29 16:00:00,2018-10-29 17:00:00,25010.0,24960.0,0.3,-15.21,11068.05,SL,,None,None,None,None
1136_240621002_B,181,WS30,Buy,2018-10-31 10:00:00,2018-10-31 11:00:00,25028.0,24978.0,0.3,-15.21,11052.84,SL,,None,None,None,None
1138_240621002_B,181,WS30,Buy,2018-11-02 07:00:00,2018-11-02 15:00:00,25498.0,25498.0,0.3,-0.21,11052.63,MoveSL2BE,,None,None,None,None
1140_240621002_B,181,WS30,Buy,2018-11-06 19:00:00,2018-11-06 21:00:00,25606.0,25556.0,0.3,-15.21,11037.42,SL,,None,None,None,None
1141_240621002_B,181,WS30,Buy,2018-11-07 03:00:00,2018-11-07 04:00:00,25799.0,25749.0,0.3,-15.21,11022.21,SL,,None,None,None,None
1148_240621002_B,181,WS30,Buy,2018-11-16 19:00:00,2018-11-16 20:00:00,25452.0,25402.0,0.3,-15.21,11007,SL,,None,None,None,None
1154_240621002_B,181,WS30,Buy,2018-11-26 10:00:00,2018-11-26 19:00:00,24531.0,24481.0,0.3,-15.21,10991.79,SL,,None,None,None,None
1155_240621002_B,181,WS30,Buy,2018-11-28 01:00:00,2018-11-29 08:00:00,24769.0,25291.0,0.3,154.18,11145.97,Exit After X Bars,,None,None,None,None
1156_240621002_B,181,WS30,Buy,2018-11-29 21:00:00,2018-11-29 22:00:00,25466.0,25416.0,0.3,-15.21,11130.76,SL,,None,None,None,None
1157_240621002_B,181,WS30,Buy,2018-11-30 23:00:00,2018-12-03 16:00:00,25578.0,25848.0,0.3,78.58,11209.34,TrailingStop,,None,None,None,None
1163_240621002_B,181,WS30,Buy,2018-12-11 13:00:00,2018-12-11 17:00:00,24598.0,24598.0,0.3,-0.21,11209.13,MoveSL2BE,,None,None,None,None
1169_240621002_B,181,WS30,Buy,2018-12-19 20:00:00,2018-12-19 21:00:00,24025.0,23975.0,0.3,-15.21,11193.92,SL,,None,None,None,None
1173_240621002_B,181,WS30,Buy,2018-12-26 22:00:00,2018-12-27 10:00:00,22672.0,22672.0,0.3,-2.42,11191.49,MoveSL2BE,,None,None,None,None
1174_240621002_B,181,WS30,Buy,2018-12-27 22:00:00,2018-12-28 01:00:00,23076.0,23026.0,0.3,-17.42,11174.07,SL,,None,None,None,None
1175_240621002_B,181,WS30,Buy,2018-12-28 12:00:00,2018-12-28 13:00:00,23315.0,23265.0,0.3,-15.21,11158.86,SL,,None,None,None,None
1179_240621002_B,181,WS30,Buy,2019-01-04 17:00:00,2019-01-08 01:00:00,23236.0,23556.0,0.3,86.93,11245.79,Exit After X Bars,,None,None,None,None
1180_240621002_B,181,WS30,Buy,2019-01-08 16:00:00,2019-01-08 17:00:00,23786.0,23736.0,0.3,-15.21,11230.58,SL,,None,None,None,None
1181_240621002_B,181,WS30,Buy,2019-01-09 16:00:00,2019-01-09 17:00:00,23965.0,23915.0,0.3,-15.21,11215.37,SL,,None,None,None,None
1185_240621002_B,181,WS30,Buy,2019-01-15 07:00:00,2019-01-15 10:00:00,24064.0,24014.0,0.3,-15.21,11200.16,SL,,None,None,None,None
1186_240621002_B,181,WS30,Buy,2019-01-16 16:00:00,2019-01-16 17:00:00,24197.0,24147.0,0.3,-15.21,11184.95,SL,,None,None,None,None
1187_240621002_B,181,WS30,Buy,2019-01-17 21:00:00,2019-01-17 22:00:00,24386.0,24336.0,0.3,-15.21,11169.74,SL,,None,None,None,None
1188_240621002_B,181,WS30,Buy,2019-01-18 16:00:00,2019-01-18 16:00:00,24578.0,24528.0,0.3,-15.21,11154.53,SL,,None,None,None,None
1193_240621002_B,181,WS30,Buy,2019-01-25 15:00:00,2019-01-25 19:00:00,24731.0,24681.0,0.3,-15.21,11139.32,SL,,None,None,None,None
1196_240621002_B,181,WS30,Buy,2019-01-30 14:00:00,2019-01-31 16:00:00,24775.0,24874.0,0.3,27.28,11166.6,TrailingStop,,None,None,None,None
1198_240621002_B,181,WS30,Buy,2019-02-01 17:00:00,2019-02-01 17:00:00,25175.0,25125.0,0.3,-15.21,11151.39,SL,,None,None,None,None
1200_240621002_B,181,WS30,Buy,2019-02-05 15:00:00,2019-02-05 20:00:00,25348.0,25298.0,0.3,-15.21,11136.18,SL,,None,None,None,None
1205_240621002_B,181,WS30,Buy,2019-02-12 18:00:00,2019-02-14 02:00:00,25338.0,25496.0,0.3,42.76,11178.94,Exit After X Bars,,None,None,None,None
1207_240621002_B,181,WS30,Buy,2019-02-15 16:00:00,2019-02-19 04:00:00,25712.0,25913.0,0.3,51.23,11230.17,Exit After X Bars,,None,None,None,None
1210_240621002_B,181,WS30,Buy,2019-02-21 05:00:00,2019-02-21 08:00:00,26085.0,26035.0,0.3,-15.21,11214.96,SL,,None,None,None,None
1212_240621002_B,181,WS30,Buy,2019-02-25 12:00:00,2019-02-25 20:00:00,26151.0,26151.0,0.3,-0.21,11214.75,MoveSL2BE,,None,None,None,None
1216_240621002_B,181,WS30,Buy,2019-03-01 16:00:00,2019-03-01 17:00:00,26123.0,26073.0,0.3,-15.21,11199.54,SL,,None,None,None,None
1222_240621002_B,181,WS30,Buy,2019-03-11 19:00:00,2019-03-12 13:00:00,25602.0,25602.0,0.3,-6.85,11192.69,MoveSL2BE,,None,None,None,None
1226_240621002_B,181,WS30,Buy,2019-03-15 18:00:00,2019-03-15 21:00:00,25883.0,25833.0,0.3,-15.21,11177.48,SL,,None,None,None,None
1228_240621002_B,181,WS30,Buy,2019-03-19 12:00:00,2019-03-19 18:00:00,26040.0,25990.0,0.3,-15.21,11162.27,SL,,None,None,None,None
1233_240621002_B,181,WS30,Buy,2019-03-26 15:00:00,2019-03-26 17:00:00,25717.0,25667.0,0.3,-15.21,11147.06,SL,,None,None,None,None
1236_240621002_B,181,WS30,Buy,2019-03-29 13:00:00,2019-03-29 15:00:00,25839.0,25789.0,0.3,-15.21,11131.85,SL,,None,None,None,None
1239_240621002_B,181,WS30,Buy,2019-04-04 22:00:00,2019-04-08 01:00:00,26395.0,26345.0,0.3,-19.64,11112.21,SL,,None,None,None,None
1244_240621002_B,181,WS30,Buy,2019-04-12 13:00:00,2019-04-12 17:00:00,26320.0,26320.0,0.3,-0.21,11112,MoveSL2BE,,None,None,None,None
1248_240621002_B,181,WS30,Buy,2019-04-22 01:00:00,2019-04-22 04:00:00,26612.0,26562.0,0.3,-15.21,11096.79,SL,,None,None,None,None
1266_240621002_B,181,WS30,Buy,2019-05-16 16:00:00,2019-05-17 09:00:00,25824.0,25774.0,0.3,-17.42,11079.37,SL,,None,None,None,None
1279_240621002_B,181,WS30,Buy,2019-06-04 14:00:00,2019-06-05 21:00:00,25030.0,25507.0,0.3,140.68,11220.05,Exit After X Bars,,None,None,None,None
1280_240621002_B,181,WS30,Buy,2019-06-06 18:00:00,2019-06-06 18:00:00,25648.0,25598.0,0.3,-15.21,11204.84,SL,,None,None,None,None
1281_240621002_B,181,WS30,Buy,2019-06-07 16:00:00,2019-06-10 03:00:00,25899.0,26072.0,0.3,49.48,11254.31,TrailingStop,,None,None,None,None
1282_240621002_B,181,WS30,Buy,2019-06-10 17:00:00,2019-06-10 19:00:00,26172.0,26122.0,0.3,-15.21,11239.1,SL,,None,None,None,None
1288_240621002_B,181,WS30,Buy,2019-06-18 16:00:00,2019-06-19 23:00:00,26295.0,26504.0,0.3,60.28,11299.38,Exit After X Bars,,None,None,None,None
1289_240621002_B,181,WS30,Buy,2019-06-20 10:00:00,2019-06-20 19:00:00,26667.0,26617.0,0.3,-15.21,11284.17,SL,,None,None,None,None
1290_240621002_B,181,WS30,Buy,2019-06-21 18:00:00,2019-06-21 18:00:00,26898.0,26848.0,0.3,-15.21,11268.96,SL,,None,None,None,None
1295_240621002_B,181,WS30,Buy,2019-07-01 01:00:00,2019-07-01 17:00:00,26750.0,26750.0,0.3,-0.21,11268.75,MoveSL2BE,,None,None,None,None
1297_240621002_B,181,WS30,Buy,2019-07-03 18:00:00,2019-07-05 09:00:00,26909.0,26993.0,0.3,20.56,11289.31,Exit After X Bars,,None,None,None,None
1301_240621002_B,181,WS30,Buy,2019-07-10 16:00:00,2019-07-10 17:00:00,26907.0,26857.0,0.3,-15.21,11274.1,SL,,None,None,None,None
1302_240621002_B,181,WS30,Buy,2019-07-11 22:00:00,2019-07-15 06:00:00,27081.0,27344.0,0.3,74.26,11348.36,Exit After X Bars,,None,None,None,None
1309_240621002_B,181,WS30,Buy,2019-07-23 20:00:00,2019-07-24 11:00:00,27320.0,27270.0,0.3,-17.42,11330.94,SL,,None,None,None,None
1321_240621002_B,181,WS30,Buy,2019-08-08 17:00:00,2019-08-09 17:00:00,26180.0,26180.0,0.3,-2.42,11328.51,MoveSL2BE,,None,None,None,None
1327_240621002_B,181,WS30,Buy,2019-08-16 11:00:00,2019-08-16 16:00:00,25810.0,25760.0,0.3,-15.21,11313.3,SL,,None,None,None,None
1328_240621002_B,181,WS30,Buy,2019-08-19 04:00:00,2019-08-20 11:00:00,26028.0,26147.0,0.3,28.85,11342.15,Exit After X Bars,,None,None,None,None
1330_240621002_B,181,WS30,Buy,2019-08-22 01:00:00,2019-08-22 04:00:00,26295.0,26245.0,0.3,-15.21,11326.94,SL,,None,None,None,None
1335_240621002_B,181,WS30,Buy,2019-08-29 10:00:00,2019-08-30 17:00:00,26152.0,26466.0,0.3,91.78,11418.72,Exit After X Bars,,None,None,None,None
1339_240621002_B,181,WS30,Buy,2019-09-05 04:00:00,2019-09-06 11:00:00,26468.0,26762.0,0.3,85.78,11504.49,Exit After X Bars,,None,None,None,None
1343_240621002_B,181,WS30,Buy,2019-09-11 18:00:00,2019-09-12 16:00:00,27000.0,27143.0,0.3,40.48,11544.97,TrailingStop,,None,None,None,None
1359_240621002_B,181,WS30,Buy,2019-10-04 16:00:00,2019-10-07 23:00:00,26323.0,26481.0,0.3,44.98,11589.95,Exit After X Bars,,None,None,None,None
1362_240621002_B,181,WS30,Buy,2019-10-10 17:00:00,2019-10-10 19:00:00,26537.0,26487.0,0.3,-15.21,11574.74,SL,,None,None,None,None
1363_240621002_B,181,WS30,Buy,2019-10-11 11:00:00,2019-10-14 12:00:00,26703.0,26743.0,0.3,9.58,11584.31,TrailingStop,,None,None,None,None
1365_240621002_B,181,WS30,Buy,2019-10-15 17:00:00,2019-10-16 03:00:00,27032.0,26982.0,0.3,-17.42,11566.89,SL,,None,None,None,None
1373_240621002_B,181,WS30,Buy,2019-10-25 18:00:00,2019-10-25 21:00:00,27014.0,26964.0,0.3,-15.21,11551.68,SL,,None,None,None,None
1374_240621002_B,181,WS30,Buy,2019-10-28 15:00:00,2019-10-28 17:00:00,27116.0,27066.0,0.3,-15.21,11536.47,SL,,None,None,None,None
1378_240621002_B,181,WS30,Buy,2019-11-01 21:00:00,2019-11-05 06:00:00,27332.0,27514.0,0.3,45.53,11582,Exit After X Bars,,None,None,None,None
1381_240621002_B,181,WS30,Buy,2019-11-07 16:00:00,2019-11-07 22:00:00,27632.0,27640.0,0.3,2.19,11584.19,TrailingStop,,None,None,None,None
1387_240621002_B,181,WS30,Buy,2019-11-15 18:00:00,2019-11-18 15:00:00,27921.0,27975.0,0.3,13.78,11597.97,TrailingStop,,None,None,None,None
1392_240621002_B,181,WS30,Buy,2019-11-25 03:00:00,2019-11-26 10:00:00,27964.0,28073.0,0.3,25.85,11623.82,Exit After X Bars,,None,None,None,None
1401_240621002_B,181,WS30,Buy,2019-12-06 16:00:00,2019-12-09 23:00:00,27870.0,27913.0,0.3,10.48,11634.29,Exit After X Bars,,None,None,None,None
1404_240621002_B,181,WS30,Buy,2019-12-12 16:00:00,2019-12-12 18:00:00,28068.0,28068.0,0.3,-0.21,11634.08,MoveSL2BE,,None,None,None,None
1410_240621002_B,181,WS30,Buy,2019-12-20 16:00:00,2019-12-23 23:00:00,28487.0,28552.0,0.3,17.08,11651.16,Exit After X Bars,,None,None,None,None
1416_240621002_B,181,WS30,Buy,2020-01-02 10:00:00,2020-01-02 17:00:00,28668.0,28668.0,0.3,-0.21,11650.95,MoveSL2BE,,None,None,None,None
1421_240621002_B,181,WS30,Buy,2020-01-09 18:00:00,2020-01-09 19:00:00,28963.0,28913.0,0.3,-15.21,11635.74,SL,,None,None,None,None
1424_240621002_B,181,WS30,Buy,2020-01-14 19:00:00,2020-01-14 20:00:00,29038.0,28988.0,0.3,-15.21,11620.53,SL,,None,None,None,None
1426_240621002_B,181,WS30,Buy,2020-01-16 22:00:00,2020-01-20 06:00:00,29227.0,29336.0,0.3,28.06,11648.59,Exit After X Bars,,None,None,None,None
1434_240621002_B,181,WS30,Buy,2020-01-29 16:00:00,2020-01-29 16:00:00,28922.0,28872.0,0.3,-15.21,11633.38,SL,,None,None,None,None
1438_240621002_B,181,WS30,Buy,2020-02-04 11:00:00,2020-02-05 18:00:00,28730.0,29081.0,0.3,102.88,11736.26,Exit After X Bars,,None,None,None,None
1439_240621002_B,181,WS30,Buy,2020-02-06 03:00:00,2020-02-06 16:00:00,29408.0,29358.0,0.3,-15.21,11721.05,SL,,None,None,None,None
1442_240621002_B,181,WS30,Buy,2020-02-11 14:00:00,2020-02-11 16:00:00,29392.0,29342.0,0.3,-15.21,11705.84,SL,,None,None,None,None
1443_240621002_B,181,WS30,Buy,2020-02-12 17:00:00,2020-02-12 17:00:00,29536.0,29486.0,0.3,-15.21,11690.63,SL,,None,None,None,None
1456_240621002_B,181,WS30,Buy,2020-03-02 09:00:00,2020-03-02 10:00:00,25873.0,25823.0,0.3,-15.21,11675.42,SL,,None,None,None,None
1457_240621002_B,181,WS30,Buy,2020-03-03 17:00:00,2020-03-03 17:00:00,26823.0,26773.0,0.3,-15.21,11660.21,SL,,None,None,None,None
1470_240621002_B,181,WS30,Buy,2020-03-20 10:00:00,2020-03-20 13:00:00,20614.0,20564.0,0.3,-15.21,11645,SL,,None,None,None,None
1472_240621002_B,181,WS30,Buy,2020-03-24 16:00:00,2020-03-24 16:00:00,20019.0,19969.0,0.3,-15.21,11629.79,SL,,None,None,None,None
1473_240621002_B,181,WS30,Buy,2020-03-25 07:00:00,2020-03-25 08:00:00,20848.0,20798.0,0.3,-15.21,11614.58,SL,,None,None,None,None
1474_240621002_B,181,WS30,Buy,2020-03-26 16:00:00,2020-03-26 16:00:00,22121.0,22071.0,0.3,-15.21,11599.37,SL,,None,None,None,None
1477_240621002_B,181,WS30,Buy,2020-03-31 04:00:00,2020-03-31 04:00:00,22473.0,22423.0,0.3,-15.21,11584.16,SL,,None,None,None,None
1481_240621002_B,181,WS30,Buy,2020-04-06 03:00:00,2020-04-07 09:00:00,21570.0,23080.0,0.3,446.15,12030.3,PT,,None,None,None,None
1483_240621002_B,181,WS30,Buy,2020-04-09 09:00:00,2020-04-09 11:00:00,23608.0,23558.0,0.3,-15.21,12015.09,SL,,None,None,None,None
1485_240621002_B,181,WS30,Buy,2020-04-14 07:00:00,2020-04-14 08:00:00,23825.0,23775.0,0.3,-15.21,11999.88,SL,,None,None,None,None
1487_240621002_B,181,WS30,Buy,2020-04-17 01:00:00,2020-04-17 16:00:00,24166.0,24116.0,0.3,-15.21,11984.67,SL,,None,None,None,None
1491_240621002_B,181,WS30,Buy,2020-04-23 17:00:00,2020-04-23 19:00:00,23717.0,23667.0,0.3,-15.21,11969.46,SL,,None,None,None,None
1493_240621002_B,181,WS30,Buy,2020-04-27 07:00:00,2020-04-27 16:00:00,23924.0,23874.0,0.3,-15.21,11954.25,SL,,None,None,None,None
1494_240621002_B,181,WS30,Buy,2020-04-28 12:00:00,2020-04-28 17:00:00,24309.0,24259.0,0.3,-15.21,11939.04,SL,,None,None,None,None
1495_240621002_B,181,WS30,Buy,2020-04-29 16:00:00,2020-04-29 16:00:00,24644.0,24594.0,0.3,-15.21,11923.83,SL,,None,None,None,None
1496_240621002_B,181,WS30,Buy,2020-04-30 07:00:00,2020-04-30 08:00:00,24860.0,24810.0,0.3,-15.21,11908.62,SL,,None,None,None,None
1499_240621002_B,181,WS30,Buy,2020-05-05 04:00:00,2020-05-05 11:00:00,23868.0,23818.0,0.3,-15.21,11893.41,SL,,None,None,None,None
1501_240621002_B,181,WS30,Buy,2020-05-08 05:00:00,2020-05-08 10:00:00,24203.0,24153.0,0.3,-15.21,11878.2,SL,,None,None,None,None
1502_240621002_B,181,WS30,Buy,2020-05-11 03:00:00,2020-05-11 08:00:00,24482.0,24432.0,0.3,-15.21,11862.99,SL,,None,None,None,None
1506_240621002_B,181,WS30,Buy,2020-05-18 01:00:00,2020-05-19 08:00:00,23774.0,24618.0,0.3,246.35,12109.34,Exit After X Bars,,None,None,None,None
1507_240621002_B,181,WS30,Buy,2020-05-19 09:00:00,2020-05-19 10:00:00,24808.0,24758.0,0.3,-15.21,12094.13,SL,,None,None,None,None
1511_240621002_B,181,WS30,Buy,2020-05-25 11:00:00,2020-05-26 22:00:00,24657.0,25124.0,0.3,133.25,12227.38,Exit After X Bars,,None,None,None,None
1512_240621002_B,181,WS30,Buy,2020-05-27 11:00:00,2020-05-27 16:00:00,25273.0,25223.0,0.3,-15.21,12212.17,SL,,None,None,None,None
1513_240621002_B,181,WS30,Buy,2020-05-28 18:00:00,2020-05-28 19:00:00,25695.0,25645.0,0.3,-15.21,12196.96,SL,,None,None,None,None
1516_240621002_B,181,WS30,Buy,2020-06-02 12:00:00,2020-06-02 14:00:00,25642.0,25592.0,0.3,-15.21,12181.75,SL,,None,None,None,None
1517_240621002_B,181,WS30,Buy,2020-06-03 06:00:00,2020-06-04 13:00:00,25846.0,26096.0,0.3,72.58,12254.33,Exit After X Bars,,None,None,None,None
1519_240621002_B,181,WS30,Buy,2020-06-05 08:00:00,2020-06-08 15:00:00,26483.0,27326.0,0.3,250.48,12504.8,Exit After X Bars,,None,None,None,None
1520_240621002_B,181,WS30,Buy,2020-06-08 21:00:00,2020-06-09 10:00:00,27439.0,27389.0,0.3,-21.85,12482.95,SL,,None,None,None,None
1525_240621002_B,181,WS30,Buy,2020-06-16 02:00:00,2020-06-16 03:00:00,26059.0,26009.0,0.3,-15.21,12467.74,SL,,None,None,None,None
1528_240621002_B,181,WS30,Buy,2020-06-19 15:00:00,2020-06-19 16:00:00,26379.0,26329.0,0.3,-15.21,12452.53,SL,,None,None,None,None
1530_240621002_B,181,WS30,Buy,2020-06-23 10:00:00,2020-06-23 17:00:00,26198.0,26148.0,0.3,-15.21,12437.32,SL,,None,None,None,None
1535_240621002_B,181,WS30,Buy,2020-06-30 22:00:00,2020-07-01 08:00:00,25736.0,25686.0,0.3,-17.42,12419.9,SL,,None,None,None,None
1536_240621002_B,181,WS30,Buy,2020-07-01 16:00:00,2020-07-01 16:00:00,26003.0,25953.0,0.3,-15.21,12404.69,SL,,None,None,None,None
1537_240621002_B,181,WS30,Buy,2020-07-02 15:00:00,2020-07-02 17:00:00,26121.0,26071.0,0.3,-15.21,12389.48,SL,,None,None,None,None
1542_240621002_B,181,WS30,Buy,2020-07-13 01:00:00,2020-07-13 02:00:00,26245.0,26195.0,0.3,-15.21,12374.27,SL,,None,None,None,None
1543_240621002_B,181,WS30,Buy,2020-07-15 01:00:00,2020-07-15 18:00:00,26740.0,26831.0,0.3,27.09,12401.36,TrailingStop,,None,None,None,None
1547_240621002_B,181,WS30,Buy,2020-07-21 08:00:00,2020-07-21 22:00:00,26864.0,26814.0,0.3,-15.21,12386.15,SL,,None,None,None,None
1549_240621002_B,181,WS30,Buy,2020-07-23 11:00:00,2020-07-23 11:00:00,27133.0,27083.0,0.3,-15.21,12370.94,SL,,None,None,None,None
1556_240621002_B,181,WS30,Buy,2020-08-03 17:00:00,2020-08-03 17:00:00,26653.0,26603.0,0.3,-15.21,12355.73,SL,,None,None,None,None
1557_240621002_B,181,WS30,Buy,2020-08-04 18:00:00,2020-08-04 19:00:00,26805.0,26755.0,0.3,-15.21,12340.52,SL,,None,None,None,None
1558_240621002_B,181,WS30,Buy,2020-08-05 09:00:00,2020-08-06 13:00:00,26933.0,27070.0,0.3,38.68,12379.19,TrailingStop,,None,None,None,None
1559_240621002_B,181,WS30,Buy,2020-08-06 21:00:00,2020-08-07 05:00:00,27315.0,27265.0,0.3,-17.42,12361.77,SL,,None,None,None,None
1560_240621002_B,181,WS30,Buy,2020-08-10 07:00:00,2020-08-11 14:00:00,27501.0,28018.0,0.3,148.25,12510.02,Exit After X Bars,,None,None,None,None
1568_240621002_B,181,WS30,Buy,2020-08-21 20:00:00,2020-08-25 04:00:00,27879.0,28389.0,0.3,143.93,12653.95,Exit After X Bars,,None,None,None,None
1571_240621002_B,181,WS30,Buy,2020-08-27 16:00:00,2020-08-27 17:00:00,28463.0,28463.0,0.3,-0.21,12653.74,MoveSL2BE,,None,None,None,None
1572_240621002_B,181,WS30,Buy,2020-08-31 01:00:00,2020-08-31 13:00:00,28734.0,28684.0,0.3,-15.21,12638.53,SL,,None,None,None,None
1574_240621002_B,181,WS30,Buy,2020-09-02 09:00:00,2020-09-03 16:00:00,28762.0,29077.0,0.3,92.08,12730.61,Exit After X Bars,,None,None,None,None
1582_240621002_B,181,WS30,Buy,2020-09-14 08:00:00,2020-09-14 11:00:00,27929.0,27879.0,0.3,-15.21,12715.4,SL,,None,None,None,None
1583_240621002_B,181,WS30,Buy,2020-09-15 13:00:00,2020-09-15 16:00:00,28180.0,28130.0,0.3,-15.21,12700.19,SL,,None,None,None,None
1584_240621002_B,181,WS30,Buy,2020-09-16 21:00:00,2020-09-16 21:00:00,28341.0,28291.0,0.3,-15.21,12684.98,SL,,None,None,None,None
1589_240621002_B,181,WS30,Buy,2020-09-23 08:00:00,2020-09-23 09:00:00,27432.0,27382.0,0.3,-15.21,12669.77,SL,,None,None,None,None
1591_240621002_B,181,WS30,Buy,2020-09-25 22:00:00,2020-09-25 23:00:00,27197.0,27147.0,0.3,-15.21,12654.56,SL,,None,None,None,None
1592_240621002_B,181,WS30,Buy,2020-09-28 08:00:00,2020-09-29 11:00:00,27341.0,27489.0,0.3,37.55,12692.1,TrailingStop,,None,None,None,None
1594_240621002_B,181,WS30,Buy,2020-09-30 17:00:00,2020-09-30 21:00:00,27836.0,27786.0,0.3,-15.21,12676.89,SL,,None,None,None,None
1597_240621002_B,181,WS30,Buy,2020-10-05 16:00:00,2020-10-05 16:00:00,27961.0,27911.0,0.3,-15.21,12661.68,SL,,None,None,None,None
1598_240621002_B,181,WS30,Buy,2020-10-06 15:00:00,2020-10-06 16:00:00,28258.0,28208.0,0.3,-15.21,12646.47,SL,,None,None,None,None
1600_240621002_B,181,WS30,Buy,2020-10-08 09:00:00,2020-10-08 11:00:00,28467.0,28417.0,0.3,-15.21,12631.26,SL,,None,None,None,None
1601_240621002_B,181,WS30,Buy,2020-10-09 18:00:00,2020-10-09 19:00:00,28661.0,28611.0,0.3,-15.21,12616.05,SL,,None,None,None,None
1602_240621002_B,181,WS30,Buy,2020-10-12 17:00:00,2020-10-13 10:00:00,28773.0,28723.0,0.3,-21.85,12594.2,SL,,None,None,None,None
1606_240621002_B,181,WS30,Buy,2020-10-16 16:00:00,2020-10-16 22:00:00,28661.0,28611.0,0.3,-15.21,12578.99,SL,,None,None,None,None
1617_240621002_B,181,WS30,Buy,2020-11-02 11:00:00,2020-11-02 16:00:00,26727.0,26727.0,0.3,-0.21,12578.78,MoveSL2BE,,None,None,None,None
1618_240621002_B,181,WS30,Buy,2020-11-03 10:00:00,2020-11-04 04:00:00,27148.0,27230.0,0.3,22.18,12600.96,TrailingStop,,None,None,None,None
1619_240621002_B,181,WS30,Buy,2020-11-04 16:00:00,2020-11-05 23:00:00,27738.0,28380.0,0.3,190.18,12791.13,Exit After X Bars,,None,None,None,None
1620_240621002_B,181,WS30,Buy,2020-11-09 01:00:00,2020-11-09 17:00:00,28591.0,29372.0,0.3,234.09,13025.22,TrailingStop,,None,None,None,None
1622_240621002_B,181,WS30,Buy,2020-11-11 09:00:00,2020-11-11 09:00:00,29576.0,29526.0,0.3,-15.21,13010.01,SL,,None,None,None,None
1624_240621002_B,181,WS30,Buy,2020-11-13 22:00:00,2020-11-13 22:00:00,29545.0,29495.0,0.3,-15.21,12994.8,SL,,None,None,None,None
1629_240621002_B,181,WS30,Buy,2020-11-23 21:00:00,2020-11-25 05:00:00,29588.0,30162.0,0.3,163.13,13157.94,Exit After X Bars,,None,None,None,None
1636_240621002_B,181,WS30,Buy,2020-12-03 17:00:00,2020-12-03 20:00:00,30020.0,29970.0,0.3,-15.21,13142.73,SL,,None,None,None,None
1637_240621002_B,181,WS30,Buy,2020-12-04 22:00:00,2020-12-07 04:00:00,30206.0,30156.0,0.3,-17.42,13125.3,SL,,None,None,None,None
1647_240621002_B,181,WS30,Buy,2020-12-21 01:00:00,2020-12-21 01:00:00,30426.0,30376.0,0.3,-15.21,13110.09,SL,,None,None,None,None
1651_240621002_B,181,WS30,Buy,2020-12-28 05:00:00,2020-12-29 12:00:00,30352.0,30564.0,0.3,56.75,13166.84,Exit After X Bars,,None,None,None,None
1654_240621002_B,181,WS30,Buy,2020-12-31 22:00:00,2021-01-04 01:00:00,30618.0,30568.0,0.3,-19.64,13147.2,SL,,None,None,None,None
1655_240621002_B,181,WS30,Buy,2021-01-04 10:00:00,2021-01-04 10:00:00,30731.0,30681.0,0.3,-15.21,13131.99,SL,,None,None,None,None
1657_240621002_B,181,WS30,Buy,2021-01-06 16:00:00,2021-01-07 23:00:00,30602.0,31048.0,0.3,131.38,13263.37,Exit After X Bars,,None,None,None,None
1665_240621002_B,181,WS30,Buy,2021-01-19 05:00:00,2021-01-19 16:00:00,30952.0,30902.0,0.3,-15.21,13248.16,SL,,None,None,None,None
1666_240621002_B,181,WS30,Buy,2021-01-20 20:00:00,2021-01-20 21:00:00,31176.0,31126.0,0.3,-15.21,13232.95,SL,,None,None,None,None
1675_240621002_B,181,WS30,Buy,2021-02-02 10:00:00,2021-02-03 17:00:00,30436.0,30679.0,0.3,70.48,13303.43,Exit After X Bars,,None,None,None,None
1677_240621002_B,181,WS30,Buy,2021-02-04 16:00:00,2021-02-05 23:00:00,30909.0,31147.0,0.3,68.98,13372.4,Exit After X Bars,,None,None,None,None
1678_240621002_B,181,WS30,Buy,2021-02-08 16:00:00,2021-02-08 17:00:00,31349.0,31299.0,0.3,-15.21,13357.19,SL,,None,None,None,None
1680_240621002_B,181,WS30,Buy,2021-02-10 15:00:00,2021-02-10 16:00:00,31531.0,31481.0,0.3,-15.21,13341.98,SL,,None,None,None,None
1683_240621002_B,181,WS30,Buy,2021-02-15 04:00:00,2021-02-16 15:00:00,31587.0,31630.0,0.3,6.05,13348.03,Exit After X Bars,,None,None,None,None
1690_240621002_B,181,WS30,Buy,2021-02-24 18:00:00,2021-02-25 17:00:00,31768.0,31819.0,0.3,12.88,13360.91,TrailingStop,,None,None,None,None
1692_240621002_B,181,WS30,Buy,2021-03-01 17:00:00,2021-03-01 19:00:00,31588.0,31538.0,0.3,-15.21,13345.7,SL,,None,None,None,None
1696_240621002_B,181,WS30,Buy,2021-03-05 22:00:00,2021-03-05 22:00:00,31564.0,31514.0,0.3,-15.21,13330.49,SL,,None,None,None,None
1697_240621002_B,181,WS30,Buy,2021-03-08 16:00:00,2021-03-08 17:00:00,31676.0,31626.0,0.3,-15.21,13315.28,SL,,None,None,None,None
1699_240621002_B,181,WS30,Buy,2021-03-10 18:00:00,2021-03-10 20:00:00,32247.0,32197.0,0.3,-15.21,13300.07,SL,,None,None,None,None
1700_240621002_B,181,WS30,Buy,2021-03-11 16:00:00,2021-03-12 10:00:00,32489.0,32439.0,0.3,-17.42,13282.64,SL,,None,None,None,None
1701_240621002_B,181,WS30,Buy,2021-03-12 22:00:00,2021-03-15 16:00:00,32758.0,32758.0,0.3,-2.42,13280.22,MoveSL2BE,,None,None,None,None
1702_240621002_B,181,WS30,Buy,2021-03-15 21:00:00,2021-03-16 16:00:00,32924.0,32874.0,0.3,-21.85,13258.37,SL,,None,None,None,None
1704_240621002_B,181,WS30,Buy,2021-03-18 01:00:00,2021-03-18 10:00:00,33072.0,33022.0,0.3,-15.21,13243.16,SL,,None,None,None,None
1710_240621002_B,181,WS30,Buy,2021-03-26 10:00:00,2021-03-26 11:00:00,32765.0,32715.0,0.3,-15.21,13227.95,SL,,None,None,None,None
1711_240621002_B,181,WS30,Buy,2021-03-29 22:00:00,2021-03-30 03:00:00,33205.0,33155.0,0.3,-21.85,13206.09,SL,,None,None,None,None
1715_240621002_B,181,WS30,Buy,2021-04-02 15:00:00,2021-04-06 06:00:00,33278.0,33458.0,0.3,44.93,13251.03,Exit After X Bars,,None,None,None,None
1719_240621002_B,181,WS30,Buy,2021-04-09 21:00:00,2021-04-13 05:00:00,33649.0,33749.0,0.3,20.93,13271.96,Exit After X Bars,,None,None,None,None
1722_240621002_B,181,WS30,Buy,2021-04-15 17:00:00,2021-04-19 01:00:00,34006.0,34119.0,0.3,29.26,13301.22,Exit After X Bars,,None,None,None,None
1731_240621002_B,181,WS30,Buy,2021-04-29 21:00:00,2021-04-29 23:00:00,34069.0,34019.0,0.3,-15.21,13286.01,SL,,None,None,None,None
1733_240621002_B,181,WS30,Buy,2021-05-03 16:00:00,2021-05-03 22:00:00,34144.0,34094.0,0.3,-15.21,13270.8,SL,,None,None,None,None
1735_240621002_B,181,WS30,Buy,2021-05-05 18:00:00,2021-05-05 22:00:00,34255.0,34205.0,0.3,-15.21,13255.59,SL,,None,None,None,None
1736_240621002_B,181,WS30,Buy,2021-05-06 18:00:00,2021-05-06 19:00:00,34428.0,34378.0,0.3,-15.21,13240.38,SL,,None,None,None,None
1737_240621002_B,181,WS30,Buy,2021-05-07 15:00:00,2021-05-07 15:00:00,34655.0,34605.0,0.3,-15.21,13225.17,SL,,None,None,None,None
1738_240621002_B,181,WS30,Buy,2021-05-10 15:00:00,2021-05-10 21:00:00,34911.0,34911.0,0.3,-0.21,13224.96,MoveSL2BE,,None,None,None,None
1742_240621002_B,181,WS30,Buy,2021-05-14 16:00:00,2021-05-14 17:00:00,34274.0,34224.0,0.3,-15.21,13209.75,SL,,None,None,None,None
1746_240621002_B,181,WS30,Buy,2021-05-20 18:00:00,2021-05-20 19:00:00,34160.0,34110.0,0.3,-15.21,13194.54,SL,,None,None,None,None
1747_240621002_B,181,WS30,Buy,2021-05-21 16:00:00,2021-05-21 19:00:00,34333.0,34283.0,0.3,-15.21,13179.33,SL,,None,None,None,None
1751_240621002_B,181,WS30,Buy,2021-05-27 16:00:00,2021-05-27 17:00:00,34561.0,34511.0,0.3,-15.21,13164.12,SL,,None,None,None,None
1754_240621002_B,181,WS30,Buy,2021-06-01 10:00:00,2021-06-01 17:00:00,34693.0,34643.0,0.3,-15.21,13148.91,SL,,None,None,None,None
1757_240621002_B,181,WS30,Buy,2021-06-04 22:00:00,2021-06-07 04:00:00,34765.0,34715.0,0.3,-17.42,13131.49,SL,,None,None,None,None
1769_240621002_B,181,WS30,Buy,2021-06-22 22:00:00,2021-06-22 22:00:00,34012.0,33962.0,0.3,-15.21,13116.28,SL,,None,None,None,None
1771_240621002_B,181,WS30,Buy,2021-06-24 16:00:00,2021-06-24 17:00:00,34175.0,34125.0,0.3,-15.21,13101.07,SL,,None,None,None,None
1772_240621002_B,181,WS30,Buy,2021-06-25 04:00:00,2021-06-25 09:00:00,34336.0,34286.0,0.3,-15.21,13085.86,SL,,None,None,None,None
1775_240621002_B,181,WS30,Buy,2021-07-01 01:00:00,2021-07-01 13:00:00,34576.0,34526.0,0.3,-15.21,13070.65,SL,,None,None,None,None
1776_240621002_B,181,WS30,Buy,2021-07-02 19:00:00,2021-07-05 03:00:00,34761.0,34711.0,0.3,-17.42,13053.23,SL,,None,None,None,None
1781_240621002_B,181,WS30,Buy,2021-07-09 17:00:00,2021-07-12 10:00:00,34795.0,34745.0,0.3,-17.42,13035.8,SL,,None,None,None,None
1782_240621002_B,181,WS30,Buy,2021-07-12 17:00:00,2021-07-12 18:00:00,34991.0,34941.0,0.3,-15.21,13020.59,SL,,None,None,None,None
1789_240621002_B,181,WS30,Buy,2021-07-21 10:00:00,2021-07-21 11:00:00,34715.0,34665.0,0.3,-15.21,13005.38,SL,,None,None,None,None
1791_240621002_B,181,WS30,Buy,2021-07-23 15:00:00,2021-07-23 16:00:00,34995.0,34945.0,0.3,-15.21,12990.17,SL,,None,None,None,None
1801_240621002_B,181,WS30,Buy,2021-08-06 16:00:00,2021-08-09 02:00:00,35159.0,35109.0,0.3,-17.42,12972.75,SL,,None,None,None,None
1804_240621002_B,181,WS30,Buy,2021-08-11 16:00:00,2021-08-12 16:00:00,35380.0,35416.0,0.3,8.38,12981.12,TrailingStop,,None,None,None,None
1811_240621002_B,181,WS30,Buy,2021-08-20 19:00:00,2021-08-20 21:00:00,35100.0,35050.0,0.3,-15.21,12965.91,SL,,None,None,None,None
1812_240621002_B,181,WS30,Buy,2021-08-23 13:00:00,2021-08-24 20:00:00,35273.0,35394.0,0.3,29.45,12995.36,Exit After X Bars,,None,None,None,None
1834_240621002_B,181,WS30,Buy,2021-09-23 12:00:00,2021-09-23 12:00:00,34544.0,34494.0,0.3,-15.21,12980.15,SL,,None,None,None,None
1836_240621002_B,181,WS30,Buy,2021-09-27 03:00:00,2021-09-27 12:00:00,34956.0,34906.0,0.3,-15.21,12964.94,SL,,None,None,None,None
1844_240621002_B,181,WS30,Buy,2021-10-07 04:00:00,2021-10-08 11:00:00,34533.0,34794.0,0.3,75.88,13040.82,Exit After X Bars,,None,None,None,None
1849_240621002_B,181,WS30,Buy,2021-10-14 09:00:00,2021-10-14 10:00:00,34561.0,34511.0,0.3,-15.21,13025.61,SL,,None,None,None,None
1850_240621002_B,181,WS30,Buy,2021-10-15 05:00:00,2021-10-18 12:00:00,35023.0,35204.0,0.3,51.88,13077.48,Exit After X Bars,,None,None,None,None
1852_240621002_B,181,WS30,Buy,2021-10-19 14:00:00,2021-10-19 15:00:00,35447.0,35397.0,0.3,-15.21,13062.27,SL,,None,None,None,None
1853_240621002_B,181,WS30,Buy,2021-10-20 17:00:00,2021-10-21 07:00:00,35578.0,35528.0,0.3,-17.42,13044.85,SL,,None,None,None,None
1855_240621002_B,181,WS30,Buy,2021-10-22 17:00:00,2021-10-22 17:00:00,35758.0,35708.0,0.3,-15.21,13029.64,SL,,None,None,None,None
1857_240621002_B,181,WS30,Buy,2021-10-26 17:00:00,2021-10-26 18:00:00,35884.0,35834.0,0.3,-15.21,13014.43,SL,,None,None,None,None
1860_240621002_B,181,WS30,Buy,2021-11-01 00:00:00,2021-11-01 16:00:00,35867.0,35867.0,0.3,-0.21,13014.22,MoveSL2BE,,None,None,None,None
1862_240621002_B,181,WS30,Buy,2021-11-04 01:00:00,2021-11-04 02:00:00,36184.0,36134.0,0.3,-15.21,12999.01,SL,,None,None,None,None
1863_240621002_B,181,WS30,Buy,2021-11-05 15:00:00,2021-11-05 19:00:00,36290.0,36290.0,0.3,-0.21,12998.8,MoveSL2BE,,None,None,None,None
1869_240621002_B,181,WS30,Buy,2021-11-15 15:00:00,2021-11-15 16:00:00,36245.0,36195.0,0.3,-15.21,12983.59,SL,,None,None,None,None
1877_240621002_B,181,WS30,Buy,2021-11-25 07:00:00,2021-11-25 11:00:00,35929.0,35879.0,0.3,-15.21,12968.38,SL,,None,None,None,None
1884_240621002_B,181,WS30,Buy,2021-12-06 16:00:00,2021-12-07 23:00:00,34904.0,35733.0,0.3,241.85,13210.23,Exit After X Bars,,None,None,None,None
1885_240621002_B,181,WS30,Buy,2021-12-08 13:00:00,2021-12-08 14:00:00,35917.0,35867.0,0.3,-15.21,13195.02,SL,,None,None,None,None
1887_240621002_B,181,WS30,Buy,2021-12-10 15:00:00,2021-12-10 16:00:00,35961.0,35911.0,0.3,-15.21,13179.81,SL,,None,None,None,None
1888_240621002_B,181,WS30,Buy,2021-12-13 11:00:00,2021-12-13 12:00:00,36085.0,36035.0,0.3,-15.21,13164.6,SL,,None,None,None,None
1890_240621002_B,181,WS30,Buy,2021-12-15 22:00:00,2021-12-16 19:00:00,35877.0,35942.0,0.3,17.08,13181.67,TrailingStop,,None,None,None,None
1894_240621002_B,181,WS30,Buy,2021-12-22 17:00:00,2021-12-27 01:00:00,35626.0,35969.0,0.3,96.05,13277.72,Exit After X Bars,,None,None,None,None
1895_240621002_B,181,WS30,Buy,2021-12-27 18:00:00,2021-12-29 02:00:00,36163.0,36433.0,0.3,71.93,13349.66,Exit After X Bars,,None,None,None,None
1897_240621002_B,181,WS30,Buy,2021-12-30 16:00:00,2021-12-30 16:00:00,36670.0,36620.0,0.3,-15.21,13334.45,SL,,None,None,None,None
1899_240621002_B,181,WS30,Buy,2022-01-03 22:00:00,2022-01-04 01:00:00,36583.0,36533.0,0.3,-21.85,13312.59,SL,,None,None,None,None
1900_240621002_B,181,WS30,Buy,2022-01-04 12:00:00,2022-01-05 07:00:00,36690.0,36690.0,0.3,-2.42,13310.17,MoveSL2BE,,None,None,None,None
1906_240621002_B,181,WS30,Buy,2022-01-12 15:00:00,2022-01-12 16:00:00,36374.0,36324.0,0.3,-15.21,13294.96,SL,,None,None,None,None
1916_240621002_B,181,WS30,Buy,2022-01-26 13:00:00,2022-01-26 14:00:00,34689.0,34639.0,0.3,-15.21,13279.75,SL,,None,None,None,None
1919_240621002_B,181,WS30,Buy,2022-01-31 17:00:00,2022-01-31 17:00:00,34839.0,34789.0,0.3,-15.21,13264.54,SL,,None,None,None,None
1920_240621002_B,181,WS30,Buy,2022-02-01 22:00:00,2022-02-03 06:00:00,35250.0,35604.0,0.3,101.56,13366.1,Exit After X Bars,,None,None,None,None
1924_240621002_B,181,WS30,Buy,2022-02-08 19:00:00,2022-02-08 21:00:00,35427.0,35377.0,0.3,-15.21,13350.89,SL,,None,None,None,None
1925_240621002_B,181,WS30,Buy,2022-02-09 10:00:00,2022-02-10 15:00:00,35644.0,35614.0,0.3,-11.42,13339.47,TrailingStop,,None,None,None,None
1929_240621002_B,181,WS30,Buy,2022-02-15 13:00:00,2022-02-15 14:00:00,34946.0,34896.0,0.3,-15.21,13324.26,SL,,None,None,None,None
1937_240621002_B,181,WS30,Buy,2022-02-25 15:00:00,2022-02-25 16:00:00,33369.0,33319.0,0.3,-15.21,13309.05,SL,,None,None,None,None
1939_240621002_B,181,WS30,Buy,2022-03-01 09:00:00,2022-03-01 10:00:00,34063.0,34013.0,0.3,-15.21,13293.84,SL,,None,None,None,None
1941_240621002_B,181,WS30,Buy,2022-03-03 16:00:00,2022-03-03 16:00:00,34110.0,34060.0,0.3,-15.21,13278.63,SL,,None,None,None,None
1947_240621002_B,181,WS30,Buy,2022-03-11 13:00:00,2022-03-11 16:00:00,33400.0,33350.0,0.3,-15.21,13263.42,SL,,None,None,None,None
1949_240621002_B,181,WS30,Buy,2022-03-15 20:00:00,2022-03-16 02:00:00,33494.0,33444.0,0.3,-17.42,13245.99,SL,,None,None,None,None
1950_240621002_B,181,WS30,Buy,2022-03-16 08:00:00,2022-03-16 20:00:00,33717.0,33667.0,0.3,-15.21,13230.78,SL,,None,None,None,None
1951_240621002_B,181,WS30,Buy,2022-03-17 18:00:00,2022-03-21 02:00:00,34188.0,34712.0,0.3,152.56,13383.35,Exit After X Bars,,None,None,None,None
1956_240621002_B,181,WS30,Buy,2022-03-25 16:00:00,2022-03-25 17:00:00,34835.0,34785.0,0.3,-15.21,13368.14,SL,,None,None,None,None
1958_240621002_B,181,WS30,Buy,2022-03-29 12:00:00,2022-03-29 19:00:00,35086.0,35036.0,0.3,-15.21,13352.93,SL,,None,None,None,None
1963_240621002_B,181,WS30,Buy,2022-04-05 17:00:00,2022-04-05 17:00:00,35045.0,34995.0,0.3,-15.21,13337.72,SL,,None,None,None,None
1966_240621002_B,181,WS30,Buy,2022-04-08 17:00:00,2022-04-08 21:00:00,34804.0,34754.0,0.3,-15.21,13322.51,SL,,None,None,None,None
1970_240621002_B,181,WS30,Buy,2022-04-14 16:00:00,2022-04-14 17:00:00,34699.0,34649.0,0.3,-15.21,13307.3,SL,,None,None,None,None
1972_240621002_B,181,WS30,Buy,2022-04-19 16:00:00,2022-04-20 23:00:00,34721.0,35170.0,0.3,132.28,13439.57,Exit After X Bars,,None,None,None,None
1973_240621002_B,181,WS30,Buy,2022-04-21 14:00:00,2022-04-21 16:00:00,35419.0,35369.0,0.3,-15.21,13424.36,SL,,None,None,None,None
1978_240621002_B,181,WS30,Buy,2022-04-28 19:00:00,2022-04-29 13:00:00,33800.0,33750.0,0.3,-17.42,13406.94,SL,,None,None,None,None
1981_240621002_B,181,WS30,Buy,2022-05-03 18:00:00,2022-05-03 18:00:00,33336.0,33286.0,0.3,-15.21,13391.73,SL,,None,None,None,None
1982_240621002_B,181,WS30,Buy,2022-05-04 21:00:00,2022-05-05 16:00:00,33442.0,33722.0,0.3,81.58,13473.3,TrailingStop,,None,None,None,None
1989_240621002_B,181,WS30,Buy,2022-05-13 14:00:00,2022-05-13 16:00:00,32065.0,32015.0,0.3,-15.21,13458.09,SL,,None,None,None,None
1990_240621002_B,181,WS30,Buy,2022-05-16 20:00:00,2022-05-16 22:00:00,32377.0,32327.0,0.3,-15.21,13442.88,SL,,None,None,None,None
1991_240621002_B,181,WS30,Buy,2022-05-17 11:00:00,2022-05-17 11:00:00,32612.0,32562.0,0.3,-15.21,13427.67,SL,,None,None,None,None
1995_240621002_B,181,WS30,Buy,2022-05-23 17:00:00,2022-05-24 08:00:00,31690.0,31640.0,0.3,-21.85,13405.82,SL,,None,None,None,None
1997_240621002_B,181,WS30,Buy,2022-05-25 17:00:00,2022-05-25 17:00:00,32114.0,32064.0,0.3,-15.21,13390.61,SL,,None,None,None,None
1998_240621002_B,181,WS30,Buy,2022-05-26 14:00:00,2022-05-26 15:00:00,32354.0,32304.0,0.3,-15.21,13375.4,SL,,None,None,None,None
1999_240621002_B,181,WS30,Buy,2022-05-27 16:00:00,2022-05-31 01:00:00,32873.0,33211.0,0.3,92.33,13467.74,TrailingStop,,None,None,None,None
2011_240621002_B,181,WS30,Buy,2022-06-15 22:00:00,2022-06-15 22:00:00,30976.0,30926.0,0.3,-15.21,13452.53,SL,,None,None,None,None
2015_240621002_B,181,WS30,Buy,2022-06-21 06:00:00,2022-06-21 08:00:00,30325.0,30275.0,0.3,-15.21,13437.32,SL,,None,None,None,None
2016_240621002_B,181,WS30,Buy,2022-06-22 21:00:00,2022-06-22 21:00:00,30753.0,30703.0,0.3,-15.21,13422.11,SL,,None,None,None,None
2018_240621002_B,181,WS30,Buy,2022-06-24 07:00:00,2022-06-27 14:00:00,30809.0,31590.0,0.3,231.88,13653.98,Exit After X Bars,,None,None,None,None
2020_240621002_B,181,WS30,Buy,2022-06-28 16:00:00,2022-06-28 16:00:00,31805.0,31755.0,0.3,-15.21,13638.77,SL,,None,None,None,None
2025_240621002_B,181,WS30,Buy,2022-07-05 06:00:00,2022-07-05 06:00:00,31187.0,31137.0,0.3,-15.21,13623.56,SL,,None,None,None,None
2027_240621002_B,181,WS30,Buy,2022-07-07 16:00:00,2022-07-07 17:00:00,31325.0,31275.0,0.3,-15.21,13608.35,SL,,None,None,None,None
2033_240621002_B,181,WS30,Buy,2022-07-15 15:00:00,2022-07-18 20:00:00,30892.0,31327.0,0.3,128.08,13736.43,TrailingStop,,None,None,None,None
2034_240621002_B,181,WS30,Buy,2022-07-19 20:00:00,2022-07-20 13:00:00,31738.0,31738.0,0.3,-2.42,13734,MoveSL2BE,,None,None,None,None
2035_240621002_B,181,WS30,Buy,2022-07-20 19:00:00,2022-07-20 19:00:00,31939.0,31889.0,0.3,-15.21,13718.79,SL,,None,None,None,None
2037_240621002_B,181,WS30,Buy,2022-07-22 16:00:00,2022-07-22 16:00:00,32150.0,32100.0,0.3,-15.21,13703.58,SL,,None,None,None,None
2040_240621002_B,181,WS30,Buy,2022-07-27 21:00:00,2022-07-28 17:00:00,32042.0,31992.0,0.3,-17.42,13686.16,SL,,None,None,None,None
2041_240621002_B,181,WS30,Buy,2022-07-28 18:00:00,2022-07-28 18:00:00,32439.0,32389.0,0.3,-15.21,13670.95,SL,,None,None,None,None
2042_240621002_B,181,WS30,Buy,2022-07-29 17:00:00,2022-07-29 17:00:00,32710.0,32660.0,0.3,-15.21,13655.74,SL,,None,None,None,None
2048_240621002_B,181,WS30,Buy,2022-08-08 10:00:00,2022-08-08 11:00:00,32926.0,32876.0,0.3,-15.21,13640.53,SL,,None,None,None,None
2050_240621002_B,181,WS30,Buy,2022-08-10 15:00:00,2022-08-11 21:00:00,33012.0,33371.0,0.3,105.28,13745.81,TrailingStop,,None,None,None,None
2052_240621002_B,181,WS30,Buy,2022-08-12 22:00:00,2022-08-15 01:00:00,33749.0,33699.0,0.3,-17.42,13728.38,SL,,None,None,None,None
2053_240621002_B,181,WS30,Buy,2022-08-15 18:00:00,2022-08-17 02:00:00,33857.0,34125.0,0.3,71.33,13799.72,Exit After X Bars,,None,None,None,None
2060_240621002_B,181,WS30,Buy,2022-08-25 22:00:00,2022-08-26 17:00:00,33193.0,33193.0,0.3,-2.42,13797.29,MoveSL2BE,,None,None,None,None
2066_240621002_B,181,WS30,Buy,2022-09-02 15:00:00,2022-09-02 16:00:00,31771.0,31721.0,0.3,-15.21,13782.08,SL,,None,None,None,None
2068_240621002_B,181,WS30,Buy,2022-09-06 10:00:00,2022-09-06 11:00:00,31563.0,31513.0,0.3,-15.21,13766.87,SL,,None,None,None,None
2070_240621002_B,181,WS30,Buy,2022-09-08 18:00:00,2022-09-08 18:00:00,31743.0,31693.0,0.3,-15.21,13751.66,SL,,None,None,None,None
2071_240621002_B,181,WS30,Buy,2022-09-09 10:00:00,2022-09-12 17:00:00,31902.0,32439.0,0.3,158.68,13910.34,Exit After X Bars,,None,None,None,None
2072_240621002_B,181,WS30,Buy,2022-09-12 19:00:00,2022-09-13 15:00:00,32325.0,32379.0,0.3,9.35,13919.69,TrailingStop,,None,None,None,None
2077_240621002_B,181,WS30,Buy,2022-09-19 22:00:00,2022-09-20 12:00:00,30968.0,30918.0,0.3,-21.85,13897.83,SL,,None,None,None,None
2084_240621002_B,181,WS30,Buy,2022-09-28 22:00:00,2022-09-28 22:00:00,29758.0,29708.0,0.3,-15.21,13882.62,SL,,None,None,None,None
2087_240621002_B,181,WS30,Buy,2022-10-03 21:00:00,2022-10-03 22:00:00,29592.0,29542.0,0.3,-15.21,13867.41,SL,,None,None,None,None
2088_240621002_B,181,WS30,Buy,2022-10-04 07:00:00,2022-10-04 08:00:00,29744.0,29694.0,0.3,-15.21,13852.2,SL,,None,None,None,None
2089_240621002_B,181,WS30,Buy,2022-10-05 22:00:00,2022-10-05 22:00:00,30444.0,30394.0,0.3,-15.21,13836.99,SL,,None,None,None,None
2093_240621002_B,181,WS30,Buy,2022-10-11 19:00:00,2022-10-11 20:00:00,29588.0,29538.0,0.3,-15.21,13821.78,SL,,None,None,None,None
2095_240621002_B,181,WS30,Buy,2022-10-13 15:00:00,2022-10-13 15:00:00,29577.0,29527.0,0.3,-15.21,13806.57,SL,,None,None,None,None
2096_240621002_B,181,WS30,Buy,2022-10-14 15:00:00,2022-10-14 16:00:00,30277.0,30227.0,0.3,-15.21,13791.36,SL,,None,None,None,None
2098_240621002_B,181,WS30,Buy,2022-10-18 06:00:00,2022-10-18 18:00:00,30420.0,30420.0,0.3,-0.21,13791.15,MoveSL2BE,,None,None,None,None
2101_240621002_B,181,WS30,Buy,2022-10-21 19:00:00,2022-10-21 20:00:00,30916.0,30866.0,0.3,-15.21,13775.94,SL,,None,None,None,None
2102_240621002_B,181,WS30,Buy,2022-10-24 13:00:00,2022-10-24 17:00:00,31218.0,31218.0,0.3,-0.21,13775.73,MoveSL2BE,,None,None,None,None
2103_240621002_B,181,WS30,Buy,2022-10-25 17:00:00,2022-10-25 17:00:00,31697.0,31647.0,0.3,-15.21,13760.52,SL,,None,None,None,None
2104_240621002_B,181,WS30,Buy,2022-10-26 17:00:00,2022-10-26 20:00:00,31975.0,31925.0,0.3,-15.21,13745.31,SL,,None,None,None,None
2105_240621002_B,181,WS30,Buy,2022-10-27 16:00:00,2022-10-27 16:00:00,32272.0,32222.0,0.3,-15.21,13730.1,SL,,None,None,None,None
2106_240621002_B,181,WS30,Buy,2022-10-28 16:00:00,2022-10-28 16:00:00,32481.0,32431.0,0.3,-15.21,13714.89,SL,,None,None,None,None
2111_240621002_B,181,WS30,Buy,2022-11-04 15:00:00,2022-11-04 15:00:00,32340.0,32290.0,0.3,-15.21,13699.68,SL,,None,None,None,None
2112_240621002_B,181,WS30,Buy,2022-11-07 20:00:00,2022-11-08 21:00:00,32704.0,33012.0,0.3,85.55,13785.23,TrailingStop,,None,None,None,None
2114_240621002_B,181,WS30,Buy,2022-11-10 15:00:00,2022-11-10 16:00:00,33298.0,33248.0,0.3,-15.21,13770.02,SL,,None,None,None,None
2115_240621002_B,181,WS30,Buy,2022-11-11 07:00:00,2022-11-11 16:00:00,33838.0,33788.0,0.3,-15.21,13754.81,SL,,None,None,None,None
2120_240621002_B,181,WS30,Buy,2022-11-18 15:00:00,2022-11-18 16:00:00,33785.0,33735.0,0.3,-15.21,13739.6,SL,,None,None,None,None
2122_240621002_B,181,WS30,Buy,2022-11-22 17:00:00,2022-11-24 01:00:00,33962.0,34239.0,0.3,78.46,13818.06,Exit After X Bars,,None,None,None,None
2127_240621002_B,181,WS30,Buy,2022-11-30 21:00:00,2022-12-01 17:00:00,34067.0,34336.0,0.3,78.28,13896.34,TrailingStop,,None,None,None,None
2132_240621002_B,181,WS30,Buy,2022-12-08 17:00:00,2022-12-08 18:00:00,33873.0,33823.0,0.3,-15.21,13881.13,SL,,None,None,None,None
2135_240621002_B,181,WS30,Buy,2022-12-13 11:00:00,2022-12-13 12:00:00,34096.0,34046.0,0.3,-15.21,13865.92,SL,,None,None,None,None
2141_240621002_B,181,WS30,Buy,2022-12-21 11:00:00,2022-12-21 14:00:00,33093.0,33043.0,0.3,-15.21,13850.71,SL,,None,None,None,None
2147_240621002_B,181,WS30,Buy,2023-01-03 01:00:00,2023-01-03 01:00:00,33394.0,33344.0,0.3,-15.21,13835.5,SL,,None,None,None,None
2150_240621002_B,181,WS30,Buy,2023-01-06 17:00:00,2023-01-09 20:00:00,33406.0,33636.0,0.3,66.58,13902.08,TrailingStop,,None,None,None,None
2152_240621002_B,181,WS30,Buy,2023-01-11 16:00:00,2023-01-11 16:00:00,33826.0,33776.0,0.3,-15.21,13886.87,SL,,None,None,None,None
2153_240621002_B,181,WS30,Buy,2023-01-12 15:00:00,2023-01-12 16:00:00,34072.0,34022.0,0.3,-15.21,13871.66,SL,,None,None,None,None
2159_240621002_B,181,WS30,Buy,2023-01-20 22:00:00,2023-01-23 02:00:00,33374.0,33324.0,0.3,-17.42,13854.23,SL,,None,None,None,None
2160_240621002_B,181,WS30,Buy,2023-01-23 16:00:00,2023-01-23 16:00:00,33484.0,33434.0,0.3,-15.21,13839.02,SL,,None,None,None,None
2163_240621002_B,181,WS30,Buy,2023-01-26 16:00:00,2023-01-26 16:00:00,33874.0,33824.0,0.3,-15.21,13823.81,SL,,None,None,None,None
2164_240621002_B,181,WS30,Buy,2023-01-27 17:00:00,2023-01-27 17:00:00,34068.0,34018.0,0.3,-15.21,13808.6,SL,,None,None,None,None
2167_240621002_B,181,WS30,Buy,2023-02-01 22:00:00,2023-02-01 22:00:00,34194.0,34144.0,0.3,-15.21,13793.39,SL,,None,None,None,None
2171_240621002_B,181,WS30,Buy,2023-02-07 19:00:00,2023-02-07 20:00:00,34067.0,34017.0,0.3,-15.21,13778.18,SL,,None,None,None,None
2175_240621002_B,181,WS30,Buy,2023-02-13 16:00:00,2023-02-14 16:00:00,33997.0,34135.0,0.3,34.55,13812.73,TrailingStop,,None,None,None,None
2188_240621002_B,181,WS30,Buy,2023-03-02 20:00:00,2023-03-06 04:00:00,32877.0,33379.0,0.3,145.96,13958.69,Exit After X Bars,,None,None,None,None
2189_240621002_B,181,WS30,Buy,2023-03-06 17:00:00,2023-03-06 18:00:00,33507.0,33457.0,0.3,-15.21,13943.48,SL,,None,None,None,None
2200_240621002_B,181,WS30,Buy,2023-03-21 11:00:00,2023-03-22 18:00:00,32386.0,32526.0,0.3,39.58,13983.06,Exit After X Bars,,None,None,None,None
2201_240621002_B,181,WS30,Buy,2023-03-22 20:00:00,2023-03-22 20:00:00,32695.0,32645.0,0.3,-15.21,13967.85,SL,,None,None,None,None
2204_240621002_B,181,WS30,Buy,2023-03-27 04:00:00,2023-03-27 10:00:00,32358.0,32308.0,0.3,-15.21,13952.64,SL,,None,None,None,None
2206_240621002_B,181,WS30,Buy,2023-03-29 22:00:00,2023-03-30 18:00:00,32682.0,32748.0,0.3,17.38,13970.01,TrailingStop,,None,None,None,None
2207_240621002_B,181,WS30,Buy,2023-03-31 16:00:00,2023-04-03 23:00:00,33029.0,33597.0,0.3,167.98,14137.99,Exit After X Bars,,None,None,None,None
2212_240621002_B,181,WS30,Buy,2023-04-11 18:00:00,2023-04-12 17:00:00,33706.0,33706.0,0.3,-2.42,14135.57,MoveSL2BE,,None,None,None,None
2213_240621002_B,181,WS30,Buy,2023-04-12 21:00:00,2023-04-12 21:00:00,33882.0,33832.0,0.3,-15.21,14120.36,SL,,None,None,None,None
2214_240621002_B,181,WS30,Buy,2023-04-13 21:00:00,2023-04-14 01:00:00,34046.0,33996.0,0.3,-17.42,14102.93,SL,,None,None,None,None
2217_240621002_B,181,WS30,Buy,2023-04-18 13:00:00,2023-04-18 14:00:00,34096.0,34046.0,0.3,-15.21,14087.72,SL,,None,None,None,None
2224_240621002_B,181,WS30,Buy,2023-04-27 20:00:00,2023-04-28 10:00:00,33739.0,33739.0,0.3,-2.42,14085.3,MoveSL2BE,,None,None,None,None
2225_240621002_B,181,WS30,Buy,2023-04-28 17:00:00,2023-04-28 18:00:00,33961.0,33911.0,0.3,-15.21,14070.09,SL,,None,None,None,None
2226_240621002_B,181,WS30,Buy,2023-05-01 17:00:00,2023-05-01 18:00:00,34228.0,34178.0,0.3,-15.21,14054.88,SL,,None,None,None,None
2230_240621002_B,181,WS30,Buy,2023-05-05 16:00:00,2023-05-05 18:00:00,33568.0,33518.0,0.3,-15.21,14039.67,SL,,None,None,None,None
2233_240621002_B,181,WS30,Buy,2023-05-10 15:00:00,2023-05-10 16:00:00,33749.0,33699.0,0.3,-15.21,14024.46,SL,,None,None,None,None
2238_240621002_B,181,WS30,Buy,2023-05-17 20:00:00,2023-05-17 21:00:00,33440.0,33390.0,0.3,-15.21,14009.25,SL,,None,None,None,None
2239_240621002_B,181,WS30,Buy,2023-05-18 22:00:00,2023-05-19 18:00:00,33575.0,33525.0,0.3,-17.42,13991.82,SL,,None,None,None,None
2245_240621002_B,181,WS30,Buy,2023-05-26 16:00:00,2023-05-30 04:00:00,32970.0,33132.0,0.3,39.53,14031.36,Exit After X Bars,,None,None,None,None
2248_240621002_B,181,WS30,Buy,2023-06-01 19:00:00,2023-06-01 22:00:00,33106.0,33056.0,0.3,-15.21,14016.15,SL,,None,None,None,None
2249_240621002_B,181,WS30,Buy,2023-06-02 15:00:00,2023-06-05 17:00:00,33265.0,33635.0,0.3,108.58,14124.72,TrailingStop,,None,None,None,None
2253_240621002_B,181,WS30,Buy,2023-06-08 19:00:00,2023-06-09 10:00:00,33807.0,33757.0,0.3,-17.42,14107.3,SL,,None,None,None,None
2254_240621002_B,181,WS30,Buy,2023-06-09 17:00:00,2023-06-09 18:00:00,33975.0,33925.0,0.3,-15.21,14092.09,SL,,None,None,None,None
2255_240621002_B,181,WS30,Buy,2023-06-12 22:00:00,2023-06-13 15:00:00,34076.0,34026.0,0.3,-21.85,14070.24,SL,,None,None,None,None
2256_240621002_B,181,WS30,Buy,2023-06-13 22:00:00,2023-06-14 01:00:00,34182.0,34132.0,0.3,-17.42,14052.81,SL,,None,None,None,None
2258_240621002_B,181,WS30,Buy,2023-06-15 18:00:00,2023-06-16 22:00:00,34292.0,34298.0,0.3,-0.62,14052.19,TrailingStop,,None,None,None,None
2265_240621002_B,181,WS30,Buy,2023-06-27 20:00:00,2023-06-28 16:00:00,33918.0,33868.0,0.3,-17.42,14034.77,SL,,None,None,None,None
2267_240621002_B,181,WS30,Buy,2023-06-29 17:00:00,2023-06-29 17:00:00,34062.0,34012.0,0.3,-15.21,14019.56,SL,,None,None,None,None
2268_240621002_B,181,WS30,Buy,2023-06-30 15:00:00,2023-07-03 16:00:00,34251.0,34284.0,0.3,7.48,14027.03,TrailingStop,,None,None,None,None
2273_240621002_B,181,WS30,Buy,2023-07-11 15:00:00,2023-07-11 17:00:00,34062.0,34012.0,0.3,-15.21,14011.82,SL,,None,None,None,None
2274_240621002_B,181,WS30,Buy,2023-07-12 15:00:00,2023-07-12 18:00:00,34396.0,34396.0,0.3,-0.21,14011.61,MoveSL2BE,,None,None,None,None
2276_240621002_B,181,WS30,Buy,2023-07-14 15:00:00,2023-07-14 17:00:00,34570.0,34520.0,0.3,-15.21,13996.4,SL,,None,None,None,None
2278_240621002_B,181,WS30,Buy,2023-07-18 16:00:00,2023-07-19 23:00:00,34767.0,35064.0,0.3,86.68,14083.08,Exit After X Bars,,None,None,None,None
2279_240621002_B,181,WS30,Buy,2023-07-20 18:00:00,2023-07-20 20:00:00,35331.0,35281.0,0.3,-15.21,14067.87,SL,,None,None,None,None
2281_240621002_B,181,WS30,Buy,2023-07-24 18:00:00,2023-07-24 22:00:00,35440.0,35390.0,0.3,-15.21,14052.66,SL,,None,None,None,None
2283_240621002_B,181,WS30,Buy,2023-07-26 21:00:00,2023-07-26 21:00:00,35629.0,35579.0,0.3,-15.21,14037.45,SL,,None,None,None,None
2287_240621002_B,181,WS30,Buy,2023-08-01 17:00:00,2023-08-01 17:00:00,35677.0,35627.0,0.3,-15.21,14022.24,SL,,None,None,None,None
2290_240621002_B,181,WS30,Buy,2023-08-04 19:00:00,2023-08-04 20:00:00,35475.0,35425.0,0.3,-15.21,14007.03,SL,,None,None,None,None
2294_240621002_B,181,WS30,Buy,2023-08-10 16:00:00,2023-08-10 17:00:00,35506.0,35456.0,0.3,-15.21,13991.82,SL,,None,None,None,None
2304_240621002_B,181,WS30,Buy,2023-08-24 16:00:00,2023-08-24 17:00:00,34634.0,34584.0,0.3,-15.21,13976.61,SL,,None,None,None,None
2306_240621002_B,181,WS30,Buy,2023-08-28 16:00:00,2023-08-28 19:00:00,34544.0,34494.0,0.3,-15.21,13961.4,SL,,None,None,None,None
2307_240621002_B,181,WS30,Buy,2023-08-29 18:00:00,2023-08-30 17:00:00,34752.0,34838.0,0.3,23.38,13984.77,TrailingStop,,None,None,None,None
2308_240621002_B,181,WS30,Buy,2023-08-30 23:00:00,2023-08-31 18:00:00,34962.0,34912.0,0.3,-17.42,13967.35,SL,,None,None,None,None
2315_240621002_B,181,WS30,Buy,2023-09-11 16:00:00,2023-09-11 16:00:00,34726.0,34676.0,0.3,-15.21,13952.14,SL,,None,None,None,None
2318_240621002_B,181,WS30,Buy,2023-09-14 19:00:00,2023-09-15 16:00:00,34876.0,34884.0,0.3,-0.02,13952.12,TrailingStop,,None,None,None,None
2328_240621002_B,181,WS30,Buy,2023-09-29 15:00:00,2023-09-29 16:00:00,33882.0,33832.0,0.3,-15.21,13936.91,SL,,None,None,None,None
2333_240621002_B,181,WS30,Buy,2023-10-06 18:00:00,2023-10-09 01:00:00,33274.0,33274.0,0.3,-2.42,13934.48,MoveSL2BE,,None,None,None,None
2334_240621002_B,181,WS30,Buy,2023-10-10 04:00:00,2023-10-10 08:00:00,33658.0,33608.0,0.3,-15.21,13919.27,SL,,None,None,None,None
2338_240621002_B,181,WS30,Buy,2023-10-16 17:00:00,2023-10-16 18:00:00,34056.0,34006.0,0.3,-15.21,13904.06,SL,,None,None,None,None
2349_240621002_B,181,WS30,Buy,2023-10-31 12:00:00,2023-10-31 12:00:00,33102.0,33052.0,0.3,-15.21,13888.85,SL,,None,None,None,None
2350_240621002_B,181,WS30,Buy,2023-11-01 16:00:00,2023-11-01 17:00:00,33234.0,33184.0,0.3,-15.21,13873.64,SL,,None,None,None,None
2351_240621002_B,181,WS30,Buy,2023-11-02 14:00:00,2023-11-03 21:00:00,33436.0,34148.0,0.3,211.18,14084.82,Exit After X Bars,,None,None,None,None
2356_240621002_B,181,WS30,Buy,2023-11-10 23:00:00,2023-11-13 01:00:00,34317.0,34267.0,0.3,-17.42,14067.39,SL,,None,None,None,None
2358_240621002_B,181,WS30,Buy,2023-11-14 15:00:00,2023-11-15 22:00:00,34508.0,35029.0,0.3,153.88,14221.27,Exit After X Bars,,None,None,None,None
2361_240621002_B,181,WS30,Buy,2023-11-20 21:00:00,2023-11-20 22:00:00,35195.0,35145.0,0.3,-15.21,14206.06,SL,,None,None,None,None
2363_240621002_B,181,WS30,Buy,2023-11-22 18:00:00,2023-11-22 19:00:00,35282.0,35232.0,0.3,-15.21,14190.85,SL,,None,None,None,None
2369_240621002_B,181,WS30,Buy,2023-11-30 15:00:00,2023-11-30 16:00:00,35678.0,35628.0,0.3,-15.21,14175.64,SL,,None,None,None,None
2370_240621002_B,181,WS30,Buy,2023-12-01 17:00:00,2023-12-01 17:00:00,36067.0,36017.0,0.3,-15.21,14160.43,SL,,None,None,None,None
2373_240621002_B,181,WS30,Buy,2023-12-06 16:00:00,2023-12-06 17:00:00,36287.0,36237.0,0.3,-15.21,14145.22,SL,,None,None,None,None
2375_240621002_B,181,WS30,Buy,2023-12-08 22:00:00,2023-12-11 10:00:00,36262.0,36212.0,0.3,-17.42,14127.8,SL,,None,None,None,None
2376_240621002_B,181,WS30,Buy,2023-12-11 20:00:00,2023-12-11 21:00:00,36390.0,36340.0,0.3,-15.21,14112.59,SL,,None,None,None,None
2377_240621002_B,181,WS30,Buy,2023-12-12 15:00:00,2023-12-12 15:00:00,36511.0,36461.0,0.3,-15.21,14097.38,SL,,None,None,None,None
2378_240621002_B,181,WS30,Buy,2023-12-13 21:00:00,2023-12-14 16:00:00,36733.0,37128.0,0.3,116.08,14213.45,TrailingStop,,None,None,None,None
2379_240621002_B,181,WS30,Buy,2023-12-14 19:00:00,2023-12-14 20:00:00,37246.0,37196.0,0.3,-15.21,14198.24,SL,,None,None,None,None
2382_240621002_B,181,WS30,Buy,2023-12-19 17:00:00,2023-12-20 21:00:00,37492.0,37513.0,0.3,3.88,14202.12,TrailingStop,,None,None,None,None
2384_240621002_B,181,WS30,Buy,2023-12-22 16:00:00,2023-12-22 17:00:00,37519.0,37469.0,0.3,-15.21,14186.91,SL,,None,None,None,None
2395_240621002_B,181,WS30,Buy,2024-01-11 04:00:00,2024-01-11 12:00:00,37746.0,37696.0,0.3,-15.21,14171.7,SL,,None,None,None,None
2400_240621002_B,181,WS30,Buy,2024-01-18 22:00:00,2024-01-19 03:00:00,37471.0,37421.0,0.3,-17.42,14154.27,SL,,None,None,None,None
2401_240621002_B,181,WS30,Buy,2024-01-19 14:00:00,2024-01-19 16:00:00,37628.0,37578.0,0.3,-15.21,14139.06,SL,,None,None,None,None
2402_240621002_B,181,WS30,Buy,2024-01-22 16:00:00,2024-01-22 18:00:00,38048.0,37998.0,0.3,-15.21,14123.85,SL,,None,None,None,None
2406_240621002_B,181,WS30,Buy,2024-01-26 17:00:00,2024-01-26 19:00:00,38157.0,38107.0,0.3,-15.21,14108.64,SL,,None,None,None,None
2407_240621002_B,181,WS30,Buy,2024-01-29 22:00:00,2024-01-30 09:00:00,38316.0,38266.0,0.3,-21.85,14086.79,SL,,None,None,None,None
2408_240621002_B,181,WS30,Buy,2024-01-30 20:00:00,2024-01-31 21:00:00,38444.0,38394.0,0.3,-17.42,14069.37,SL,,None,None,None,None
2410_240621002_B,181,WS30,Buy,2024-02-02 20:00:00,2024-02-02 23:00:00,38615.0,38615.0,0.3,-0.21,14069.16,MoveSL2BE,,None,None,None,None
2413_240621002_B,181,WS30,Buy,2024-02-07 16:00:00,2024-02-07 17:00:00,38638.0,38588.0,0.3,-15.21,14053.95,SL,,None,None,None,None
2415_240621002_B,181,WS30,Buy,2024-02-09 15:00:00,2024-02-09 15:00:00,38851.0,38801.0,0.3,-15.21,14038.74,SL,,None,None,None,None
2419_240621002_B,181,WS30,Buy,2024-02-15 16:00:00,2024-02-16 16:00:00,38537.0,38599.0,0.3,16.18,14054.91,TrailingStop,,None,None,None,None
2424_240621002_B,181,WS30,Buy,2024-02-22 08:00:00,2024-02-23 15:00:00,38717.0,39114.0,0.3,116.68,14171.59,Exit After X Bars,,None,None,None,None
2425_240621002_B,181,WS30,Buy,2024-02-23 16:00:00,2024-02-23 18:00:00,39252.0,39202.0,0.3,-15.21,14156.38,SL,,None,None,None,None
2429_240621002_B,181,WS30,Buy,2024-02-29 16:00:00,2024-02-29 16:00:00,39050.0,39000.0,0.3,-15.21,14141.17,SL,,None,None,None,None
2437_240621002_B,181,WS30,Buy,2024-03-12 14:00:00,2024-03-12 14:00:00,38894.0,38844.0,0.3,-15.21,14125.96,SL,,None,None,None,None
2438_240621002_B,181,WS30,Buy,2024-03-13 17:00:00,2024-03-13 19:00:00,39177.0,39127.0,0.3,-15.21,14110.75,SL,,None,None,None,None
2442_240621002_B,181,WS30,Buy,2024-03-19 17:00:00,2024-03-21 01:00:00,39005.0,39572.0,0.3,165.46,14276.21,Exit After X Bars,,None,None,None,None
2443_240621002_B,181,WS30,Buy,2024-03-21 07:00:00,2024-03-21 11:00:00,39647.0,39597.0,0.3,-15.21,14261,SL,,None,None,None,None
2447_240621002_B,181,WS30,Buy,2024-03-27 15:00:00,2024-03-27 18:00:00,39537.0,39487.0,0.3,-15.21,14245.79,SL,,None,None,None,None
2448_240621002_B,181,WS30,Buy,2024-04-01 01:00:00,2024-04-01 15:00:00,39908.0,39858.0,0.3,-15.21,14230.58,SL,,None,None,None,None
2451_240621002_B,181,WS30,Buy,2024-04-04 16:00:00,2024-04-04 16:00:00,39410.0,39360.0,0.3,-15.21,14215.37,SL,,None,None,None,None
2463_240621002_B,181,WS30,Buy,2024-04-22 14:00:00,2024-04-22 15:00:00,38211.0,38161.0,0.3,-15.21,14200.16,SL,,None,None,None,None
2464_240621002_B,181,WS30,Buy,2024-04-23 20:00:00,2024-04-23 21:00:00,38553.0,38503.0,0.3,-15.21,14184.95,SL,,None,None,None,None
2471_240621002_B,181,WS30,Buy,2024-05-03 01:00:00,2024-05-06 08:00:00,38458.0,38707.0,0.3,72.28,14257.23,Exit After X Bars,,None,None,None,None
2473_240621002_B,181,WS30,Buy,2024-05-07 17:00:00,2024-05-07 18:00:00,38975.0,38925.0,0.3,-15.21,14242.02,SL,,None,None,None,None
2474_240621002_B,181,WS30,Buy,2024-05-08 22:00:00,2024-05-09 06:00:00,39077.0,39027.0,0.3,-17.42,14224.59,SL,,None,None,None,None
2475_240621002_B,181,WS30,Buy,2024-05-09 17:00:00,2024-05-10 18:00:00,39194.0,39426.0,0.3,67.18,14291.77,TrailingStop,,None,None,None,None
2479_240621002_B,181,WS30,Buy,2024-05-15 15:00:00,2024-05-16 21:00:00,39714.0,39889.0,0.3,50.08,14341.85,TrailingStop,,None,None,None,None
2490_240621002_B,181,WS30,Buy,2024-05-31 20:00:00,2024-06-03 16:00:00,38301.0,38590.0,0.3,84.28,14426.12,TrailingStop,,None,None,None,None
2494_240621002_B,181,WS30,Buy,2024-06-06 16:00:00,2024-06-06 17:00:00,38947.0,38897.0,0.3,-15.21,14410.91,SL,,None,None,None,None
2495_240621002_B,181,WS30,Buy,2024-06-07 17:00:00,2024-06-07 17:00:00,39107.0,39057.0,0.3,-15.21,14395.7,SL,,None,None,None,None
2498_240621002_B,181,WS30,Buy,2024-06-12 15:00:00,2024-06-12 17:00:00,38972.0,38972.0,0.3,-0.21,14395.49,MoveSL2BE,,None,None,None,None
2501_240621002_B,181,WS30,Buy,2024-06-17 20:00:00,2024-06-19 04:00:00,38746.0,38812.0,0.3,10.73,14406.23,Exit After X Bars,,None,None,None,None
