orderId,strategyRunId,symbol,orderType,openTime,closeTime,openPrice,closePrice,size,profit,balance,closeType,comment,sl,tp,swap,commission
4_240906003_B,184,XAUUSD,Buy,2011-01-07 16:00:00,2011-01-07 20:00:00,1376.86,1367.74,1,-912,9088,Exit After X Bars,,None,None,None,None
5_240906003_B,184,XAUUSD,Buy,2011-01-11 08:00:00,2011-01-11 12:00:00,1378.58,1378.29,1,-29,9059,Exit After X Bars,,None,None,None,None
7_240906003_B,184,XAUUSD,Buy,2011-01-18 08:00:00,2011-01-18 12:00:00,1369.95,1370.18,1,23,9082,Exit After X Bars,,None,None,None,None
12_240906003_B,184,XAUUSD,Buy,2011-01-26 20:00:00,2011-01-27 00:00:00,1334.93,1345.98,1,1105,10187,Exit After X Bars,,None,None,None,None
14_240906003_B,184,XAUUSD,Buy,2011-01-28 16:00:00,2011-01-28 20:00:00,1340.6,1343.01,1,241,10428,Exit After X Bars,,None,None,None,None
15_240906003_B,184,XAUUSD,Buy,2011-02-03 16:00:00,2011-02-03 20:00:00,1339.29,1353.88,1,1459,11887,Exit After X Bars,,None,None,None,None
16_240906003_B,184,XAUUSD,Buy,2011-02-11 12:00:00,2011-02-11 16:00:00,1366.75,1365.53,1,-122,11765,Exit After X Bars,,None,None,None,None
17_240906003_B,184,XAUUSD,Buy,2011-02-15 08:00:00,2011-02-15 12:00:00,1368.2,1371.67,1,347,12112,Exit After X Bars,,None,None,None,None
19_240906003_B,184,XAUUSD,Buy,2011-02-23 16:00:00,2011-02-23 20:00:00,1406.2,1415.25,1,905,13017,Exit After X Bars,,None,None,None,None
21_240906003_B,184,XAUUSD,Buy,2011-03-01 12:00:00,2011-03-01 16:00:00,1415.59,1419.47,1,388,13405,Exit After X Bars,,None,None,None,None
23_240906003_B,184,XAUUSD,Buy,2011-03-04 16:00:00,2011-03-04 20:00:00,1431.77,1427.88,1,-389,13016,Exit After X Bars,,None,None,None,None
30_240906003_B,184,XAUUSD,Buy,2011-03-18 00:00:00,2011-03-18 04:00:00,1405.89,1406.99,1,110,13126,Exit After X Bars,,None,None,None,None
33_240906003_B,184,XAUUSD,Buy,2011-03-29 16:00:00,2011-03-29 20:00:00,1423.08,1416.52,1,-656,12470,Exit After X Bars,,None,None,None,None
34_240906003_B,184,XAUUSD,Buy,2011-03-30 12:00:00,2011-03-30 16:00:00,1423.12,1428.01,1,489,12959,Exit After X Bars,,None,None,None,None
38_240906003_B,184,XAUUSD,Buy,2011-04-14 16:00:00,2011-04-14 20:00:00,1461.83,1471.83,1,1000,13959,Exit After X Bars,,None,None,None,None
39_240906003_B,184,XAUUSD,Buy,2011-04-25 20:00:00,2011-04-26 00:00:00,1508.79,1506.77,1,-202,13757,Exit After X Bars,,None,None,None,None
41_240906003_B,184,XAUUSD,Buy,2011-04-27 16:00:00,2011-04-27 20:00:00,1509.78,1512.16,1,238,13995,Exit After X Bars,,None,None,None,None
50_240906003_B,184,XAUUSD,Buy,2011-05-20 08:00:00,2011-05-20 12:00:00,1499.63,1502.02,1,239,14234,Exit After X Bars,,None,None,None,None
52_240906003_B,184,XAUUSD,Buy,2011-06-01 16:00:00,2011-06-01 20:00:00,1540.54,1545.4,1,486,14720,Exit After X Bars,,None,None,None,None
54_240906003_B,184,XAUUSD,Buy,2011-06-03 16:00:00,2011-06-03 20:00:00,1544.22,1541.86,1,-236,14484,Exit After X Bars,,None,None,None,None
57_240906003_B,184,XAUUSD,Buy,2011-06-09 16:00:00,2011-06-09 20:00:00,1542.91,1544.6,1,169,14653,Exit After X Bars,,None,None,None,None
61_240906003_B,184,XAUUSD,Buy,2011-06-15 16:00:00,2011-06-15 20:00:00,1527.17,1524.58,1,-259,14394,Exit After X Bars,,None,None,None,None
63_240906003_B,184,XAUUSD,Buy,2011-06-17 16:00:00,2011-06-17 20:00:00,1532.77,1534.88,1,211,14605,Exit After X Bars,,None,None,None,None
67_240906003_B,184,XAUUSD,Buy,2011-06-28 12:00:00,2011-06-28 16:00:00,1503.09,1500.35,1,-274,14331,Exit After X Bars,,None,None,None,None
71_240906003_B,184,XAUUSD,Buy,2011-07-21 12:00:00,2011-07-21 16:00:00,1601.83,1597.53,1,-430,13901,Exit After X Bars,,None,None,None,None
72_240906003_B,184,XAUUSD,Buy,2011-07-22 12:00:00,2011-07-22 16:00:00,1601.69,1602.23,1,54,13955,Exit After X Bars,,None,None,None,None
73_240906003_B,184,XAUUSD,Buy,2011-07-27 00:00:00,2011-07-27 04:00:00,1621.32,1622.23,1,91,14046,Exit After X Bars,,None,None,None,None
75_240906003_B,184,XAUUSD,Buy,2011-07-29 12:00:00,2011-07-29 16:00:00,1619.79,1623.19,1,340,14386,Exit After X Bars,,None,None,None,None
77_240906003_B,184,XAUUSD,Buy,2011-08-02 12:00:00,2011-08-02 16:00:00,1631.74,1637.39,1,565,14951,Exit After X Bars,,None,None,None,None
80_240906003_B,184,XAUUSD,Buy,2011-08-15 20:00:00,2011-08-16 00:00:00,1763.54,1765.36,1,182,15133,Exit After X Bars,,None,None,None,None
81_240906003_B,184,XAUUSD,Buy,2011-08-17 20:00:00,2011-08-18 00:00:00,1786.76,1791.05,1,429,15562,Exit After X Bars,,None,None,None,None
85_240906003_B,184,XAUUSD,Buy,2011-08-30 12:00:00,2011-08-30 16:00:00,1822.12,1825.21,1,309,15871,Exit After X Bars,,None,None,None,None
86_240906003_B,184,XAUUSD,Buy,2011-09-02 08:00:00,2011-09-02 12:00:00,1839.45,1849.95,1,1050,16921,Exit After X Bars,,None,None,None,None
88_240906003_B,184,XAUUSD,Buy,2011-09-08 12:00:00,2011-09-08 16:00:00,1846.35,1858.15,1,1180,18101,Exit After X Bars,,None,None,None,None
94_240906003_B,184,XAUUSD,Buy,2011-09-16 16:00:00,2011-09-16 20:00:00,1815.27,1813.72,1,-155,17946,Exit After X Bars,,None,None,None,None
105_240906003_B,184,XAUUSD,Buy,2011-10-21 12:00:00,2011-10-21 16:00:00,1630.14,1642.71,1,1257,19203,Exit After X Bars,,None,None,None,None
107_240906003_B,184,XAUUSD,Buy,2011-11-02 04:00:00,2011-11-02 08:00:00,1727.35,1721.86,1,-549,18654,Exit After X Bars,,None,None,None,None
108_240906003_B,184,XAUUSD,Buy,2011-11-03 12:00:00,2011-11-03 16:00:00,1743.79,1761.62,1,1783,20437,Exit After X Bars,,None,None,None,None
111_240906003_B,184,XAUUSD,Buy,2011-11-11 16:00:00,2011-11-11 20:00:00,1775.02,1786.78,1,1176,21613,Exit After X Bars,,None,None,None,None
124_240906003_B,184,XAUUSD,Buy,2011-12-07 12:00:00,2011-12-07 16:00:00,1732.74,1733.37,1,63,21676,Exit After X Bars,,None,None,None,None
130_240906003_B,184,XAUUSD,Buy,2011-12-16 16:00:00,2011-12-16 20:00:00,1593.36,1593.08,1,-28,21648,Exit After X Bars,,None,None,None,None
131_240906003_B,184,XAUUSD,Buy,2011-12-19 12:00:00,2011-12-19 16:00:00,1600.55,1604.55,1,400,22048,Exit After X Bars,,None,None,None,None
135_240906003_B,184,XAUUSD,Buy,2012-01-16 12:00:00,2012-01-16 16:00:00,1644.17,1642.75,1,-142,21906,Exit After X Bars,,None,None,None,None
136_240906003_B,184,XAUUSD,Buy,2012-01-19 08:00:00,2012-01-19 12:00:00,1666.49,1665.42,1,-107,21799,Exit After X Bars,,None,None,None,None
137_240906003_B,184,XAUUSD,Buy,2012-01-20 16:00:00,2012-01-20 20:00:00,1665.5,1663.26,1,-224,21575,Exit After X Bars,,None,None,None,None
139_240906003_B,184,XAUUSD,Buy,2012-01-25 16:00:00,2012-01-25 20:00:00,1670.71,1689.7,1,1899,23474,Exit After X Bars,,None,None,None,None
140_240906003_B,184,XAUUSD,Buy,2012-02-02 16:00:00,2012-02-02 20:00:00,1751.63,1755.07,1,344,23818,Exit After X Bars,,None,None,None,None
143_240906003_B,184,XAUUSD,Buy,2012-02-07 16:00:00,2012-02-07 20:00:00,1724.89,1746.27,1,2138,25956,Exit After X Bars,,None,None,None,None
145_240906003_B,184,XAUUSD,Buy,2012-02-09 16:00:00,2012-02-09 20:00:00,1748.33,1739.26,1,-907,25049,Exit After X Bars,,None,None,None,None
147_240906003_B,184,XAUUSD,Buy,2012-02-13 16:00:00,2012-02-13 20:00:00,1724.15,1723.02,1,-113,24936,Exit After X Bars,,None,None,None,None
149_240906003_B,184,XAUUSD,Buy,2012-02-15 12:00:00,2012-02-15 16:00:00,1727.58,1730.85,1,327,25263,Exit After X Bars,,None,None,None,None
152_240906003_B,184,XAUUSD,Buy,2012-02-28 12:00:00,2012-02-28 16:00:00,1779.17,1780.06,1,89,25352,Exit After X Bars,,None,None,None,None
158_240906003_B,184,XAUUSD,Buy,2012-03-08 08:00:00,2012-03-08 12:00:00,1692.7,1701.02,1,832,26184,Exit After X Bars,,None,None,None,None
164_240906003_B,184,XAUUSD,Buy,2012-03-23 16:00:00,2012-03-23 20:00:00,1661.66,1662.57,1,91,26275,Exit After X Bars,,None,None,None,None
166_240906003_B,184,XAUUSD,Buy,2012-03-30 12:00:00,2012-03-30 16:00:00,1663.64,1665.58,1,194,26469,Exit After X Bars,,None,None,None,None
169_240906003_B,184,XAUUSD,Buy,2012-04-06 12:00:00,2012-04-06 16:00:00,1633.25,1641.71,1,846,27315,Exit After X Bars,,None,None,None,None
173_240906003_B,184,XAUUSD,Buy,2012-04-19 16:00:00,2012-04-19 20:00:00,1648.7,1639.67,1,-903,26412,Exit After X Bars,,None,None,None,None
176_240906003_B,184,XAUUSD,Buy,2012-04-24 12:00:00,2012-04-24 16:00:00,1639.05,1642.25,1,320,26732,Exit After X Bars,,None,None,None,None
177_240906003_B,184,XAUUSD,Buy,2012-05-01 00:00:00,2012-05-01 04:00:00,1667.25,1665.58,1,-167,26565,Exit After X Bars,,None,None,None,None
184_240906003_B,184,XAUUSD,Buy,2012-05-10 16:00:00,2012-05-10 20:00:00,1595.71,1595.78,1,7,26572,Exit After X Bars,,None,None,None,None
188_240906003_B,184,XAUUSD,Buy,2012-05-17 16:00:00,2012-05-17 20:00:00,1563.73,1576.13,1,1240,27812,Exit After X Bars,,None,None,None,None
190_240906003_B,184,XAUUSD,Buy,2012-05-24 12:00:00,2012-05-24 16:00:00,1564.37,1575.66,1,1129,28941,Exit After X Bars,,None,None,None,None
193_240906003_B,184,XAUUSD,Buy,2012-06-01 12:00:00,2012-06-01 16:00:00,1573.19,1581.44,1,825,29766,Exit After X Bars,,None,None,None,None
195_240906003_B,184,XAUUSD,Buy,2012-06-11 12:00:00,2012-06-11 16:00:00,1594.8,1593.62,1,-118,29648,Exit After X Bars,,None,None,None,None
196_240906003_B,184,XAUUSD,Buy,2012-06-12 16:00:00,2012-06-12 20:00:00,1600.88,1611.94,1,1106,30754,Exit After X Bars,,None,None,None,None
197_240906003_B,184,XAUUSD,Buy,2012-06-19 08:00:00,2012-06-19 12:00:00,1632.26,1629.85,1,-241,30513,Exit After X Bars,,None,None,None,None
201_240906003_B,184,XAUUSD,Buy,2012-06-25 16:00:00,2012-06-25 20:00:00,1573.16,1583.29,1,1013,31526,Exit After X Bars,,None,None,None,None
205_240906003_B,184,XAUUSD,Buy,2012-06-29 12:00:00,2012-06-29 16:00:00,1573.33,1597.36,1,2403,33929,Exit After X Bars,,None,None,None,None
209_240906003_B,184,XAUUSD,Buy,2012-07-10 12:00:00,2012-07-10 16:00:00,1592.69,1600.83,1,814,34743,Exit After X Bars,,None,None,None,None
213_240906003_B,184,XAUUSD,Buy,2012-07-19 12:00:00,2012-07-19 16:00:00,1583.01,1584.15,1,114,34857,Exit After X Bars,,None,None,None,None
216_240906003_B,184,XAUUSD,Buy,2012-07-24 16:00:00,2012-07-24 20:00:00,1580.25,1575.79,1,-446,34411,Exit After X Bars,,None,None,None,None
220_240906003_B,184,XAUUSD,Buy,2012-08-09 20:00:00,2012-08-10 00:00:00,1618.31,1616.66,1,-165,34246,Exit After X Bars,,None,None,None,None
221_240906003_B,184,XAUUSD,Buy,2012-08-10 16:00:00,2012-08-10 20:00:00,1618.24,1621.52,1,328,34574,Exit After X Bars,,None,None,None,None
224_240906003_B,184,XAUUSD,Buy,2012-08-16 12:00:00,2012-08-16 16:00:00,1606.38,1607.65,1,127,34701,Exit After X Bars,,None,None,None,None
228_240906003_B,184,XAUUSD,Buy,2012-08-31 16:00:00,2012-08-31 20:00:00,1663.87,1681.56,1,1769,36470,Exit After X Bars,,None,None,None,None
229_240906003_B,184,XAUUSD,Buy,2012-09-06 08:00:00,2012-09-06 12:00:00,1698.69,1709.11,1,1042,37512,Exit After X Bars,,None,None,None,None
230_240906003_B,184,XAUUSD,Buy,2012-09-07 12:00:00,2012-09-07 16:00:00,1713.5,1724.79,1,1129,38641,Exit After X Bars,,None,None,None,None
231_240906003_B,184,XAUUSD,Buy,2012-09-13 16:00:00,2012-09-13 20:00:00,1745.34,1752.67,1,733,39374,Exit After X Bars,,None,None,None,None
232_240906003_B,184,XAUUSD,Buy,2012-09-18 16:00:00,2012-09-18 20:00:00,1772.97,1766.65,1,-632,38742,Exit After X Bars,,None,None,None,None
233_240906003_B,184,XAUUSD,Buy,2012-09-19 16:00:00,2012-09-19 20:00:00,1773.05,1769.59,1,-346,38396,Exit After X Bars,,None,None,None,None
238_240906003_B,184,XAUUSD,Buy,2012-09-27 12:00:00,2012-09-27 16:00:00,1765.42,1764.21,1,-121,38275,Exit After X Bars,,None,None,None,None
239_240906003_B,184,XAUUSD,Buy,2012-10-01 12:00:00,2012-10-01 16:00:00,1783.06,1784.74,1,168,38443,Exit After X Bars,,None,None,None,None
241_240906003_B,184,XAUUSD,Buy,2012-10-04 08:00:00,2012-10-04 12:00:00,1784.2,1785.03,1,83,38526,Exit After X Bars,,None,None,None,None
244_240906003_B,184,XAUUSD,Buy,2012-10-09 12:00:00,2012-10-09 16:00:00,1777.96,1774.13,1,-383,38143,Exit After X Bars,,None,None,None,None
246_240906003_B,184,XAUUSD,Buy,2012-10-11 16:00:00,2012-10-11 20:00:00,1768.09,1769.56,1,147,38290,Exit After X Bars,,None,None,None,None
249_240906003_B,184,XAUUSD,Buy,2012-10-17 00:00:00,2012-10-17 04:00:00,1748.65,1750.45,1,180,38470,Exit After X Bars,,None,None,None,None
255_240906003_B,184,XAUUSD,Buy,2012-10-26 16:00:00,2012-10-26 20:00:00,1717.77,1712.97,1,-480,37990,Exit After X Bars,,None,None,None,None
258_240906003_B,184,XAUUSD,Buy,2012-11-14 16:00:00,2012-11-14 20:00:00,1732.92,1729.65,1,-327,37663,Exit After X Bars,,None,None,None,None
261_240906003_B,184,XAUUSD,Buy,2012-11-23 16:00:00,2012-11-23 20:00:00,1735.41,1750.79,1,1538,39201,Exit After X Bars,,None,None,None,None
264_240906003_B,184,XAUUSD,Buy,2012-11-30 12:00:00,2012-11-30 16:00:00,1728.28,1723.27,1,-501,38700,Exit After X Bars,,None,None,None,None
269_240906003_B,184,XAUUSD,Buy,2012-12-07 16:00:00,2012-12-07 20:00:00,1703.08,1701.75,1,-133,38567,Exit After X Bars,,None,None,None,None
272_240906003_B,184,XAUUSD,Buy,2012-12-17 16:00:00,2012-12-17 20:00:00,1699.06,1696.31,1,-275,38292,Exit After X Bars,,None,None,None,None
278_240906003_B,184,XAUUSD,Buy,2013-01-08 16:00:00,2013-01-08 20:00:00,1658.8,1659.3,1,50,38342,Exit After X Bars,,None,None,None,None
282_240906003_B,184,XAUUSD,Buy,2013-02-01 16:00:00,2013-02-01 20:00:00,1677.18,1671.47,1,-571,37771,Exit After X Bars,,None,None,None,None
283_240906003_B,184,XAUUSD,Buy,2013-02-05 12:00:00,2013-02-05 16:00:00,1681.96,1682.95,1,99,37870,Exit After X Bars,,None,None,None,None
288_240906003_B,184,XAUUSD,Buy,2013-02-13 12:00:00,2013-02-13 16:00:00,1653.27,1651.73,1,-154,37716,Exit After X Bars,,None,None,None,None
304_240906003_B,184,XAUUSD,Buy,2013-03-27 16:00:00,2013-03-27 20:00:00,1600.83,1605.55,1,472,38188,Exit After X Bars,,None,None,None,None
310_240906003_B,184,XAUUSD,Buy,2013-04-05 12:00:00,2013-04-05 16:00:00,1556.61,1568.42,1,1181,39369,Exit After X Bars,,None,None,None,None
316_240906003_B,184,XAUUSD,Buy,2013-04-18 12:00:00,2013-04-18 16:00:00,1394.24,1394.75,1,51,39420,Exit After X Bars,,None,None,None,None
318_240906003_B,184,XAUUSD,Buy,2013-05-02 16:00:00,2013-05-02 20:00:00,1471.84,1468.85,1,-299,39121,Exit After X Bars,,None,None,None,None
320_240906003_B,184,XAUUSD,Buy,2013-05-08 12:00:00,2013-05-08 16:00:00,1465.34,1466.24,1,90,39211,Exit After X Bars,,None,None,None,None
328_240906003_B,184,XAUUSD,Buy,2013-05-20 16:00:00,2013-05-20 20:00:00,1383.39,1384.75,1,136,39347,Exit After X Bars,,None,None,None,None
329_240906003_B,184,XAUUSD,Buy,2013-05-28 16:00:00,2013-05-28 20:00:00,1396.26,1386.04,1,-1022,38325,Exit After X Bars,,None,None,None,None
330_240906003_B,184,XAUUSD,Buy,2013-06-03 16:00:00,2013-06-03 20:00:00,1415.64,1412.84,1,-280,38045,Exit After X Bars,,None,None,None,None
332_240906003_B,184,XAUUSD,Buy,2013-06-05 16:00:00,2013-06-05 20:00:00,1406.6,1403.25,1,-335,37710,Exit After X Bars,,None,None,None,None
333_240906003_B,184,XAUUSD,Buy,2013-06-06 16:00:00,2013-06-06 20:00:00,1410.38,1416.45,1,607,38317,Exit After X Bars,,None,None,None,None
337_240906003_B,184,XAUUSD,Buy,2013-06-12 16:00:00,2013-06-12 20:00:00,1380.79,1390.86,1,1007,39324,Exit After X Bars,,None,None,None,None
349_240906003_B,184,XAUUSD,Buy,2013-07-09 04:00:00,2013-07-09 08:00:00,1242.79,1254.4,1,1161,40485,Exit After X Bars,,None,None,None,None
353_240906003_B,184,XAUUSD,Buy,2013-07-29 12:00:00,2013-07-29 16:00:00,1333.89,1328.71,1,-518,39967,Exit After X Bars,,None,None,None,None
354_240906003_B,184,XAUUSD,Buy,2013-07-31 04:00:00,2013-07-31 08:00:00,1338.01,1333.29,1,-472,39495,Exit After X Bars,,None,None,None,None
359_240906003_B,184,XAUUSD,Buy,2013-08-08 08:00:00,2013-08-08 12:00:00,1296.57,1289.08,1,-749,38746,Exit After X Bars,,None,None,None,None
360_240906003_B,184,XAUUSD,Buy,2013-08-14 20:00:00,2013-08-15 00:00:00,1336.15,1335.72,1,-43,38703,Exit After X Bars,,None,None,None,None
362_240906003_B,184,XAUUSD,Buy,2013-08-21 20:00:00,2013-08-22 00:00:00,1377.18,1366.09,1,-1109,37594,Exit After X Bars,,None,None,None,None
363_240906003_B,184,XAUUSD,Buy,2013-08-22 16:00:00,2013-08-22 20:00:00,1378.65,1371.75,1,-690,36904,Exit After X Bars,,None,None,None,None
364_240906003_B,184,XAUUSD,Buy,2013-08-23 16:00:00,2013-08-23 20:00:00,1381.36,1395.8,1,1444,38348,Exit After X Bars,,None,None,None,None
368_240906003_B,184,XAUUSD,Buy,2013-09-03 12:00:00,2013-09-03 16:00:00,1394.93,1398.01,1,308,38656,Exit After X Bars,,None,None,None,None
379_240906003_B,184,XAUUSD,Buy,2013-09-18 20:00:00,2013-09-19 00:00:00,1323.25,1362.63,1,3938,42594,Exit After X Bars,,None,None,None,None
381_240906003_B,184,XAUUSD,Buy,2013-09-25 08:00:00,2013-09-25 12:00:00,1329.9,1323.05,1,-685,41909,Exit After X Bars,,None,None,None,None
382_240906003_B,184,XAUUSD,Buy,2013-09-27 16:00:00,2013-09-27 20:00:00,1337.93,1337.6,1,-33,41876,Exit After X Bars,,None,None,None,None
386_240906003_B,184,XAUUSD,Buy,2013-10-04 12:00:00,2013-10-04 16:00:00,1323.6,1317.36,1,-624,41252,Exit After X Bars,,None,None,None,None
391_240906003_B,184,XAUUSD,Buy,2013-10-17 08:00:00,2013-10-17 12:00:00,1289.69,1305.41,1,1572,42824,Exit After X Bars,,None,None,None,None
393_240906003_B,184,XAUUSD,Buy,2013-10-30 12:00:00,2013-10-30 16:00:00,1352.61,1354.15,1,154,42978,Exit After X Bars,,None,None,None,None
398_240906003_B,184,XAUUSD,Buy,2013-11-06 12:00:00,2013-11-06 16:00:00,1319.66,1316.76,1,-290,42688,Exit After X Bars,,None,None,None,None
403_240906003_B,184,XAUUSD,Buy,2013-11-14 00:00:00,2013-11-14 04:00:00,1285.05,1282.24,1,-281,42407,Exit After X Bars,,None,None,None,None
408_240906003_B,184,XAUUSD,Buy,2013-11-25 20:00:00,2013-11-26 00:00:00,1248.7,1251.21,1,251,42658,Exit After X Bars,,None,None,None,None
411_240906003_B,184,XAUUSD,Buy,2013-12-04 12:00:00,2013-12-04 16:00:00,1225.91,1225.9,1,-1,42657,Exit After X Bars,,None,None,None,None
415_240906003_B,184,XAUUSD,Buy,2013-12-16 16:00:00,2013-12-16 20:00:00,1238.48,1246.12,1,764,43421,Exit After X Bars,,None,None,None,None
417_240906003_B,184,XAUUSD,Buy,2013-12-18 20:00:00,2013-12-19 00:00:00,1242.9,1218.09,1,-2481,40940,Exit After X Bars,,None,None,None,None
421_240906003_B,184,XAUUSD,Buy,2013-12-24 16:00:00,2013-12-24 20:00:00,1203.69,1203.84,1,15,40955,Exit After X Bars,,None,None,None,None
422_240906003_B,184,XAUUSD,Buy,2013-12-31 16:00:00,2013-12-31 20:00:00,1208.25,1204.8,1,-345,40610,Exit After X Bars,,None,None,None,None
424_240906003_B,184,XAUUSD,Buy,2014-01-10 04:00:00,2014-01-10 08:00:00,1231.71,1236.55,1,484,41094,Exit After X Bars,,None,None,None,None
426_240906003_B,184,XAUUSD,Buy,2014-01-16 16:00:00,2014-01-16 20:00:00,1242.32,1241.14,1,-118,40976,Exit After X Bars,,None,None,None,None
427_240906003_B,184,XAUUSD,Buy,2014-01-17 12:00:00,2014-01-17 16:00:00,1245.02,1248.12,1,310,41286,Exit After X Bars,,None,None,None,None
432_240906003_B,184,XAUUSD,Buy,2014-01-29 12:00:00,2014-01-29 16:00:00,1261.31,1266.85,1,554,41840,Exit After X Bars,,None,None,None,None
435_240906003_B,184,XAUUSD,Buy,2014-02-03 16:00:00,2014-02-03 20:00:00,1254.79,1259.36,1,457,42297,Exit After X Bars,,None,None,None,None
436_240906003_B,184,XAUUSD,Buy,2014-02-05 12:00:00,2014-02-05 16:00:00,1266.13,1265.41,1,-72,42225,Exit After X Bars,,None,None,None,None
439_240906003_B,184,XAUUSD,Buy,2014-02-20 20:00:00,2014-02-21 00:00:00,1321.72,1322.82,1,110,42335,Exit After X Bars,,None,None,None,None
440_240906003_B,184,XAUUSD,Buy,2014-02-21 12:00:00,2014-02-21 16:00:00,1324.69,1321.95,1,-274,42061,Exit After X Bars,,None,None,None,None
445_240906003_B,184,XAUUSD,Buy,2014-03-05 16:00:00,2014-03-05 20:00:00,1340.53,1341.02,1,49,42110,Exit After X Bars,,None,None,None,None
446_240906003_B,184,XAUUSD,Buy,2014-03-06 16:00:00,2014-03-06 20:00:00,1341.7,1348.87,1,717,42827,Exit After X Bars,,None,None,None,None
459_240906003_B,184,XAUUSD,Buy,2014-04-02 12:00:00,2014-04-02 16:00:00,1287.5,1291.57,1,407,43234,Exit After X Bars,,None,None,None,None
466_240906003_B,184,XAUUSD,Buy,2014-04-24 16:00:00,2014-04-24 20:00:00,1288.8,1289.87,1,107,43341,Exit After X Bars,,None,None,None,None
470_240906003_B,184,XAUUSD,Buy,2014-05-02 16:00:00,2014-05-02 20:00:00,1288.67,1298.41,1,974,44315,Exit After X Bars,,None,None,None,None
474_240906003_B,184,XAUUSD,Buy,2014-05-12 12:00:00,2014-05-12 16:00:00,1294.25,1300.66,1,641,44956,Exit After X Bars,,None,None,None,None
475_240906003_B,184,XAUUSD,Buy,2014-05-14 12:00:00,2014-05-14 16:00:00,1303.73,1307.38,1,365,45321,Exit After X Bars,,None,None,None,None
487_240906003_B,184,XAUUSD,Buy,2014-06-05 12:00:00,2014-06-05 16:00:00,1250.52,1254.85,1,433,45754,Exit After X Bars,,None,None,None,None
489_240906003_B,184,XAUUSD,Buy,2014-06-18 12:00:00,2014-06-18 16:00:00,1272.24,1271.69,1,-55,45699,Exit After X Bars,,None,None,None,None
492_240906003_B,184,XAUUSD,Buy,2014-06-27 16:00:00,2014-06-27 20:00:00,1318.21,1318.3,1,9,45708,Exit After X Bars,,None,None,None,None
493_240906003_B,184,XAUUSD,Buy,2014-06-30 20:00:00,2014-07-01 00:00:00,1320.71,1327.15,1,644,46352,Exit After X Bars,,None,None,None,None
494_240906003_B,184,XAUUSD,Buy,2014-07-02 16:00:00,2014-07-02 20:00:00,1330.66,1329.4,1,-126,46226,Exit After X Bars,,None,None,None,None
498_240906003_B,184,XAUUSD,Buy,2014-07-08 12:00:00,2014-07-08 16:00:00,1319.74,1321.99,1,225,46451,Exit After X Bars,,None,None,None,None
502_240906003_B,184,XAUUSD,Buy,2014-07-17 12:00:00,2014-07-17 16:00:00,1303.59,1305.77,1,218,46669,Exit After X Bars,,None,None,None,None
507_240906003_B,184,XAUUSD,Buy,2014-07-25 20:00:00,2014-07-28 00:00:00,1301.12,1307.57,1,645,47314,End Of Friday,,None,None,None,None
517_240906003_B,184,XAUUSD,Buy,2014-08-26 04:00:00,2014-08-26 08:00:00,1282.72,1282.24,1,-48,47266,Exit After X Bars,,None,None,None,None
527_240906003_B,184,XAUUSD,Buy,2014-09-16 08:00:00,2014-09-16 12:00:00,1238.88,1239.76,1,88,47354,Exit After X Bars,,None,None,None,None
530_240906003_B,184,XAUUSD,Buy,2014-09-23 08:00:00,2014-09-23 12:00:00,1225.52,1223.54,1,-198,47156,Exit After X Bars,,None,None,None,None
531_240906003_B,184,XAUUSD,Buy,2014-09-26 04:00:00,2014-09-26 08:00:00,1225.84,1222.61,1,-323,46833,Exit After X Bars,,None,None,None,None
533_240906003_B,184,XAUUSD,Buy,2014-10-02 04:00:00,2014-10-02 08:00:00,1219.98,1219.5,1,-48,46785,Exit After X Bars,,None,None,None,None
535_240906003_B,184,XAUUSD,Buy,2014-10-07 08:00:00,2014-10-07 12:00:00,1209.22,1208.79,1,-43,46742,Exit After X Bars,,None,None,None,None
536_240906003_B,184,XAUUSD,Buy,2014-10-15 12:00:00,2014-10-15 16:00:00,1238.04,1236.12,1,-192,46550,Exit After X Bars,,None,None,None,None
541_240906003_B,184,XAUUSD,Buy,2014-10-28 12:00:00,2014-10-28 16:00:00,1231.69,1232.63,1,94,46644,Exit After X Bars,,None,None,None,None
546_240906003_B,184,XAUUSD,Buy,2014-11-04 12:00:00,2014-11-04 16:00:00,1173.46,1169.24,1,-422,46222,Exit After X Bars,,None,None,None,None
549_240906003_B,184,XAUUSD,Buy,2014-11-07 12:00:00,2014-11-07 16:00:00,1149.05,1148.58,1,-47,46175,Exit After X Bars,,None,None,None,None
550_240906003_B,184,XAUUSD,Buy,2014-11-21 12:00:00,2014-11-21 16:00:00,1201.92,1202.94,1,102,46277,Exit After X Bars,,None,None,None,None
551_240906003_B,184,XAUUSD,Buy,2014-11-25 20:00:00,2014-11-26 00:00:00,1200.09,1200.55,1,46,46323,Exit After X Bars,,None,None,None,None
555_240906003_B,184,XAUUSD,Buy,2014-12-01 16:00:00,2014-12-01 20:00:00,1189.09,1215.34,1,2625,48948,Exit After X Bars,,None,None,None,None
557_240906003_B,184,XAUUSD,Buy,2014-12-08 20:00:00,2014-12-09 00:00:00,1207.34,1202.88,1,-446,48502,Exit After X Bars,,None,None,None,None
561_240906003_B,184,XAUUSD,Buy,2014-12-16 12:00:00,2014-12-16 16:00:00,1216.94,1211.4,1,-554,47948,Exit After X Bars,,None,None,None,None
563_240906003_B,184,XAUUSD,Buy,2014-12-18 12:00:00,2014-12-18 16:00:00,1202.74,1202.87,1,13,47961,Exit After X Bars,,None,None,None,None
567_240906003_B,184,XAUUSD,Buy,2014-12-26 00:00:00,2014-12-26 04:00:00,1181.15,1183.63,1,248,48209,Exit After X Bars,,None,None,None,None
569_240906003_B,184,XAUUSD,Buy,2015-01-09 12:00:00,2015-01-09 16:00:00,1218.11,1214.26,1,-385,47824,Exit After X Bars,,None,None,None,None
570_240906003_B,184,XAUUSD,Buy,2015-01-14 16:00:00,2015-01-14 20:00:00,1242.66,1238.64,1,-402,47422,Exit After X Bars,,None,None,None,None
571_240906003_B,184,XAUUSD,Buy,2015-01-15 12:00:00,2015-01-15 16:00:00,1244.1,1254.5,1,1040,48462,Exit After X Bars,,None,None,None,None
572_240906003_B,184,XAUUSD,Buy,2015-01-22 16:00:00,2015-01-22 20:00:00,1304.87,1300.98,1,-389,48073,Exit After X Bars,,None,None,None,None
575_240906003_B,184,XAUUSD,Buy,2015-01-27 12:00:00,2015-01-27 16:00:00,1287.09,1287.31,1,22,48095,Exit After X Bars,,None,None,None,None
578_240906003_B,184,XAUUSD,Buy,2015-01-30 16:00:00,2015-01-30 20:00:00,1277.03,1275.44,1,-159,47936,Exit After X Bars,,None,None,None,None
579_240906003_B,184,XAUUSD,Buy,2015-02-03 08:00:00,2015-02-03 12:00:00,1284.48,1280.88,1,-360,47576,Exit After X Bars,,None,None,None,None
591_240906003_B,184,XAUUSD,Buy,2015-02-25 00:00:00,2015-02-25 04:00:00,1210.05,1209.99,1,-6,47570,Exit After X Bars,,None,None,None,None
593_240906003_B,184,XAUUSD,Buy,2015-03-05 16:00:00,2015-03-05 20:00:00,1207.12,1199.08,1,-804,46766,Exit After X Bars,,None,None,None,None
601_240906003_B,184,XAUUSD,Buy,2015-04-01 12:00:00,2015-04-01 16:00:00,1190.5,1193.54,1,304,47070,Exit After X Bars,,None,None,None,None
605_240906003_B,184,XAUUSD,Buy,2015-04-10 12:00:00,2015-04-10 16:00:00,1202.48,1204.96,1,248,47318,Exit After X Bars,,None,None,None,None
608_240906003_B,184,XAUUSD,Buy,2015-04-15 20:00:00,2015-04-16 00:00:00,1198.88,1202.18,1,330,47648,Exit After X Bars,,None,None,None,None
611_240906003_B,184,XAUUSD,Buy,2015-04-22 08:00:00,2015-04-22 12:00:00,1204.64,1200.73,1,-391,47257,Exit After X Bars,,None,None,None,None
614_240906003_B,184,XAUUSD,Buy,2015-04-27 16:00:00,2015-04-27 20:00:00,1192.65,1206.76,1,1411,48668,Exit After X Bars,,None,None,None,None
617_240906003_B,184,XAUUSD,Buy,2015-05-05 12:00:00,2015-05-05 16:00:00,1192.69,1197.78,1,509,49177,Exit After X Bars,,None,None,None,None
619_240906003_B,184,XAUUSD,Buy,2015-05-08 12:00:00,2015-05-08 16:00:00,1188.36,1189.59,1,123,49300,Exit After X Bars,,None,None,None,None
621_240906003_B,184,XAUUSD,Buy,2015-05-12 12:00:00,2015-05-12 16:00:00,1191.65,1195.14,1,349,49649,Exit After X Bars,,None,None,None,None
624_240906003_B,184,XAUUSD,Buy,2015-05-22 08:00:00,2015-05-22 12:00:00,1213.19,1212.43,1,-76,49573,Exit After X Bars,,None,None,None,None
628_240906003_B,184,XAUUSD,Buy,2015-05-28 16:00:00,2015-05-28 20:00:00,1188.86,1188.44,1,-42,49531,Exit After X Bars,,None,None,None,None
629_240906003_B,184,XAUUSD,Buy,2015-05-29 12:00:00,2015-05-29 16:00:00,1190.72,1189.8,1,-92,49439,Exit After X Bars,,None,None,None,None
630_240906003_B,184,XAUUSD,Buy,2015-06-01 16:00:00,2015-06-01 20:00:00,1193.71,1191.04,1,-267,49172,Exit After X Bars,,None,None,None,None
634_240906003_B,184,XAUUSD,Buy,2015-06-09 04:00:00,2015-06-09 08:00:00,1176.46,1177.58,1,112,49284,Exit After X Bars,,None,None,None,None
636_240906003_B,184,XAUUSD,Buy,2015-06-15 16:00:00,2015-06-15 20:00:00,1183.41,1188.24,1,483,49767,Exit After X Bars,,None,None,None,None
637_240906003_B,184,XAUUSD,Buy,2015-06-17 20:00:00,2015-06-18 00:00:00,1184.68,1184.86,1,18,49785,Exit After X Bars,,None,None,None,None
642_240906003_B,184,XAUUSD,Buy,2015-06-29 00:00:00,2015-06-29 04:00:00,1184.23,1185.47,1,123.9,49908.9,Exit After X Bars,,None,None,None,None
646_240906003_B,184,XAUUSD,Buy,2015-07-03 12:00:00,2015-07-03 16:00:00,1169.23,1169.48,1,25,49933.9,Exit After X Bars,,None,None,None,None
647_240906003_B,184,XAUUSD,Buy,2015-07-06 16:00:00,2015-07-06 20:00:00,1169.74,1172.13,1,239,50172.9,Exit After X Bars,,None,None,None,None
650_240906003_B,184,XAUUSD,Buy,2015-07-09 12:00:00,2015-07-09 16:00:00,1164.51,1164.53,1,2,50174.9,Exit After X Bars,,None,None,None,None
652_240906003_B,184,XAUUSD,Buy,2015-07-14 16:00:00,2015-07-14 20:00:00,1159.34,1155.13,1,-421,49753.9,Exit After X Bars,,None,None,None,None
662_240906003_B,184,XAUUSD,Buy,2015-07-31 16:00:00,2015-07-31 20:00:00,1095.05,1094.21,1,-84,49669.9,Exit After X Bars,,None,None,None,None
663_240906003_B,184,XAUUSD,Buy,2015-08-19 08:00:00,2015-08-19 12:00:00,1122.61,1122.46,1,-15,49654.9,Exit After X Bars,,None,None,None,None
667_240906003_B,184,XAUUSD,Buy,2015-08-28 12:00:00,2015-08-28 16:00:00,1129.09,1129.06,1,-3,49651.9,Exit After X Bars,,None,None,None,None
668_240906003_B,184,XAUUSD,Buy,2015-09-01 04:00:00,2015-09-01 08:00:00,1140.6,1142.28,1,168,49819.9,Exit After X Bars,,None,None,None,None
673_240906003_B,184,XAUUSD,Buy,2015-09-08 12:00:00,2015-09-08 16:00:00,1123.06,1122.09,1,-97,49722.9,Exit After X Bars,,None,None,None,None
677_240906003_B,184,XAUUSD,Buy,2015-09-14 12:00:00,2015-09-14 16:00:00,1108.3,1105.19,1,-311,49411.9,Exit After X Bars,,None,None,None,None
679_240906003_B,184,XAUUSD,Buy,2015-09-16 12:00:00,2015-09-16 16:00:00,1108.88,1114.03,1,515,49926.9,Exit After X Bars,,None,None,None,None
681_240906003_B,184,XAUUSD,Buy,2015-09-24 04:00:00,2015-09-24 08:00:00,1134.92,1134.21,1,-71,49855.9,Exit After X Bars,,None,None,None,None
686_240906003_B,184,XAUUSD,Buy,2015-10-02 12:00:00,2015-10-02 16:00:00,1118.95,1131.89,1,1294,51149.9,Exit After X Bars,,None,None,None,None
687_240906003_B,184,XAUUSD,Buy,2015-10-09 08:00:00,2015-10-09 12:00:00,1153.49,1153.75,1,26,51175.9,Exit After X Bars,,None,None,None,None
688_240906003_B,184,XAUUSD,Buy,2015-10-14 00:00:00,2015-10-14 04:00:00,1168.82,1168.66,1,-16,51159.9,Exit After X Bars,,None,None,None,None
691_240906003_B,184,XAUUSD,Buy,2015-10-20 16:00:00,2015-10-20 20:00:00,1177.88,1176.93,1,-95,51064.9,Exit After X Bars,,None,None,None,None
695_240906003_B,184,XAUUSD,Buy,2015-10-28 08:00:00,2015-10-28 12:00:00,1169.5,1172.1,1,260,51324.9,Exit After X Bars,,None,None,None,None
706_240906003_B,184,XAUUSD,Buy,2015-11-19 16:00:00,2015-11-19 20:00:00,1083.15,1080.32,1,-283,51041.9,Exit After X Bars,,None,None,None,None
709_240906003_B,184,XAUUSD,Buy,2015-11-30 20:00:00,2015-12-01 00:00:00,1066.79,1064.8,1,-199,50842.9,Exit After X Bars,,None,None,None,None
711_240906003_B,184,XAUUSD,Buy,2015-12-04 12:00:00,2015-12-04 16:00:00,1067.61,1068.32,1,71,50913.9,Exit After X Bars,,None,None,None,None
712_240906003_B,184,XAUUSD,Buy,2015-12-11 16:00:00,2015-12-11 20:00:00,1075.46,1075.16,1,-30,50883.9,Exit After X Bars,,None,None,None,None
715_240906003_B,184,XAUUSD,Buy,2015-12-16 12:00:00,2015-12-16 16:00:00,1068.56,1072.87,1,431,51314.9,Exit After X Bars,,None,None,None,None
717_240906003_B,184,XAUUSD,Buy,2015-12-18 16:00:00,2015-12-18 20:00:00,1068.16,1065.61,1,-255,51059.9,Exit After X Bars,,None,None,None,None
724_240906003_B,184,XAUUSD,Buy,2016-01-13 20:00:00,2016-01-14 00:00:00,1095.26,1093.36,1,-190,50869.9,Exit After X Bars,,None,None,None,None
726_240906003_B,184,XAUUSD,Buy,2016-01-15 12:00:00,2016-01-15 16:00:00,1092.92,1093.84,1,92,50961.9,Exit After X Bars,,None,None,None,None
728_240906003_B,184,XAUUSD,Buy,2016-01-20 00:00:00,2016-01-20 04:00:00,1091.96,1091.52,1,-44,50917.9,Exit After X Bars,,None,None,None,None
729_240906003_B,184,XAUUSD,Buy,2016-01-22 16:00:00,2016-01-22 20:00:00,1102.57,1097.71,1,-486,50431.9,Exit After X Bars,,None,None,None,None
731_240906003_B,184,XAUUSD,Buy,2016-02-03 16:00:00,2016-02-03 20:00:00,1130.77,1139.41,1,864,51295.9,Exit After X Bars,,None,None,None,None
732_240906003_B,184,XAUUSD,Buy,2016-02-11 00:00:00,2016-02-11 04:00:00,1198.5,1207.95,1,945,52240.9,Exit After X Bars,,None,None,None,None
734_240906003_B,184,XAUUSD,Buy,2016-02-16 12:00:00,2016-02-16 16:00:00,1213.52,1214.62,1,110,52350.9,Exit After X Bars,,None,None,None,None
736_240906003_B,184,XAUUSD,Buy,2016-02-18 16:00:00,2016-02-18 20:00:00,1213.26,1227.06,1,1380,53730.9,Exit After X Bars,,None,None,None,None
741_240906003_B,184,XAUUSD,Buy,2016-02-29 20:00:00,2016-03-01 00:00:00,1237.92,1237.53,1,-39,53691.9,Exit After X Bars,,None,None,None,None
743_240906003_B,184,XAUUSD,Buy,2016-03-03 12:00:00,2016-03-03 16:00:00,1243.86,1241.71,1,-215,53476.9,Exit After X Bars,,None,None,None,None
745_240906003_B,184,XAUUSD,Buy,2016-03-10 16:00:00,2016-03-10 20:00:00,1260.1,1272.46,1,1236,54712.9,Exit After X Bars,,None,None,None,None
749_240906003_B,184,XAUUSD,Buy,2016-03-16 20:00:00,2016-03-17 00:00:00,1237.86,1260.82,1,2296,57008.9,Exit After X Bars,,None,None,None,None
751_240906003_B,184,XAUUSD,Buy,2016-03-22 08:00:00,2016-03-22 12:00:00,1258.44,1252.25,1,-619,56389.9,Exit After X Bars,,None,None,None,None
755_240906003_B,184,XAUUSD,Buy,2016-03-29 16:00:00,2016-03-29 20:00:00,1222.86,1235.67,1,1281,57670.9,Exit After X Bars,,None,None,None,None
757_240906003_B,184,XAUUSD,Buy,2016-04-05 08:00:00,2016-04-05 12:00:00,1233.76,1232.66,1,-110,57560.9,Exit After X Bars,,None,None,None,None
758_240906003_B,184,XAUUSD,Buy,2016-04-07 12:00:00,2016-04-07 16:00:00,1236.59,1239.3,1,271,57831.9,Exit After X Bars,,None,None,None,None
762_240906003_B,184,XAUUSD,Buy,2016-04-18 12:00:00,2016-04-18 16:00:00,1235.71,1239.54,1,383,58214.9,Exit After X Bars,,None,None,None,None
765_240906003_B,184,XAUUSD,Buy,2016-04-26 16:00:00,2016-04-26 20:00:00,1242.12,1240.55,1,-157,58057.9,Exit After X Bars,,None,None,None,None
768_240906003_B,184,XAUUSD,Buy,2016-05-06 12:00:00,2016-05-06 16:00:00,1286.16,1291.99,1,583,58640.9,Exit After X Bars,,None,None,None,None
771_240906003_B,184,XAUUSD,Buy,2016-05-12 16:00:00,2016-05-12 20:00:00,1278.86,1271.05,1,-781,57859.9,Exit After X Bars,,None,None,None,None
776_240906003_B,184,XAUUSD,Buy,2016-05-20 16:00:00,2016-05-20 20:00:00,1258.97,1250.82,1,-815,57044.9,Exit After X Bars,,None,None,None,None
782_240906003_B,184,XAUUSD,Buy,2016-06-03 12:00:00,2016-06-03 16:00:00,1221.65,1236.96,1,1531,58575.9,Exit After X Bars,,None,None,None,None
783_240906003_B,184,XAUUSD,Buy,2016-06-15 20:00:00,2016-06-16 00:00:00,1289.44,1291.66,1,222,58797.9,Exit After X Bars,,None,None,None,None
788_240906003_B,184,XAUUSD,Buy,2016-06-24 00:00:00,2016-06-24 04:00:00,1269.16,1271.53,1,237,59034.9,Exit After X Bars,,None,None,None,None
790_240906003_B,184,XAUUSD,Buy,2016-07-01 04:00:00,2016-07-01 08:00:00,1327.56,1330.3,1,274,59308.9,Exit After X Bars,,None,None,None,None
792_240906003_B,184,XAUUSD,Buy,2016-07-08 16:00:00,2016-07-08 20:00:00,1367.46,1355.82,1,-1164,58144.9,Exit After X Bars,,None,None,None,None
797_240906003_B,184,XAUUSD,Buy,2016-07-15 20:00:00,2016-07-18 00:00:00,1336.52,1332.62,1,-390,57754.9,End Of Friday,,None,None,None,None
799_240906003_B,184,XAUUSD,Buy,2016-07-20 04:00:00,2016-07-20 08:00:00,1335.3,1331.76,1,-354,57400.9,Exit After X Bars,,None,None,None,None
800_240906003_B,184,XAUUSD,Buy,2016-07-21 16:00:00,2016-07-21 20:00:00,1327.12,1330.09,1,297,57697.9,Exit After X Bars,,None,None,None,None
803_240906003_B,184,XAUUSD,Buy,2016-07-26 12:00:00,2016-07-26 16:00:00,1321.96,1320.7,1,-126,57571.9,Exit After X Bars,,None,None,None,None
807_240906003_B,184,XAUUSD,Buy,2016-08-09 16:00:00,2016-08-09 20:00:00,1337.92,1339.93,1,201,57772.9,Exit After X Bars,,None,None,None,None
809_240906003_B,184,XAUUSD,Buy,2016-08-12 12:00:00,2016-08-12 16:00:00,1353.14,1355.01,1,187,57959.9,Exit After X Bars,,None,None,None,None
810_240906003_B,184,XAUUSD,Buy,2016-08-16 12:00:00,2016-08-16 16:00:00,1356.22,1349.02,1,-720,57239.9,Exit After X Bars,,None,None,None,None
814_240906003_B,184,XAUUSD,Buy,2016-08-23 12:00:00,2016-08-23 16:00:00,1339.95,1343.74,1,379,57618.9,Exit After X Bars,,None,None,None,None
817_240906003_B,184,XAUUSD,Buy,2016-08-26 12:00:00,2016-08-26 16:00:00,1326.81,1331.14,1,433,58051.9,Exit After X Bars,,None,None,None,None
821_240906003_B,184,XAUUSD,Buy,2016-09-01 16:00:00,2016-09-01 20:00:00,1314.71,1313.54,1,-117,57934.9,Exit After X Bars,,None,None,None,None
826_240906003_B,184,XAUUSD,Buy,2016-09-15 12:00:00,2016-09-15 16:00:00,1325.82,1320.64,1,-518,57416.9,Exit After X Bars,,None,None,None,None
828_240906003_B,184,XAUUSD,Buy,2016-09-20 04:00:00,2016-09-20 08:00:00,1316.0,1316.33,1,33,57449.9,Exit After X Bars,,None,None,None,None
831_240906003_B,184,XAUUSD,Buy,2016-09-30 08:00:00,2016-09-30 12:00:00,1326.82,1326.0,1,-82,57367.9,Exit After X Bars,,None,None,None,None
837_240906003_B,184,XAUUSD,Buy,2016-10-28 16:00:00,2016-10-28 20:00:00,1272.7,1269.81,1,-289,57078.9,Exit After X Bars,,None,None,None,None
839_240906003_B,184,XAUUSD,Buy,2016-11-08 16:00:00,2016-11-08 20:00:00,1288.8,1276.86,1,-1194,55884.9,Exit After X Bars,,None,None,None,None
843_240906003_B,184,XAUUSD,Buy,2016-11-16 00:00:00,2016-11-16 04:00:00,1231.05,1231.18,1,13,55897.9,Exit After X Bars,,None,None,None,None
844_240906003_B,184,XAUUSD,Buy,2016-11-17 12:00:00,2016-11-17 16:00:00,1229.72,1224.52,1,-520,55377.9,Exit After X Bars,,None,None,None,None
848_240906003_B,184,XAUUSD,Buy,2016-11-25 12:00:00,2016-11-25 16:00:00,1189.26,1187.54,1,-172,55205.9,Exit After X Bars,,None,None,None,None
850_240906003_B,184,XAUUSD,Buy,2016-12-07 16:00:00,2016-12-07 20:00:00,1177.73,1175.55,1,-218,54987.9,Exit After X Bars,,None,None,None,None
854_240906003_B,184,XAUUSD,Buy,2016-12-16 16:00:00,2016-12-16 20:00:00,1137.27,1137.32,1,5,54992.9,Exit After X Bars,,None,None,None,None
858_240906003_B,184,XAUUSD,Buy,2017-01-20 20:00:00,2017-01-23 00:00:00,1207.78,1209.46,1,168,55160.9,End Of Friday,,None,None,None,None
859_240906003_B,184,XAUUSD,Buy,2017-01-23 16:00:00,2017-01-23 20:00:00,1214.71,1215.09,1,38,55198.9,Exit After X Bars,,None,None,None,None
864_240906003_B,184,XAUUSD,Buy,2017-01-30 12:00:00,2017-01-30 16:00:00,1191.45,1193.3,1,185,55383.9,Exit After X Bars,,None,None,None,None
867_240906003_B,184,XAUUSD,Buy,2017-02-14 12:00:00,2017-02-14 16:00:00,1230.93,1232.82,1,189,55572.9,Exit After X Bars,,None,None,None,None
868_240906003_B,184,XAUUSD,Buy,2017-02-16 00:00:00,2017-02-16 04:00:00,1234.29,1236.16,1,187,55759.9,Exit After X Bars,,None,None,None,None
871_240906003_B,184,XAUUSD,Buy,2017-02-22 12:00:00,2017-02-22 16:00:00,1238.74,1238.65,1,-9,55750.9,Exit After X Bars,,None,None,None,None
872_240906003_B,184,XAUUSD,Buy,2017-02-23 12:00:00,2017-02-23 16:00:00,1240.26,1248.47,1,821,56571.9,Exit After X Bars,,None,None,None,None
882_240906003_B,184,XAUUSD,Buy,2017-03-14 12:00:00,2017-03-14 16:00:00,1206.07,1203.71,1,-236,56335.9,Exit After X Bars,,None,None,None,None
887_240906003_B,184,XAUUSD,Buy,2017-04-03 16:00:00,2017-04-03 20:00:00,1250.39,1252.34,1,195,56530.9,Exit After X Bars,,None,None,None,None
889_240906003_B,184,XAUUSD,Buy,2017-04-07 04:00:00,2017-04-07 08:00:00,1258.73,1263.51,1,478,57008.9,Exit After X Bars,,None,None,None,None
891_240906003_B,184,XAUUSD,Buy,2017-04-11 12:00:00,2017-04-11 16:00:00,1256.98,1260.48,1,350,57358.9,Exit After X Bars,,None,None,None,None
895_240906003_B,184,XAUUSD,Buy,2017-04-21 12:00:00,2017-04-21 16:00:00,1283.22,1282.38,1,-84,57274.9,Exit After X Bars,,None,None,None,None
900_240906003_B,184,XAUUSD,Buy,2017-04-28 12:00:00,2017-04-28 16:00:00,1267.05,1266.6,1,-45,57229.9,Exit After X Bars,,None,None,None,None
901_240906003_B,184,XAUUSD,Buy,2017-05-01 16:00:00,2017-05-01 20:00:00,1268.41,1256.19,1,-1222,56007.9,Exit After X Bars,,None,None,None,None
906_240906003_B,184,XAUUSD,Buy,2017-05-08 12:00:00,2017-05-08 16:00:00,1235.36,1230.3,1,-506,55501.9,Exit After X Bars,,None,None,None,None
908_240906003_B,184,XAUUSD,Buy,2017-05-11 16:00:00,2017-05-11 20:00:00,1226.24,1224.91,1,-133,55368.9,Exit After X Bars,,None,None,None,None
910_240906003_B,184,XAUUSD,Buy,2017-05-26 08:00:00,2017-05-26 12:00:00,1258.74,1263.49,1,475,55843.9,Exit After X Bars,,None,None,None,None
912_240906003_B,184,XAUUSD,Buy,2017-05-31 12:00:00,2017-05-31 16:00:00,1265.2,1266.08,1,88,55931.9,Exit After X Bars,,None,None,None,None
914_240906003_B,184,XAUUSD,Buy,2017-06-02 12:00:00,2017-06-02 16:00:00,1268.73,1273.68,1,495,56426.9,Exit After X Bars,,None,None,None,None
919_240906003_B,184,XAUUSD,Buy,2017-06-14 12:00:00,2017-06-14 16:00:00,1268.8,1276.32,1,752,57178.9,Exit After X Bars,,None,None,None,None
924_240906003_B,184,XAUUSD,Buy,2017-06-22 00:00:00,2017-06-22 04:00:00,1247.92,1250.85,1,293,57471.9,Exit After X Bars,,None,None,None,None
930_240906003_B,184,XAUUSD,Buy,2017-07-06 00:00:00,2017-07-06 04:00:00,1227.27,1227.31,1,4,57475.9,Exit After X Bars,,None,None,None,None
931_240906003_B,184,XAUUSD,Buy,2017-07-07 12:00:00,2017-07-07 16:00:00,1227.23,1221.02,1,-621,56854.9,Exit After X Bars,,None,None,None,None
933_240906003_B,184,XAUUSD,Buy,2017-07-11 16:00:00,2017-07-11 20:00:00,1215.82,1215.74,1,-8,56846.9,Exit After X Bars,,None,None,None,None
935_240906003_B,184,XAUUSD,Buy,2017-07-26 20:00:00,2017-07-27 00:00:00,1254.96,1260.47,1,551,57397.9,Exit After X Bars,,None,None,None,None
936_240906003_B,184,XAUUSD,Buy,2017-07-28 12:00:00,2017-07-28 16:00:00,1265.05,1263.57,1,-148,57249.9,Exit After X Bars,,None,None,None,None
941_240906003_B,184,XAUUSD,Buy,2017-08-08 20:00:00,2017-08-09 00:00:00,1259.78,1260.4,1,62,57311.9,Exit After X Bars,,None,None,None,None
944_240906003_B,184,XAUUSD,Buy,2017-08-16 20:00:00,2017-08-17 00:00:00,1275.3,1283.5,1,820,58131.9,Exit After X Bars,,None,None,None,None
947_240906003_B,184,XAUUSD,Buy,2017-08-23 12:00:00,2017-08-23 16:00:00,1290.84,1289.25,1,-159,57972.9,Exit After X Bars,,None,None,None,None
949_240906003_B,184,XAUUSD,Buy,2017-08-25 16:00:00,2017-08-25 20:00:00,1290.01,1292.64,1,263,58235.9,Exit After X Bars,,None,None,None,None
951_240906003_B,184,XAUUSD,Buy,2017-08-31 16:00:00,2017-08-31 20:00:00,1313.5,1316.85,1,335,58570.9,Exit After X Bars,,None,None,None,None
952_240906003_B,184,XAUUSD,Buy,2017-09-07 12:00:00,2017-09-07 16:00:00,1341.61,1343.87,1,226,58796.9,Exit After X Bars,,None,None,None,None
955_240906003_B,184,XAUUSD,Buy,2017-09-13 12:00:00,2017-09-13 16:00:00,1334.33,1331.65,1,-268,58528.9,Exit After X Bars,,None,None,None,None
960_240906003_B,184,XAUUSD,Buy,2017-09-20 16:00:00,2017-09-20 20:00:00,1311.51,1313.22,1,171,58699.9,Exit After X Bars,,None,None,None,None
962_240906003_B,184,XAUUSD,Buy,2017-09-22 12:00:00,2017-09-22 16:00:00,1297.46,1294.75,1,-271,58428.9,Exit After X Bars,,None,None,None,None
963_240906003_B,184,XAUUSD,Buy,2017-09-25 16:00:00,2017-09-25 20:00:00,1298.27,1310.15,1,1188,59616.9,Exit After X Bars,,None,None,None,None
967_240906003_B,184,XAUUSD,Buy,2017-09-29 12:00:00,2017-09-29 16:00:00,1288.57,1288.61,1,4,59620.9,Exit After X Bars,,None,None,None,None
969_240906003_B,184,XAUUSD,Buy,2017-10-04 08:00:00,2017-10-04 12:00:00,1277.03,1275.54,1,-149,59471.9,Exit After X Bars,,None,None,None,None
976_240906003_B,184,XAUUSD,Buy,2017-10-26 08:00:00,2017-10-26 12:00:00,1281.19,1277.93,1,-326,59145.9,Exit After X Bars,,None,None,None,None
978_240906003_B,184,XAUUSD,Buy,2017-10-30 16:00:00,2017-10-30 20:00:00,1273.86,1278.05,1,419,59564.9,Exit After X Bars,,None,None,None,None
979_240906003_B,184,XAUUSD,Buy,2017-11-01 12:00:00,2017-11-01 16:00:00,1276.26,1275.13,1,-113,59451.9,Exit After X Bars,,None,None,None,None
980_240906003_B,184,XAUUSD,Buy,2017-11-06 16:00:00,2017-11-06 20:00:00,1280.08,1280.84,1,76,59527.9,Exit After X Bars,,None,None,None,None
982_240906003_B,184,XAUUSD,Buy,2017-11-14 16:00:00,2017-11-14 20:00:00,1279.66,1281.0,1,134,59661.9,Exit After X Bars,,None,None,None,None
983_240906003_B,184,XAUUSD,Buy,2017-11-17 16:00:00,2017-11-17 20:00:00,1289.4,1293.4,1,400,60061.9,Exit After X Bars,,None,None,None,None
985_240906003_B,184,XAUUSD,Buy,2017-11-22 12:00:00,2017-11-22 16:00:00,1284.64,1285.34,1,70,60131.9,Exit After X Bars,,None,None,None,None
989_240906003_B,184,XAUUSD,Buy,2017-12-01 16:00:00,2017-12-01 20:00:00,1283.19,1283.66,1,47,60178.9,Exit After X Bars,,None,None,None,None
997_240906003_B,184,XAUUSD,Buy,2017-12-13 16:00:00,2017-12-13 20:00:00,1244.76,1245.73,1,97,60275.9,Exit After X Bars,,None,None,None,None
998_240906003_B,184,XAUUSD,Buy,2018-01-04 16:00:00,2018-01-04 20:00:00,1317.67,1319.68,1,201,60476.9,Exit After X Bars,,None,None,None,None
1002_240906003_B,184,XAUUSD,Buy,2018-01-10 12:00:00,2018-01-10 16:00:00,1315.7,1319.7,1,400,60876.9,Exit After X Bars,,None,None,None,None
1003_240906003_B,184,XAUUSD,Buy,2018-01-12 04:00:00,2018-01-12 08:00:00,1327.48,1328.26,1,78,60954.9,Exit After X Bars,,None,None,None,None
1004_240906003_B,184,XAUUSD,Buy,2018-01-17 00:00:00,2018-01-17 04:00:00,1343.5,1343.65,1,15,60969.9,Exit After X Bars,,None,None,None,None
1006_240906003_B,184,XAUUSD,Buy,2018-01-23 00:00:00,2018-01-23 04:00:00,1336.37,1336.56,1,19,60988.9,Exit After X Bars,,None,None,None,None
1009_240906003_B,184,XAUUSD,Buy,2018-01-30 16:00:00,2018-01-30 20:00:00,1348.57,1338.57,1,-1000,59988.9,Exit After X Bars,,None,None,None,None
1011_240906003_B,184,XAUUSD,Buy,2018-02-01 20:00:00,2018-02-02 00:00:00,1347.43,1348.64,1,121,60109.9,Exit After X Bars,,None,None,None,None
1025_240906003_B,184,XAUUSD,Buy,2018-03-02 12:00:00,2018-03-02 16:00:00,1322.39,1325.0,1,261,60370.9,Exit After X Bars,,None,None,None,None
1028_240906003_B,184,XAUUSD,Buy,2018-03-13 00:00:00,2018-03-13 04:00:00,1325.04,1324.25,1,-79,60291.9,Exit After X Bars,,None,None,None,None
1032_240906003_B,184,XAUUSD,Buy,2018-03-21 16:00:00,2018-03-21 20:00:00,1319.53,1323.92,1,439,60730.9,Exit After X Bars,,None,None,None,None
1037_240906003_B,184,XAUUSD,Buy,2018-04-06 16:00:00,2018-04-06 20:00:00,1332.11,1331.36,1,-75,60655.9,Exit After X Bars,,None,None,None,None
1038_240906003_B,184,XAUUSD,Buy,2018-04-09 16:00:00,2018-04-09 20:00:00,1335.25,1335.22,1,-3,60652.9,Exit After X Bars,,None,None,None,None
1042_240906003_B,184,XAUUSD,Buy,2018-04-18 12:00:00,2018-04-18 16:00:00,1347.64,1353.13,1,549,61201.9,Exit After X Bars,,None,None,None,None
1046_240906003_B,184,XAUUSD,Buy,2018-04-24 16:00:00,2018-04-24 20:00:00,1329.34,1331.84,1,250,61451.9,Exit After X Bars,,None,None,None,None
1048_240906003_B,184,XAUUSD,Buy,2018-04-26 12:00:00,2018-04-26 16:00:00,1325.59,1324.72,1,-87,61364.9,Exit After X Bars,,None,None,None,None
1052_240906003_B,184,XAUUSD,Buy,2018-05-02 12:00:00,2018-05-02 16:00:00,1310.09,1308.94,1,-115,61249.9,Exit After X Bars,,None,None,None,None
1053_240906003_B,184,XAUUSD,Buy,2018-05-10 12:00:00,2018-05-10 16:00:00,1317.67,1322.01,1,434,61683.9,Exit After X Bars,,None,None,None,None
1057_240906003_B,184,XAUUSD,Buy,2018-05-18 16:00:00,2018-05-18 20:00:00,1291.63,1292.53,1,90,61773.9,Exit After X Bars,,None,None,None,None
1058_240906003_B,184,XAUUSD,Buy,2018-05-22 08:00:00,2018-05-22 12:00:00,1294.02,1293.72,1,-30,61743.9,Exit After X Bars,,None,None,None,None
1061_240906003_B,184,XAUUSD,Buy,2018-06-05 16:00:00,2018-06-05 20:00:00,1297.96,1298.38,1,42,61785.9,Exit After X Bars,,None,None,None,None
1062_240906003_B,184,XAUUSD,Buy,2018-06-11 16:00:00,2018-06-11 20:00:00,1300.5,1300.19,1,-31,61754.9,Exit After X Bars,,None,None,None,None
1064_240906003_B,184,XAUUSD,Buy,2018-06-13 20:00:00,2018-06-14 00:00:00,1299.65,1299.25,1,-40,61714.9,Exit After X Bars,,None,None,None,None
1070_240906003_B,184,XAUUSD,Buy,2018-06-22 12:00:00,2018-06-22 16:00:00,1269.94,1268.64,1,-130,61584.9,Exit After X Bars,,None,None,None,None
1076_240906003_B,184,XAUUSD,Buy,2018-07-03 16:00:00,2018-07-03 20:00:00,1250.57,1252.72,1,215,61799.9,Exit After X Bars,,None,None,None,None
1081_240906003_B,184,XAUUSD,Buy,2018-07-17 08:00:00,2018-07-17 12:00:00,1243.6,1244.67,1,107,61906.9,Exit After X Bars,,None,None,None,None
1083_240906003_B,184,XAUUSD,Buy,2018-07-19 20:00:00,2018-07-20 00:00:00,1228.36,1223.01,1,-535,61371.9,Exit After X Bars,,None,None,None,None
1084_240906003_B,184,XAUUSD,Buy,2018-07-20 12:00:00,2018-07-20 16:00:00,1228.85,1229.95,1,110,61481.9,Exit After X Bars,,None,None,None,None
1085_240906003_B,184,XAUUSD,Buy,2018-07-25 12:00:00,2018-07-25 16:00:00,1232.44,1232.4,1,-4,61477.9,Exit After X Bars,,None,None,None,None
1088_240906003_B,184,XAUUSD,Buy,2018-07-31 16:00:00,2018-07-31 20:00:00,1224.93,1225.98,1,105,61582.9,Exit After X Bars,,None,None,None,None
1090_240906003_B,184,XAUUSD,Buy,2018-08-03 16:00:00,2018-08-03 20:00:00,1218.22,1215.78,1,-244,61338.9,Exit After X Bars,,None,None,None,None
1092_240906003_B,184,XAUUSD,Buy,2018-08-09 08:00:00,2018-08-09 12:00:00,1216.02,1212.92,1,-310,61028.9,Exit After X Bars,,None,None,None,None
1098_240906003_B,184,XAUUSD,Buy,2018-08-17 20:00:00,2018-08-20 00:00:00,1181.52,1183.33,1,181,61209.9,End Of Friday,,None,None,None,None
1100_240906003_B,184,XAUUSD,Buy,2018-08-31 08:00:00,2018-08-31 12:00:00,1207.68,1206.3,1,-138,61071.9,Exit After X Bars,,None,None,None,None
1103_240906003_B,184,XAUUSD,Buy,2018-09-05 16:00:00,2018-09-05 20:00:00,1196.45,1195.41,1,-104,60967.9,Exit After X Bars,,None,None,None,None
1106_240906003_B,184,XAUUSD,Buy,2018-09-11 20:00:00,2018-09-12 00:00:00,1198.36,1198.01,1,-35,60932.9,Exit After X Bars,,None,None,None,None
1107_240906003_B,184,XAUUSD,Buy,2018-09-12 16:00:00,2018-09-12 20:00:00,1199.3,1203.97,1,467,61399.9,Exit After X Bars,,None,None,None,None
1109_240906003_B,184,XAUUSD,Buy,2018-09-19 12:00:00,2018-09-19 16:00:00,1204.73,1205.23,1,50,61449.9,Exit After X Bars,,None,None,None,None
1116_240906003_B,184,XAUUSD,Buy,2018-10-02 08:00:00,2018-10-02 12:00:00,1193.76,1193.13,1,-63,61386.9,Exit After X Bars,,None,None,None,None
1119_240906003_B,184,XAUUSD,Buy,2018-10-10 20:00:00,2018-10-11 00:00:00,1190.5,1194.76,1,426,61812.9,Exit After X Bars,,None,None,None,None
1121_240906003_B,184,XAUUSD,Buy,2018-10-18 16:00:00,2018-10-18 20:00:00,1229.27,1227.71,1,-156,61656.9,Exit After X Bars,,None,None,None,None
1122_240906003_B,184,XAUUSD,Buy,2018-10-19 12:00:00,2018-10-19 16:00:00,1229.91,1228.2,1,-171,61485.9,Exit After X Bars,,None,None,None,None
1123_240906003_B,184,XAUUSD,Buy,2018-10-23 08:00:00,2018-10-23 12:00:00,1230.57,1235.63,1,506,61991.9,Exit After X Bars,,None,None,None,None
1125_240906003_B,184,XAUUSD,Buy,2018-10-26 08:00:00,2018-10-26 12:00:00,1236.42,1237.36,1,94,62085.9,Exit After X Bars,,None,None,None,None
1128_240906003_B,184,XAUUSD,Buy,2018-11-01 08:00:00,2018-11-01 12:00:00,1226.43,1225.73,1,-70,62015.9,Exit After X Bars,,None,None,None,None
1130_240906003_B,184,XAUUSD,Buy,2018-11-07 12:00:00,2018-11-07 16:00:00,1235.8,1228.55,1,-725,61290.9,Exit After X Bars,,None,None,None,None
1135_240906003_B,184,XAUUSD,Buy,2018-11-14 16:00:00,2018-11-14 20:00:00,1204.22,1208.29,1,407,61697.9,Exit After X Bars,,None,None,None,None
1138_240906003_B,184,XAUUSD,Buy,2018-11-28 16:00:00,2018-11-28 20:00:00,1225.09,1221.12,1,-397,61300.9,Exit After X Bars,,None,None,None,None
1143_240906003_B,184,XAUUSD,Buy,2018-12-17 12:00:00,2018-12-17 16:00:00,1240.2,1241.54,1,134,61434.9,Exit After X Bars,,None,None,None,None
1144_240906003_B,184,XAUUSD,Buy,2018-12-20 16:00:00,2018-12-20 20:00:00,1257.89,1262.55,1,466,61900.9,Exit After X Bars,,None,None,None,None
1146_240906003_B,184,XAUUSD,Buy,2019-01-07 12:00:00,2019-01-07 16:00:00,1291.87,1292.27,1,40,61940.9,Exit After X Bars,,None,None,None,None
1148_240906003_B,184,XAUUSD,Buy,2019-01-09 16:00:00,2019-01-09 20:00:00,1286.86,1289.85,1,299,62239.9,Exit After X Bars,,None,None,None,None
1149_240906003_B,184,XAUUSD,Buy,2019-01-11 04:00:00,2019-01-11 08:00:00,1293.72,1293.86,1,14,62253.9,Exit After X Bars,,None,None,None,None
1152_240906003_B,184,XAUUSD,Buy,2019-01-16 16:00:00,2019-01-16 20:00:00,1294.62,1293.74,1,-88,62165.9,Exit After X Bars,,None,None,None,None
1153_240906003_B,184,XAUUSD,Buy,2019-01-17 12:00:00,2019-01-17 16:00:00,1294.86,1291.51,1,-335,61830.9,Exit After X Bars,,None,None,None,None
1156_240906003_B,184,XAUUSD,Buy,2019-01-23 12:00:00,2019-01-23 16:00:00,1285.56,1280.78,1,-478,61352.9,Exit After X Bars,,None,None,None,None
1158_240906003_B,184,XAUUSD,Buy,2019-01-25 12:00:00,2019-01-25 16:00:00,1283.78,1288.55,1,477,61829.9,Exit After X Bars,,None,None,None,None
1160_240906003_B,184,XAUUSD,Buy,2019-02-05 12:00:00,2019-02-05 16:00:00,1315.03,1314.58,1,-45,61784.9,Exit After X Bars,,None,None,None,None
1163_240906003_B,184,XAUUSD,Buy,2019-02-08 12:00:00,2019-02-08 16:00:00,1311.72,1314.73,1,301,62085.9,Exit After X Bars,,None,None,None,None
1165_240906003_B,184,XAUUSD,Buy,2019-02-13 16:00:00,2019-02-13 20:00:00,1314.59,1311.68,1,-291,61794.9,Exit After X Bars,,None,None,None,None
1166_240906003_B,184,XAUUSD,Buy,2019-02-15 12:00:00,2019-02-15 16:00:00,1318.02,1317.47,1,-55,61739.9,Exit After X Bars,,None,None,None,None
1175_240906003_B,184,XAUUSD,Buy,2019-03-06 08:00:00,2019-03-06 12:00:00,1289.53,1285.95,1,-358,61381.9,Exit After X Bars,,None,None,None,None
1176_240906003_B,184,XAUUSD,Buy,2019-03-07 12:00:00,2019-03-07 16:00:00,1288.27,1284.79,1,-348,61033.9,Exit After X Bars,,None,None,None,None
1178_240906003_B,184,XAUUSD,Buy,2019-03-20 20:00:00,2019-03-21 00:00:00,1310.75,1312.96,1,221,61254.9,Exit After X Bars,,None,None,None,None
1180_240906003_B,184,XAUUSD,Buy,2019-03-27 12:00:00,2019-03-27 16:00:00,1318.68,1315.07,1,-361,60893.9,Exit After X Bars,,None,None,None,None
1185_240906003_B,184,XAUUSD,Buy,2019-04-04 04:00:00,2019-04-04 08:00:00,1292.67,1292.6,1,-7,60886.9,Exit After X Bars,,None,None,None,None
1194_240906003_B,184,XAUUSD,Buy,2019-04-24 12:00:00,2019-04-24 16:00:00,1273.8,1270.9,1,-290,60596.9,Exit After X Bars,,None,None,None,None
1196_240906003_B,184,XAUUSD,Buy,2019-05-03 12:00:00,2019-05-03 16:00:00,1272.9,1275.84,1,294,60890.9,Exit After X Bars,,None,None,None,None
1197_240906003_B,184,XAUUSD,Buy,2019-05-13 12:00:00,2019-05-13 16:00:00,1289.28,1291.42,1,214,61104.9,Exit After X Bars,,None,None,None,None
1202_240906003_B,184,XAUUSD,Buy,2019-05-22 12:00:00,2019-05-22 16:00:00,1276.18,1275.58,1,-60,61044.9,Exit After X Bars,,None,None,None,None
1203_240906003_B,184,XAUUSD,Buy,2019-05-23 12:00:00,2019-05-23 16:00:00,1277.17,1282.7,1,553,61597.9,Exit After X Bars,,None,None,None,None
1205_240906003_B,184,XAUUSD,Buy,2019-05-30 16:00:00,2019-05-30 20:00:00,1285.37,1287.07,1,170,61767.9,Exit After X Bars,,None,None,None,None
1207_240906003_B,184,XAUUSD,Buy,2019-06-12 04:00:00,2019-06-12 08:00:00,1329.8,1332.3,1,250,62017.9,Exit After X Bars,,None,None,None,None
1208_240906003_B,184,XAUUSD,Buy,2019-06-13 16:00:00,2019-06-13 20:00:00,1337.56,1339.35,1,179,62196.9,Exit After X Bars,,None,None,None,None
1210_240906003_B,184,XAUUSD,Buy,2019-06-19 20:00:00,2019-06-20 00:00:00,1354.47,1360.32,1,585,62781.9,Exit After X Bars,,None,None,None,None
1212_240906003_B,184,XAUUSD,Buy,2019-06-28 00:00:00,2019-06-28 04:00:00,1414.82,1414.25,1,-57,62724.9,Exit After X Bars,,None,None,None,None
1214_240906003_B,184,XAUUSD,Buy,2019-07-02 16:00:00,2019-07-02 20:00:00,1395.95,1404.96,1,901,63625.9,Exit After X Bars,,None,None,None,None
1219_240906003_B,184,XAUUSD,Buy,2019-07-10 12:00:00,2019-07-10 16:00:00,1399.9,1410.09,1,1019,64644.9,Exit After X Bars,,None,None,None,None
1221_240906003_B,184,XAUUSD,Buy,2019-07-15 12:00:00,2019-07-15 16:00:00,1416.7,1412.11,1,-459,64185.9,Exit After X Bars,,None,None,None,None
1223_240906003_B,184,XAUUSD,Buy,2019-07-17 16:00:00,2019-07-17 20:00:00,1416.12,1422.27,1,615,64800.9,Exit After X Bars,,None,None,None,None
1225_240906003_B,184,XAUUSD,Buy,2019-07-23 16:00:00,2019-07-23 20:00:00,1428.92,1419.41,1,-951,63849.9,Exit After X Bars,,None,None,None,None
1227_240906003_B,184,XAUUSD,Buy,2019-07-25 12:00:00,2019-07-25 16:00:00,1429.32,1424.48,1,-484,63365.9,Exit After X Bars,,None,None,None,None
1229_240906003_B,184,XAUUSD,Buy,2019-07-29 20:00:00,2019-07-30 00:00:00,1424.67,1426.49,1,182,63547.9,Exit After X Bars,,None,None,None,None
1230_240906003_B,184,XAUUSD,Buy,2019-08-01 20:00:00,2019-08-02 00:00:00,1434.17,1444.8,1,1063,64610.9,Exit After X Bars,,None,None,None,None
1231_240906003_B,184,XAUUSD,Buy,2019-08-12 12:00:00,2019-08-12 16:00:00,1505.54,1501.91,1,-363,64247.9,Exit After X Bars,,None,None,None,None
1233_240906003_B,184,XAUUSD,Buy,2019-08-15 20:00:00,2019-08-16 00:00:00,1523.6,1523.39,1,-21,64226.9,Exit After X Bars,,None,None,None,None
1236_240906003_B,184,XAUUSD,Buy,2019-08-20 12:00:00,2019-08-20 16:00:00,1503.05,1504.12,1,107,64333.9,Exit After X Bars,,None,None,None,None
1239_240906003_B,184,XAUUSD,Buy,2019-08-23 12:00:00,2019-08-23 16:00:00,1504.4,1502.29,1,-211,64122.9,Exit After X Bars,,None,None,None,None
1241_240906003_B,184,XAUUSD,Buy,2019-09-03 08:00:00,2019-09-03 12:00:00,1532.61,1532.2,1,-41,64081.9,Exit After X Bars,,None,None,None,None
1242_240906003_B,184,XAUUSD,Buy,2019-09-04 20:00:00,2019-09-05 00:00:00,1549.89,1551.92,1,203,64284.9,Exit After X Bars,,None,None,None,None
1247_240906003_B,184,XAUUSD,Buy,2019-09-12 08:00:00,2019-09-12 12:00:00,1500.78,1504.38,1,360,64644.9,Exit After X Bars,,None,None,None,None
1249_240906003_B,184,XAUUSD,Buy,2019-09-20 20:00:00,2019-09-23 00:00:00,1511.39,1513.99,1,260,64904.9,End Of Friday,,None,None,None,None
1254_240906003_B,184,XAUUSD,Buy,2019-10-02 12:00:00,2019-10-02 16:00:00,1486.99,1492.34,1,535,65439.9,Exit After X Bars,,None,None,None,None
1256_240906003_B,184,XAUUSD,Buy,2019-10-08 12:00:00,2019-10-08 16:00:00,1503.91,1503.57,1,-34,65405.9,Exit After X Bars,,None,None,None,None
1262_240906003_B,184,XAUUSD,Buy,2019-10-17 12:00:00,2019-10-17 16:00:00,1492.94,1490.08,1,-286,65119.9,Exit After X Bars,,None,None,None,None
1264_240906003_B,184,XAUUSD,Buy,2019-10-23 16:00:00,2019-10-23 20:00:00,1495.13,1492.28,1,-285,64834.9,Exit After X Bars,,None,None,None,None
1267_240906003_B,184,XAUUSD,Buy,2019-10-30 12:00:00,2019-10-30 16:00:00,1494.43,1492.42,1,-201,64633.9,Exit After X Bars,,None,None,None,None
1273_240906003_B,184,XAUUSD,Buy,2019-11-13 08:00:00,2019-11-13 12:00:00,1466.2,1465.85,1,-35,64598.9,Exit After X Bars,,None,None,None,None
1274_240906003_B,184,XAUUSD,Buy,2019-11-18 16:00:00,2019-11-18 20:00:00,1468.93,1471.97,1,304,64902.9,Exit After X Bars,,None,None,None,None
1275_240906003_B,184,XAUUSD,Buy,2019-11-22 12:00:00,2019-11-22 16:00:00,1471.38,1468.69,1,-269,64633.9,Exit After X Bars,,None,None,None,None
1277_240906003_B,184,XAUUSD,Buy,2019-11-26 16:00:00,2019-11-26 20:00:00,1460.63,1460.05,1,-58,64575.9,Exit After X Bars,,None,None,None,None
1278_240906003_B,184,XAUUSD,Buy,2019-11-29 16:00:00,2019-11-29 20:00:00,1462.79,1463.89,1,110,64685.9,Exit After X Bars,,None,None,None,None
1279_240906003_B,184,XAUUSD,Buy,2019-12-03 08:00:00,2019-12-03 12:00:00,1466.47,1466.06,1,-41,64644.9,Exit After X Bars,,None,None,None,None
1282_240906003_B,184,XAUUSD,Buy,2019-12-10 12:00:00,2019-12-10 16:00:00,1465.24,1466.97,1,173,64817.9,Exit After X Bars,,None,None,None,None
1283_240906003_B,184,XAUUSD,Buy,2019-12-11 16:00:00,2019-12-11 20:00:00,1469.05,1470.33,1,128,64945.9,Exit After X Bars,,None,None,None,None
1286_240906003_B,184,XAUUSD,Buy,2019-12-19 16:00:00,2019-12-19 20:00:00,1479.14,1479.76,1,62,65007.9,Exit After X Bars,,None,None,None,None
1288_240906003_B,184,XAUUSD,Buy,2020-01-10 12:00:00,2020-01-10 16:00:00,1556.18,1548.64,1,-754,64253.9,Exit After X Bars,,None,None,None,None
1292_240906003_B,184,XAUUSD,Buy,2020-01-17 12:00:00,2020-01-17 16:00:00,1557.24,1555.36,1,-188,64065.9,Exit After X Bars,,None,None,None,None
1294_240906003_B,184,XAUUSD,Buy,2020-01-23 00:00:00,2020-01-23 04:00:00,1559.84,1559.89,1,5,64070.9,Exit After X Bars,,None,None,None,None
1295_240906003_B,184,XAUUSD,Buy,2020-01-24 16:00:00,2020-01-24 20:00:00,1567.76,1571.61,1,385,64455.9,Exit After X Bars,,None,None,None,None
1297_240906003_B,184,XAUUSD,Buy,2020-01-30 04:00:00,2020-01-30 08:00:00,1580.57,1578.08,1,-249,64206.9,Exit After X Bars,,None,None,None,None
1298_240906003_B,184,XAUUSD,Buy,2020-01-31 16:00:00,2020-01-31 20:00:00,1585.78,1583.5,1,-228,63978.9,Exit After X Bars,,None,None,None,None
1303_240906003_B,184,XAUUSD,Buy,2020-02-13 04:00:00,2020-02-13 08:00:00,1573.9,1574.09,1,19,63997.9,Exit After X Bars,,None,None,None,None
1306_240906003_B,184,XAUUSD,Buy,2020-02-27 12:00:00,2020-02-27 16:00:00,1650.42,1651.83,1,141,64138.9,Exit After X Bars,,None,None,None,None
1309_240906003_B,184,XAUUSD,Buy,2020-03-03 16:00:00,2020-03-03 20:00:00,1610.69,1645.16,1,3447,67585.9,Exit After X Bars,,None,None,None,None
1312_240906003_B,184,XAUUSD,Buy,2020-03-11 12:00:00,2020-03-11 16:00:00,1667.24,1665.52,1,-172,67413.9,Exit After X Bars,,None,None,None,None
1316_240906003_B,184,XAUUSD,Buy,2020-03-17 16:00:00,2020-03-17 20:00:00,1540.36,1527.22,1,-1314,66099.9,Exit After X Bars,,None,None,None,None
1321_240906003_B,184,XAUUSD,Buy,2020-04-02 12:00:00,2020-04-02 16:00:00,1596.3,1601.04,1,474,66573.9,Exit After X Bars,,None,None,None,None
1323_240906003_B,184,XAUUSD,Buy,2020-04-16 12:00:00,2020-04-16 16:00:00,1726.0,1724.86,1,-114,66459.9,Exit After X Bars,,None,None,None,None
1325_240906003_B,184,XAUUSD,Buy,2020-04-20 16:00:00,2020-04-20 20:00:00,1701.2,1693.91,1,-729,65730.9,Exit After X Bars,,None,None,None,None
1329_240906003_B,184,XAUUSD,Buy,2020-04-29 20:00:00,2020-04-30 00:00:00,1714.41,1711.6,1,-281,65449.9,Exit After X Bars,,None,None,None,None
1330_240906003_B,184,XAUUSD,Buy,2020-04-30 12:00:00,2020-04-30 16:00:00,1717.26,1706.46,1,-1080,64369.9,Exit After X Bars,,None,None,None,None
1334_240906003_B,184,XAUUSD,Buy,2020-05-07 16:00:00,2020-05-07 20:00:00,1704.72,1715.17,1,1045,65414.9,Exit After X Bars,,None,None,None,None
1336_240906003_B,184,XAUUSD,Buy,2020-05-12 16:00:00,2020-05-12 20:00:00,1708.06,1702.46,1,-560,64854.9,Exit After X Bars,,None,None,None,None
1337_240906003_B,184,XAUUSD,Buy,2020-05-13 12:00:00,2020-05-13 16:00:00,1710.6,1712.08,1,148,65002.9,Exit After X Bars,,None,None,None,None
1349_240906003_B,184,XAUUSD,Buy,2020-06-18 08:00:00,2020-06-18 12:00:00,1731.87,1732.86,1,99,65101.9,Exit After X Bars,,None,None,None,None
1350_240906003_B,184,XAUUSD,Buy,2020-06-19 16:00:00,2020-06-19 20:00:00,1737.32,1741.5,1,418,65519.9,Exit After X Bars,,None,None,None,None
1351_240906003_B,184,XAUUSD,Buy,2020-06-26 16:00:00,2020-06-26 20:00:00,1766.25,1767.46,1,121,65640.9,Exit After X Bars,,None,None,None,None
1352_240906003_B,184,XAUUSD,Buy,2020-06-29 20:00:00,2020-06-30 00:00:00,1771.79,1769.79,1,-200,65440.9,Exit After X Bars,,None,None,None,None
1353_240906003_B,184,XAUUSD,Buy,2020-06-30 16:00:00,2020-06-30 20:00:00,1773.9,1783.36,1,946,66386.9,Exit After X Bars,,None,None,None,None
1357_240906003_B,184,XAUUSD,Buy,2020-07-06 12:00:00,2020-07-06 16:00:00,1776.83,1783.07,1,624,67010.9,Exit After X Bars,,None,None,None,None
1358_240906003_B,184,XAUUSD,Buy,2020-07-07 16:00:00,2020-07-07 20:00:00,1786.78,1795.77,1,899,67909.9,Exit After X Bars,,None,None,None,None
1360_240906003_B,184,XAUUSD,Buy,2020-07-13 16:00:00,2020-07-13 20:00:00,1810.37,1809.68,1,-69,67840.9,Exit After X Bars,,None,None,None,None
1361_240906003_B,184,XAUUSD,Buy,2020-07-15 08:00:00,2020-07-15 12:00:00,1813.07,1812.4,1,-67,67773.9,Exit After X Bars,,None,None,None,None
1363_240906003_B,184,XAUUSD,Buy,2020-07-17 16:00:00,2020-07-17 20:00:00,1808.6,1807.75,1,-85,67688.9,Exit After X Bars,,None,None,None,None
1364_240906003_B,184,XAUUSD,Buy,2020-07-31 08:00:00,2020-07-31 12:00:00,1980.33,1976.84,1,-349,67339.9,Exit After X Bars,,None,None,None,None
1365_240906003_B,184,XAUUSD,Buy,2020-08-04 04:00:00,2020-08-04 08:00:00,1977.7,1974.49,1,-321,67018.9,Exit After X Bars,,None,None,None,None
1369_240906003_B,184,XAUUSD,Buy,2020-08-13 16:00:00,2020-08-13 20:00:00,1948.82,1953.66,1,484,67502.9,Exit After X Bars,,None,None,None,None
1371_240906003_B,184,XAUUSD,Buy,2020-08-17 12:00:00,2020-08-17 16:00:00,1955.95,1958.03,1,208,67710.9,Exit After X Bars,,None,None,None,None
1375_240906003_B,184,XAUUSD,Buy,2020-08-26 16:00:00,2020-08-26 20:00:00,1931.61,1943.23,1,1162,68872.9,Exit After X Bars,,None,None,None,None
1378_240906003_B,184,XAUUSD,Buy,2020-09-04 12:00:00,2020-09-04 16:00:00,1945.57,1927.17,1,-1840,67032.9,Exit After X Bars,,None,None,None,None
1380_240906003_B,184,XAUUSD,Buy,2020-09-08 16:00:00,2020-09-08 20:00:00,1932.44,1938.77,1,633,67665.9,Exit After X Bars,,None,None,None,None
1381_240906003_B,184,XAUUSD,Buy,2020-09-09 16:00:00,2020-09-09 20:00:00,1940.61,1948.25,1,764,68429.9,Exit After X Bars,,None,None,None,None
1388_240906003_B,184,XAUUSD,Buy,2020-09-28 12:00:00,2020-09-28 16:00:00,1872.29,1867.97,1,-432,67997.9,Exit After X Bars,,None,None,None,None
1392_240906003_B,184,XAUUSD,Buy,2020-10-16 12:00:00,2020-10-16 16:00:00,1912.71,1906.71,1,-600,67397.9,Exit After X Bars,,None,None,None,None
1393_240906003_B,184,XAUUSD,Buy,2020-10-19 12:00:00,2020-10-19 16:00:00,1913.71,1911.79,1,-192,67205.9,Exit After X Bars,,None,None,None,None
1394_240906003_B,184,XAUUSD,Buy,2020-10-21 04:00:00,2020-10-21 08:00:00,1918.25,1918.98,1,73,67278.9,Exit After X Bars,,None,None,None,None
1398_240906003_B,184,XAUUSD,Buy,2020-10-27 16:00:00,2020-10-27 20:00:00,1908.38,1909.17,1,79,67357.9,Exit After X Bars,,None,None,None,None
1401_240906003_B,184,XAUUSD,Buy,2020-10-30 12:00:00,2020-10-30 16:00:00,1881.63,1887.35,1,572,67929.9,Exit After X Bars,,None,None,None,None
1402_240906003_B,184,XAUUSD,Buy,2020-11-05 08:00:00,2020-11-05 12:00:00,1916.12,1917.0,1,88,68017.9,Exit After X Bars,,None,None,None,None
1406_240906003_B,184,XAUUSD,Buy,2020-11-12 16:00:00,2020-11-12 20:00:00,1881.63,1877.3,1,-433,67584.9,Exit After X Bars,,None,None,None,None
1407_240906003_B,184,XAUUSD,Buy,2020-11-13 12:00:00,2020-11-13 16:00:00,1883.49,1894.65,1,1116,68700.9,Exit After X Bars,,None,None,None,None
1410_240906003_B,184,XAUUSD,Buy,2020-11-20 12:00:00,2020-11-20 16:00:00,1867.39,1867.3,1,-9,68691.9,Exit After X Bars,,None,None,None,None
1416_240906003_B,184,XAUUSD,Buy,2020-12-01 12:00:00,2020-12-01 16:00:00,1809.4,1812.76,1,336,69027.9,Exit After X Bars,,None,None,None,None
1419_240906003_B,184,XAUUSD,Buy,2020-12-15 08:00:00,2020-12-15 12:00:00,1847.44,1845.47,1,-197,68830.9,Exit After X Bars,,None,None,None,None
1422_240906003_B,184,XAUUSD,Buy,2020-12-24 16:00:00,2020-12-24 20:00:00,1878.2,1879.57,1,137,68967.9,Exit After X Bars,,None,None,None,None
1424_240906003_B,184,XAUUSD,Buy,2020-12-30 16:00:00,2020-12-30 20:00:00,1886.12,1888.73,1,261,69228.9,Exit After X Bars,,None,None,None,None
1429_240906003_B,184,XAUUSD,Buy,2021-01-12 20:00:00,2021-01-13 00:00:00,1852.16,1854.33,1,217,69445.9,Exit After X Bars,,None,None,None,None
1433_240906003_B,184,XAUUSD,Buy,2021-01-20 08:00:00,2021-01-20 12:00:00,1855.5,1854.51,1,-99,69346.9,Exit After X Bars,,None,None,None,None
1437_240906003_B,184,XAUUSD,Buy,2021-01-28 12:00:00,2021-01-28 16:00:00,1850.41,1856.92,1,651,69997.9,Exit After X Bars,,None,None,None,None
1442_240906003_B,184,XAUUSD,Buy,2021-02-08 12:00:00,2021-02-08 16:00:00,1814.86,1829.72,1,1486,71483.9,Exit After X Bars,,None,None,None,None
1445_240906003_B,184,XAUUSD,Buy,2021-02-16 12:00:00,2021-02-16 16:00:00,1825.25,1796.73,1,-2852,68631.9,Exit After X Bars,,None,None,None,None
1448_240906003_B,184,XAUUSD,Buy,2021-02-19 16:00:00,2021-02-19 20:00:00,1789.28,1783.0,1,-628,68003.9,Exit After X Bars,,None,None,None,None
1457_240906003_B,184,XAUUSD,Buy,2021-03-09 12:00:00,2021-03-09 16:00:00,1707.35,1713.35,1,600,68603.9,Exit After X Bars,,None,None,None,None
1461_240906003_B,184,XAUUSD,Buy,2021-03-25 16:00:00,2021-03-25 20:00:00,1738.19,1728.18,1,-1001,67602.9,Exit After X Bars,,None,None,None,None
1465_240906003_B,184,XAUUSD,Buy,2021-03-31 16:00:00,2021-03-31 20:00:00,1700.7,1711.84,1,1114,68716.9,Exit After X Bars,,None,None,None,None
1468_240906003_B,184,XAUUSD,Buy,2021-04-13 16:00:00,2021-04-13 20:00:00,1744.79,1742.5,1,-229,68487.9,Exit After X Bars,,None,None,None,None
1469_240906003_B,184,XAUUSD,Buy,2021-04-21 16:00:00,2021-04-21 20:00:00,1789.8,1790.73,1,93,68580.9,Exit After X Bars,,None,None,None,None
1471_240906003_B,184,XAUUSD,Buy,2021-04-23 12:00:00,2021-04-23 16:00:00,1790.45,1793.44,1,299,68879.9,Exit After X Bars,,None,None,None,None
1473_240906003_B,184,XAUUSD,Buy,2021-04-27 12:00:00,2021-04-27 16:00:00,1782.24,1782.93,1,69,68948.9,Exit After X Bars,,None,None,None,None
1474_240906003_B,184,XAUUSD,Buy,2021-04-29 00:00:00,2021-04-29 04:00:00,1785.3,1784.61,1,-69,68879.9,Exit After X Bars,,None,None,None,None
1476_240906003_B,184,XAUUSD,Buy,2021-05-06 16:00:00,2021-05-06 20:00:00,1798.82,1815.7,1,1688,70567.9,Exit After X Bars,,None,None,None,None
1478_240906003_B,184,XAUUSD,Buy,2021-05-12 16:00:00,2021-05-12 20:00:00,1841.52,1820.23,1,-2129,68438.9,Exit After X Bars,,None,None,None,None
1480_240906003_B,184,XAUUSD,Buy,2021-05-19 16:00:00,2021-05-19 20:00:00,1874.6,1881.86,1,726,69164.9,Exit After X Bars,,None,None,None,None
1482_240906003_B,184,XAUUSD,Buy,2021-05-21 12:00:00,2021-05-21 16:00:00,1883.51,1886.94,1,343,69507.9,Exit After X Bars,,None,None,None,None
1484_240906003_B,184,XAUUSD,Buy,2021-05-25 16:00:00,2021-05-25 20:00:00,1885.93,1895.23,1,930,70437.9,Exit After X Bars,,None,None,None,None
1486_240906003_B,184,XAUUSD,Buy,2021-05-28 16:00:00,2021-05-28 20:00:00,1898.53,1899.75,1,122,70559.9,Exit After X Bars,,None,None,None,None
1487_240906003_B,184,XAUUSD,Buy,2021-05-31 16:00:00,2021-06-01 00:00:00,1905.59,1907.39,1,180,70739.9,Exit After X Bars,,None,None,None,None
1492_240906003_B,184,XAUUSD,Buy,2021-06-07 20:00:00,2021-06-08 00:00:00,1896.0,1897.97,1,197,70936.9,Exit After X Bars,,None,None,None,None
1495_240906003_B,184,XAUUSD,Buy,2021-06-10 20:00:00,2021-06-11 00:00:00,1898.84,1897.78,1,-106,70830.9,Exit After X Bars,,None,None,None,None
1503_240906003_B,184,XAUUSD,Buy,2021-06-23 16:00:00,2021-06-23 20:00:00,1787.29,1783.21,1,-408,70422.9,Exit After X Bars,,None,None,None,None
1505_240906003_B,184,XAUUSD,Buy,2021-07-01 04:00:00,2021-07-01 08:00:00,1775.51,1774.39,1,-112,70310.9,Exit After X Bars,,None,None,None,None
1507_240906003_B,184,XAUUSD,Buy,2021-07-20 12:00:00,2021-07-20 16:00:00,1815.33,1822.68,1,735,71045.9,Exit After X Bars,,None,None,None,None
1509_240906003_B,184,XAUUSD,Buy,2021-07-23 08:00:00,2021-07-23 12:00:00,1808.75,1804.31,1,-444,70601.9,Exit After X Bars,,None,None,None,None
1512_240906003_B,184,XAUUSD,Buy,2021-07-28 20:00:00,2021-07-29 00:00:00,1805.04,1806.93,1,189,70790.9,Exit After X Bars,,None,None,None,None
1515_240906003_B,184,XAUUSD,Buy,2021-08-04 12:00:00,2021-08-04 16:00:00,1814.84,1827.06,1,1222,72012.9,Exit After X Bars,,None,None,None,None
1520_240906003_B,184,XAUUSD,Buy,2021-08-11 12:00:00,2021-08-11 16:00:00,1733.38,1744.61,1,1123,73135.9,Exit After X Bars,,None,None,None,None
1521_240906003_B,184,XAUUSD,Buy,2021-08-19 16:00:00,2021-08-19 20:00:00,1790.87,1782.5,1,-837,72298.9,Exit After X Bars,,None,None,None,None
1523_240906003_B,184,XAUUSD,Buy,2021-08-26 16:00:00,2021-08-26 20:00:00,1797.47,1792.11,1,-536,71762.9,Exit After X Bars,,None,None,None,None
1524_240906003_B,184,XAUUSD,Buy,2021-09-01 12:00:00,2021-09-01 16:00:00,1817.61,1819.32,1,171,71933.9,Exit After X Bars,,None,None,None,None
1526_240906003_B,184,XAUUSD,Buy,2021-09-03 12:00:00,2021-09-03 16:00:00,1816.9,1823.4,1,650,72583.9,Exit After X Bars,,None,None,None,None
1529_240906003_B,184,XAUUSD,Buy,2021-09-10 08:00:00,2021-09-10 12:00:00,1801.98,1801.59,1,-39,72544.9,Exit After X Bars,,None,None,None,None
1531_240906003_B,184,XAUUSD,Buy,2021-09-14 12:00:00,2021-09-14 16:00:00,1798.16,1797.16,1,-100,72444.9,Exit After X Bars,,None,None,None,None
1535_240906003_B,184,XAUUSD,Buy,2021-09-21 12:00:00,2021-09-21 16:00:00,1766.87,1771.79,1,492,72936.9,Exit After X Bars,,None,None,None,None
1538_240906003_B,184,XAUUSD,Buy,2021-09-27 16:00:00,2021-09-27 20:00:00,1757.41,1752.14,1,-527,72409.9,Exit After X Bars,,None,None,None,None
1540_240906003_B,184,XAUUSD,Buy,2021-09-29 12:00:00,2021-09-29 16:00:00,1743.59,1738.32,1,-527,71882.9,Exit After X Bars,,None,None,None,None
1541_240906003_B,184,XAUUSD,Buy,2021-09-30 16:00:00,2021-09-30 20:00:00,1745.24,1758.15,1,1291,73173.9,Exit After X Bars,,None,None,None,None
1542_240906003_B,184,XAUUSD,Buy,2021-10-06 16:00:00,2021-10-06 20:00:00,1762.83,1762.34,1,-49,73124.9,Exit After X Bars,,None,None,None,None
1543_240906003_B,184,XAUUSD,Buy,2021-10-08 12:00:00,2021-10-08 16:00:00,1764.91,1775.77,1,1086,74210.9,Exit After X Bars,,None,None,None,None
1544_240906003_B,184,XAUUSD,Buy,2021-10-13 16:00:00,2021-10-13 20:00:00,1781.13,1792.5,1,1137,75347.9,Exit After X Bars,,None,None,None,None
1547_240906003_B,184,XAUUSD,Buy,2021-10-20 12:00:00,2021-10-20 16:00:00,1784.93,1786.43,1,150,75497.9,Exit After X Bars,,None,None,None,None
1549_240906003_B,184,XAUUSD,Buy,2021-10-28 12:00:00,2021-10-28 16:00:00,1804.38,1798.98,1,-540,74957.9,Exit After X Bars,,None,None,None,None
1554_240906003_B,184,XAUUSD,Buy,2021-11-04 12:00:00,2021-11-04 16:00:00,1785.45,1792.52,1,707,75664.9,Exit After X Bars,,None,None,None,None
1562_240906003_B,184,XAUUSD,Buy,2021-11-25 12:00:00,2021-11-25 16:00:00,1792.91,1791.1,1,-181,75483.9,Exit After X Bars,,None,None,None,None
1566_240906003_B,184,XAUUSD,Buy,2021-12-03 16:00:00,2021-12-03 20:00:00,1780.87,1780.42,1,-45,75438.9,Exit After X Bars,,None,None,None,None
1568_240906003_B,184,XAUUSD,Buy,2021-12-16 08:00:00,2021-12-16 12:00:00,1785.51,1785.43,1,-8,75430.9,Exit After X Bars,,None,None,None,None
1569_240906003_B,184,XAUUSD,Buy,2021-12-21 12:00:00,2021-12-21 16:00:00,1799.99,1797.87,1,-212,75218.9,Exit After X Bars,,None,None,None,None
1570_240906003_B,184,XAUUSD,Buy,2021-12-22 20:00:00,2021-12-23 00:00:00,1800.36,1803.8,1,344,75562.9,Exit After X Bars,,None,None,None,None
1572_240906003_B,184,XAUUSD,Buy,2021-12-30 16:00:00,2021-12-30 20:00:00,1805.54,1813.42,1,788,76350.9,Exit After X Bars,,None,None,None,None
1574_240906003_B,184,XAUUSD,Buy,2022-01-05 12:00:00,2022-01-05 16:00:00,1827.31,1825.4,1,-191,76159.9,Exit After X Bars,,None,None,None,None
1577_240906003_B,184,XAUUSD,Buy,2022-01-10 12:00:00,2022-01-10 16:00:00,1798.43,1792.91,1,-552,75607.9,Exit After X Bars,,None,None,None,None
1580_240906003_B,184,XAUUSD,Buy,2022-01-19 12:00:00,2022-01-19 16:00:00,1819.96,1823.91,1,395,76002.9,Exit After X Bars,,None,None,None,None
1582_240906003_B,184,XAUUSD,Buy,2022-01-24 20:00:00,2022-01-25 00:00:00,1842.98,1842.67,1,-31,75971.9,Exit After X Bars,,None,None,None,None
1583_240906003_B,184,XAUUSD,Buy,2022-01-25 16:00:00,2022-01-25 20:00:00,1843.9,1849.7,1,580,76551.9,Exit After X Bars,,None,None,None,None
1587_240906003_B,184,XAUUSD,Buy,2022-01-31 12:00:00,2022-01-31 16:00:00,1792.73,1797.59,1,486,77037.9,Exit After X Bars,,None,None,None,None
1588_240906003_B,184,XAUUSD,Buy,2022-02-02 16:00:00,2022-02-02 20:00:00,1808.49,1809.98,1,149,77186.9,Exit After X Bars,,None,None,None,None
1589_240906003_B,184,XAUUSD,Buy,2022-02-04 20:00:00,2022-02-07 00:00:00,1807.41,1806.72,1,-69,77117.9,End Of Friday,,None,None,None,None
1590_240906003_B,184,XAUUSD,Buy,2022-02-11 20:00:00,2022-02-14 00:00:00,1841.7,1859.23,1,1753,78870.9,End Of Friday,,None,None,None,None
1593_240906003_B,184,XAUUSD,Buy,2022-02-23 16:00:00,2022-02-23 20:00:00,1906.78,1908.22,1,144,79014.9,Exit After X Bars,,None,None,None,None
1595_240906003_B,184,XAUUSD,Buy,2022-02-28 12:00:00,2022-02-28 16:00:00,1913.55,1917.14,1,359,79373.9,Exit After X Bars,,None,None,None,None
1596_240906003_B,184,XAUUSD,Buy,2022-03-01 12:00:00,2022-03-01 16:00:00,1917.93,1916.73,1,-120,79253.9,Exit After X Bars,,None,None,None,None
1597_240906003_B,184,XAUUSD,Buy,2022-03-03 12:00:00,2022-03-03 16:00:00,1935.32,1926.01,1,-931,78322.9,Exit After X Bars,,None,None,None,None
1603_240906003_B,184,XAUUSD,Buy,2022-03-17 04:00:00,2022-03-17 08:00:00,1934.52,1935.8,1,128,78450.9,Exit After X Bars,,None,None,None,None
1605_240906003_B,184,XAUUSD,Buy,2022-03-21 20:00:00,2022-03-22 00:00:00,1940.46,1935.43,1,-503,77947.9,Exit After X Bars,,None,None,None,None
1607_240906003_B,184,XAUUSD,Buy,2022-03-23 12:00:00,2022-03-23 16:00:00,1930.54,1928.83,1,-171,77776.9,Exit After X Bars,,None,None,None,None
1610_240906003_B,184,XAUUSD,Buy,2022-03-30 12:00:00,2022-03-30 16:00:00,1921.17,1927.08,1,591,78367.9,Exit After X Bars,,None,None,None,None
1611_240906003_B,184,XAUUSD,Buy,2022-03-31 16:00:00,2022-03-31 20:00:00,1938.31,1944.27,1,596,78963.9,Exit After X Bars,,None,None,None,None
1613_240906003_B,184,XAUUSD,Buy,2022-04-04 16:00:00,2022-04-04 20:00:00,1936.26,1931.39,1,-487,78476.9,Exit After X Bars,,None,None,None,None
1615_240906003_B,184,XAUUSD,Buy,2022-04-07 12:00:00,2022-04-07 16:00:00,1933.25,1927.55,1,-570,77906.9,Exit After X Bars,,None,None,None,None
1623_240906003_B,184,XAUUSD,Buy,2022-04-29 08:00:00,2022-04-29 12:00:00,1906.67,1913.84,1,717,78623.9,Exit After X Bars,,None,None,None,None
1626_240906003_B,184,XAUUSD,Buy,2022-05-04 20:00:00,2022-05-05 00:00:00,1877.7,1881.3,1,360,78983.9,Exit After X Bars,,None,None,None,None
1632_240906003_B,184,XAUUSD,Buy,2022-05-16 20:00:00,2022-05-17 00:00:00,1824.31,1824.7,1,39,79022.9,Exit After X Bars,,None,None,None,None
1633_240906003_B,184,XAUUSD,Buy,2022-05-19 12:00:00,2022-05-19 16:00:00,1835.77,1838.19,1,242,79264.9,Exit After X Bars,,None,None,None,None
1634_240906003_B,184,XAUUSD,Buy,2022-05-27 08:00:00,2022-05-27 12:00:00,1859.14,1856.65,1,-249,79015.9,Exit After X Bars,,None,None,None,None
1639_240906003_B,184,XAUUSD,Buy,2022-06-08 16:00:00,2022-06-08 20:00:00,1855.39,1855.32,1,-7,79008.9,Exit After X Bars,,None,None,None,None
1641_240906003_B,184,XAUUSD,Buy,2022-06-10 16:00:00,2022-06-10 20:00:00,1852.47,1871.61,1,1914,80922.9,Exit After X Bars,,None,None,None,None
1644_240906003_B,184,XAUUSD,Buy,2022-06-15 12:00:00,2022-06-15 16:00:00,1825.58,1831.58,1,600,81522.9,Exit After X Bars,,None,None,None,None
1646_240906003_B,184,XAUUSD,Buy,2022-06-22 12:00:00,2022-06-22 16:00:00,1843.41,1844.59,1,118,81640.9,Exit After X Bars,,None,None,None,None
1650_240906003_B,184,XAUUSD,Buy,2022-06-29 12:00:00,2022-06-29 16:00:00,1827.65,1831.18,1,353,81993.9,Exit After X Bars,,None,None,None,None
1653_240906003_B,184,XAUUSD,Buy,2022-07-05 04:00:00,2022-07-05 08:00:00,1811.59,1811.34,1,-25,81968.9,Exit After X Bars,,None,None,None,None
1656_240906003_B,184,XAUUSD,Buy,2022-07-08 16:00:00,2022-07-08 20:00:00,1748.76,1742.24,1,-652,81316.9,Exit After X Bars,,None,None,None,None
1659_240906003_B,184,XAUUSD,Buy,2022-07-13 16:00:00,2022-07-13 20:00:00,1738.99,1737.85,1,-114,81202.9,Exit After X Bars,,None,None,None,None
1662_240906003_B,184,XAUUSD,Buy,2022-07-21 16:00:00,2022-07-21 20:00:00,1714.15,1711.62,1,-253,80949.9,Exit After X Bars,,None,None,None,None
1663_240906003_B,184,XAUUSD,Buy,2022-08-04 12:00:00,2022-08-04 16:00:00,1787.72,1780.64,1,-708,80241.9,Exit After X Bars,,None,None,None,None
1665_240906003_B,184,XAUUSD,Buy,2022-08-08 16:00:00,2022-08-08 20:00:00,1788.88,1787.56,1,-132,80109.9,Exit After X Bars,,None,None,None,None
1666_240906003_B,184,XAUUSD,Buy,2022-08-10 12:00:00,2022-08-10 16:00:00,1800.15,1797.19,1,-296,79813.9,Exit After X Bars,,None,None,None,None
1668_240906003_B,184,XAUUSD,Buy,2022-08-12 20:00:00,2022-08-15 00:00:00,1798.95,1802.31,1,336,80149.9,End Of Friday,,None,None,None,None
1675_240906003_B,184,XAUUSD,Buy,2022-08-23 16:00:00,2022-08-23 20:00:00,1739.77,1749.64,1,987,81136.9,Exit After X Bars,,None,None,None,None
1681_240906003_B,184,XAUUSD,Buy,2022-09-02 12:00:00,2022-09-02 16:00:00,1708.42,1708.73,1,31,81167.9,Exit After X Bars,,None,None,None,None
1682_240906003_B,184,XAUUSD,Buy,2022-09-07 16:00:00,2022-09-07 20:00:00,1714.77,1714.98,1,21,81188.9,Exit After X Bars,,None,None,None,None
1693_240906003_B,184,XAUUSD,Buy,2022-09-28 16:00:00,2022-09-28 20:00:00,1642.07,1659.16,1,1709,82897.9,Exit After X Bars,,None,None,None,None
1698_240906003_B,184,XAUUSD,Buy,2022-10-13 12:00:00,2022-10-13 16:00:00,1677.96,1654.55,1,-2341,80556.9,Exit After X Bars,,None,None,None,None
1700_240906003_B,184,XAUUSD,Buy,2022-10-17 12:00:00,2022-10-17 16:00:00,1663.64,1666.48,1,284,80840.9,Exit After X Bars,,None,None,None,None
1703_240906003_B,184,XAUUSD,Buy,2022-10-20 16:00:00,2022-10-20 20:00:00,1641.78,1636.03,1,-575,80265.9,Exit After X Bars,,None,None,None,None
1704_240906003_B,184,XAUUSD,Buy,2022-10-21 16:00:00,2022-10-21 20:00:00,1645.18,1651.3,1,612,80877.9,Exit After X Bars,,None,None,None,None
1707_240906003_B,184,XAUUSD,Buy,2022-11-04 16:00:00,2022-11-04 20:00:00,1669.15,1673.16,1,401,81278.9,Exit After X Bars,,None,None,None,None
1711_240906003_B,184,XAUUSD,Buy,2022-11-22 16:00:00,2022-11-22 20:00:00,1746.46,1739.36,1,-710,80568.9,Exit After X Bars,,None,None,None,None
1712_240906003_B,184,XAUUSD,Buy,2022-11-23 20:00:00,2022-11-24 00:00:00,1749.29,1749.33,1,4,80572.9,Exit After X Bars,,None,None,None,None
1714_240906003_B,184,XAUUSD,Buy,2022-11-29 08:00:00,2022-11-29 12:00:00,1756.04,1753.91,1,-213,80359.9,Exit After X Bars,,None,None,None,None
1715_240906003_B,184,XAUUSD,Buy,2022-11-30 20:00:00,2022-12-01 00:00:00,1757.81,1768.62,1,1081,81440.9,Exit After X Bars,,None,None,None,None
1718_240906003_B,184,XAUUSD,Buy,2022-12-07 16:00:00,2022-12-07 20:00:00,1780.57,1782.96,1,239,81679.9,Exit After X Bars,,None,None,None,None
1719_240906003_B,184,XAUUSD,Buy,2022-12-08 12:00:00,2022-12-08 16:00:00,1790.19,1789.41,1,-78,81601.9,Exit After X Bars,,None,None,None,None
1721_240906003_B,184,XAUUSD,Buy,2022-12-13 12:00:00,2022-12-13 16:00:00,1795.18,1810.86,1,1568,83169.9,Exit After X Bars,,None,None,None,None
1723_240906003_B,184,XAUUSD,Buy,2022-12-16 12:00:00,2022-12-16 16:00:00,1785.76,1785.4,1,-36,83133.9,Exit After X Bars,,None,None,None,None
1724_240906003_B,184,XAUUSD,Buy,2022-12-20 04:00:00,2022-12-20 08:00:00,1794.09,1788.67,1,-542,82591.9,Exit After X Bars,,None,None,None,None
1729_240906003_B,184,XAUUSD,Buy,2023-01-06 12:00:00,2023-01-06 16:00:00,1850.89,1851.63,1,74,82665.9,Exit After X Bars,,None,None,None,None
1730_240906003_B,184,XAUUSD,Buy,2023-01-12 00:00:00,2023-01-12 04:00:00,1880.41,1880.46,1,5,82670.9,Exit After X Bars,,None,None,None,None
1732_240906003_B,184,XAUUSD,Buy,2023-01-18 12:00:00,2023-01-18 16:00:00,1916.29,1921.2,1,491,83161.9,Exit After X Bars,,None,None,None,None
1733_240906003_B,184,XAUUSD,Buy,2023-01-19 20:00:00,2023-01-20 00:00:00,1925.56,1931.74,1,618,83779.9,Exit After X Bars,,None,None,None,None
1735_240906003_B,184,XAUUSD,Buy,2023-01-23 20:00:00,2023-01-24 00:00:00,1930.98,1930.6,1,-38,83741.9,Exit After X Bars,,None,None,None,None
1736_240906003_B,184,XAUUSD,Buy,2023-01-24 20:00:00,2023-01-25 00:00:00,1935.5,1937.4,1,190,83931.9,Exit After X Bars,,None,None,None,None
1737_240906003_B,184,XAUUSD,Buy,2023-01-25 16:00:00,2023-01-25 20:00:00,1939.08,1937.2,1,-188,83743.9,Exit After X Bars,,None,None,None,None
1741_240906003_B,184,XAUUSD,Buy,2023-01-31 20:00:00,2023-02-01 00:00:00,1930.51,1927.54,1,-297,83446.9,Exit After X Bars,,None,None,None,None
1742_240906003_B,184,XAUUSD,Buy,2023-02-01 12:00:00,2023-02-01 16:00:00,1930.91,1929.13,1,-178,83268.9,Exit After X Bars,,None,None,None,None
1745_240906003_B,184,XAUUSD,Buy,2023-02-07 16:00:00,2023-02-07 20:00:00,1875.49,1880.47,1,498,83766.9,Exit After X Bars,,None,None,None,None
1746_240906003_B,184,XAUUSD,Buy,2023-02-09 08:00:00,2023-02-09 12:00:00,1884.15,1883.04,1,-111,83655.9,Exit After X Bars,,None,None,None,None
1748_240906003_B,184,XAUUSD,Buy,2023-02-14 12:00:00,2023-02-14 16:00:00,1868.2,1862.46,1,-574,83081.9,Exit After X Bars,,None,None,None,None
1750_240906003_B,184,XAUUSD,Buy,2023-02-16 16:00:00,2023-02-16 20:00:00,1841.9,1842.34,1,44,83125.9,Exit After X Bars,,None,None,None,None
1755_240906003_B,184,XAUUSD,Buy,2023-02-28 16:00:00,2023-02-28 20:00:00,1819.91,1829.15,1,924,84049.9,Exit After X Bars,,None,None,None,None
1758_240906003_B,184,XAUUSD,Buy,2023-03-09 12:00:00,2023-03-09 16:00:00,1824.08,1825.06,1,98,84147.9,Exit After X Bars,,None,None,None,None
1760_240906003_B,184,XAUUSD,Buy,2023-03-22 20:00:00,2023-03-23 00:00:00,1969.33,1969.71,1,38,84185.9,Exit After X Bars,,None,None,None,None
1763_240906003_B,184,XAUUSD,Buy,2023-03-28 16:00:00,2023-03-28 20:00:00,1968.22,1968.94,1,72,84257.9,Exit After X Bars,,None,None,None,None
1765_240906003_B,184,XAUUSD,Buy,2023-03-30 12:00:00,2023-03-30 16:00:00,1971.38,1970.18,1,-120,84137.9,Exit After X Bars,,None,None,None,None
1766_240906003_B,184,XAUUSD,Buy,2023-03-31 12:00:00,2023-03-31 16:00:00,1983.99,1979.55,1,-444,83693.9,Exit After X Bars,,None,None,None,None
1767_240906003_B,184,XAUUSD,Buy,2023-04-03 16:00:00,2023-04-03 20:00:00,1987.31,1986.82,1,-49,83644.9,Exit After X Bars,,None,None,None,None
1768_240906003_B,184,XAUUSD,Buy,2023-04-04 16:00:00,2023-04-04 20:00:00,1990.22,2020.68,1,3046,86690.9,Exit After X Bars,,None,None,None,None
1771_240906003_B,184,XAUUSD,Buy,2023-04-11 16:00:00,2023-04-11 20:00:00,2002.72,2006.04,1,332,87022.9,Exit After X Bars,,None,None,None,None
1776_240906003_B,184,XAUUSD,Buy,2023-04-20 12:00:00,2023-04-20 16:00:00,1996.61,2006.61,1,1000,88022.9,Exit After X Bars,,None,None,None,None
1778_240906003_B,184,XAUUSD,Buy,2023-04-25 00:00:00,2023-04-25 04:00:00,1997.74,1996.92,1,-82,87940.9,Exit After X Bars,,None,None,None,None
1781_240906003_B,184,XAUUSD,Buy,2023-05-01 12:00:00,2023-05-01 16:00:00,1994.8,2004.07,1,927,88867.9,Exit After X Bars,,None,None,None,None
1782_240906003_B,184,XAUUSD,Buy,2023-05-02 16:00:00,2023-05-02 20:00:00,2005.73,2015.04,1,931,89798.9,Exit After X Bars,,None,None,None,None
1785_240906003_B,184,XAUUSD,Buy,2023-05-09 12:00:00,2023-05-09 16:00:00,2029.18,2026.93,1,-225,89573.9,Exit After X Bars,,None,None,None,None
1786_240906003_B,184,XAUUSD,Buy,2023-05-10 12:00:00,2023-05-10 16:00:00,2037.98,2045.58,1,760,90333.9,Exit After X Bars,,None,None,None,None
1793_240906003_B,184,XAUUSD,Buy,2023-05-19 16:00:00,2023-05-19 20:00:00,1978.65,1978.26,1,-39,90294.9,Exit After X Bars,,None,None,None,None
1794_240906003_B,184,XAUUSD,Buy,2023-05-24 12:00:00,2023-05-24 16:00:00,1982.31,1979.84,1,-247,90047.9,Exit After X Bars,,None,None,None,None
1798_240906003_B,184,XAUUSD,Buy,2023-05-30 12:00:00,2023-05-30 16:00:00,1949.38,1956.33,1,695,90742.9,Exit After X Bars,,None,None,None,None
1800_240906003_B,184,XAUUSD,Buy,2023-06-08 16:00:00,2023-06-08 20:00:00,1970.0,1966.18,1,-382,90360.9,Exit After X Bars,,None,None,None,None
1802_240906003_B,184,XAUUSD,Buy,2023-06-16 04:00:00,2023-06-16 08:00:00,1960.13,1955.39,1,-474,89886.9,Exit After X Bars,,None,None,None,None
1807_240906003_B,184,XAUUSD,Buy,2023-06-23 16:00:00,2023-06-23 20:00:00,1930.77,1918.59,1,-1218,88668.9,Exit After X Bars,,None,None,None,None
1809_240906003_B,184,XAUUSD,Buy,2023-06-30 12:00:00,2023-06-30 16:00:00,1913.11,1910.94,1,-217,88451.9,Exit After X Bars,,None,None,None,None
1811_240906003_B,184,XAUUSD,Buy,2023-07-07 12:00:00,2023-07-07 16:00:00,1927.43,1918.66,1,-877,87574.9,Exit After X Bars,,None,None,None,None
1812_240906003_B,184,XAUUSD,Buy,2023-07-11 08:00:00,2023-07-11 12:00:00,1934.68,1936.49,1,181,87755.9,Exit After X Bars,,None,None,None,None
1813_240906003_B,184,XAUUSD,Buy,2023-07-18 08:00:00,2023-07-18 12:00:00,1962.45,1961.65,1,-80,87675.9,Exit After X Bars,,None,None,None,None
1817_240906003_B,184,XAUUSD,Buy,2023-07-26 08:00:00,2023-07-26 12:00:00,1967.57,1972.0,1,443,88118.9,Exit After X Bars,,None,None,None,None
1820_240906003_B,184,XAUUSD,Buy,2023-07-31 12:00:00,2023-07-31 16:00:00,1963.3,1965.36,1,206,88324.9,Exit After X Bars,,None,None,None,None
1824_240906003_B,184,XAUUSD,Buy,2023-08-04 12:00:00,2023-08-04 16:00:00,1938.55,1938.92,1,37,88361.9,Exit After X Bars,,None,None,None,None
1828_240906003_B,184,XAUUSD,Buy,2023-08-10 12:00:00,2023-08-10 16:00:00,1928.13,1926.09,1,-204,88157.9,Exit After X Bars,,None,None,None,None
1839_240906003_B,184,XAUUSD,Buy,2023-09-08 16:00:00,2023-09-08 20:00:00,1924.29,1919.53,1,-476,87681.9,Exit After X Bars,,None,None,None,None
1842_240906003_B,184,XAUUSD,Buy,2023-09-15 04:00:00,2023-09-15 08:00:00,1915.57,1916.0,1,43,87724.9,Exit After X Bars,,None,None,None,None
1844_240906003_B,184,XAUUSD,Buy,2023-09-22 20:00:00,2023-09-25 00:00:00,1925.95,1924.34,1,-161,87563.9,End Of Friday,,None,None,None,None
1849_240906003_B,184,XAUUSD,Buy,2023-09-29 16:00:00,2023-09-29 20:00:00,1879.34,1853.54,1,-2580,84983.9,Exit After X Bars,,None,None,None,None
1853_240906003_B,184,XAUUSD,Buy,2023-10-06 16:00:00,2023-10-06 20:00:00,1830.13,1829.1,1,-103,84880.9,Exit After X Bars,,None,None,None,None
1855_240906003_B,184,XAUUSD,Buy,2023-10-25 16:00:00,2023-10-25 20:00:00,1977.1,1978.15,1,105,84985.9,Exit After X Bars,,None,None,None,None
1856_240906003_B,184,XAUUSD,Buy,2023-10-26 20:00:00,2023-10-27 00:00:00,1986.77,1984.49,1,-228,84757.9,Exit After X Bars,,None,None,None,None
1857_240906003_B,184,XAUUSD,Buy,2023-10-27 20:00:00,2023-10-30 00:00:00,1991.74,2004.14,1,1240,85997.9,End Of Friday,,None,None,None,None
1859_240906003_B,184,XAUUSD,Buy,2023-10-31 16:00:00,2023-10-31 20:00:00,2002.16,1990.73,1,-1143,84854.9,Exit After X Bars,,None,None,None,None
1862_240906003_B,184,XAUUSD,Buy,2023-11-03 12:00:00,2023-11-03 16:00:00,1990.78,2000.05,1,927,85781.9,Exit After X Bars,,None,None,None,None
1869_240906003_B,184,XAUUSD,Buy,2023-11-14 12:00:00,2023-11-14 16:00:00,1948.97,1954.21,1,524,86305.9,Exit After X Bars,,None,None,None,None
1870_240906003_B,184,XAUUSD,Buy,2023-11-21 04:00:00,2023-11-21 08:00:00,1993.21,1991.69,1,-152,86153.9,Exit After X Bars,,None,None,None,None
1872_240906003_B,184,XAUUSD,Buy,2023-11-24 12:00:00,2023-11-24 16:00:00,1994.72,1999.55,1,483,86636.9,Exit After X Bars,,None,None,None,None
1873_240906003_B,184,XAUUSD,Buy,2023-12-01 08:00:00,2023-12-01 12:00:00,2049.23,2046.33,1,-290,86346.9,Exit After X Bars,,None,None,None,None
1876_240906003_B,184,XAUUSD,Buy,2023-12-06 12:00:00,2023-12-06 16:00:00,2030.58,2030.17,1,-41,86305.9,Exit After X Bars,,None,None,None,None
1877_240906003_B,184,XAUUSD,Buy,2023-12-08 00:00:00,2023-12-08 04:00:00,2032.75,2032.19,1,-56,86249.9,Exit After X Bars,,None,None,None,None
1879_240906003_B,184,XAUUSD,Buy,2023-12-12 12:00:00,2023-12-12 16:00:00,1996.48,1984.35,1,-1213,85036.9,Exit After X Bars,,None,None,None,None
1880_240906003_B,184,XAUUSD,Buy,2023-12-13 20:00:00,2023-12-14 00:00:00,1996.44,2025.95,1,2951,87987.9,Exit After X Bars,,None,None,None,None
1885_240906003_B,184,XAUUSD,Buy,2024-01-05 16:00:00,2024-01-05 20:00:00,2050.64,2041.84,1,-880,87107.9,Exit After X Bars,,None,None,None,None
1887_240906003_B,184,XAUUSD,Buy,2024-01-09 12:00:00,2024-01-09 16:00:00,2036.66,2038.49,1,183,87290.9,Exit After X Bars,,None,None,None,None
1888_240906003_B,184,XAUUSD,Buy,2024-01-11 12:00:00,2024-01-11 16:00:00,2041.78,2029.37,1,-1241,86049.9,Exit After X Bars,,None,None,None,None
1891_240906003_B,184,XAUUSD,Buy,2024-01-19 08:00:00,2024-01-19 12:00:00,2028.78,2029.64,1,86,86135.9,Exit After X Bars,,None,None,None,None
1896_240906003_B,184,XAUUSD,Buy,2024-02-06 12:00:00,2024-02-06 16:00:00,2028.43,2029.07,1,64,86199.9,Exit After X Bars,,None,None,None,None
1897_240906003_B,184,XAUUSD,Buy,2024-02-07 16:00:00,2024-02-07 20:00:00,2038.71,2035.56,1,-315,85884.9,Exit After X Bars,,None,None,None,None
1901_240906003_B,184,XAUUSD,Buy,2024-02-13 12:00:00,2024-02-13 16:00:00,2027.44,2004.31,1,-2313,83571.9,Exit After X Bars,,None,None,None,None
1903_240906003_B,184,XAUUSD,Buy,2024-02-23 16:00:00,2024-02-23 20:00:00,2031.05,2037.91,1,686,84257.9,Exit After X Bars,,None,None,None,None
1904_240906003_B,184,XAUUSD,Buy,2024-02-29 12:00:00,2024-02-29 16:00:00,2038.88,2047.56,1,868,85125.9,Exit After X Bars,,None,None,None,None
1908_240906003_B,184,XAUUSD,Buy,2024-03-15 12:00:00,2024-03-15 16:00:00,2171.55,2161.7,1,-985,84140.9,Exit After X Bars,,None,None,None,None
1911_240906003_B,184,XAUUSD,Buy,2024-03-20 16:00:00,2024-03-20 20:00:00,2159.35,2157.61,1,-174,83966.9,Exit After X Bars,,None,None,None,None
1913_240906003_B,184,XAUUSD,Buy,2024-03-25 16:00:00,2024-03-25 20:00:00,2179.94,2175.72,1,-422,83544.9,Exit After X Bars,,None,None,None,None
1914_240906003_B,184,XAUUSD,Buy,2024-03-26 12:00:00,2024-03-26 16:00:00,2181.12,2187.85,1,673,84217.9,Exit After X Bars,,None,None,None,None
1915_240906003_B,184,XAUUSD,Buy,2024-03-28 08:00:00,2024-03-28 12:00:00,2199.91,2194.65,1,-526,83691.9,Exit After X Bars,,None,None,None,None
1916_240906003_B,184,XAUUSD,Buy,2024-04-05 16:00:00,2024-04-05 20:00:00,2305.1,2327.17,1,2207,85898.9,Exit After X Bars,,None,None,None,None
1918_240906003_B,184,XAUUSD,Buy,2024-04-11 20:00:00,2024-04-12 00:00:00,2354.31,2371.5,1,1719,87617.9,Exit After X Bars,,None,None,None,None
1920_240906003_B,184,XAUUSD,Buy,2024-04-16 16:00:00,2024-04-16 20:00:00,2391.68,2397.41,1,573,88190.9,Exit After X Bars,,None,None,None,None
1922_240906003_B,184,XAUUSD,Buy,2024-04-19 04:00:00,2024-04-19 08:00:00,2395.17,2383.48,1,-1169,87021.9,Exit After X Bars,,None,None,None,None
1925_240906003_B,184,XAUUSD,Buy,2024-04-24 16:00:00,2024-04-24 20:00:00,2331.87,2324.97,1,-690,86331.9,Exit After X Bars,,None,None,None,None
1926_240906003_B,184,XAUUSD,Buy,2024-04-25 16:00:00,2024-04-25 20:00:00,2336.97,2328.62,1,-835,85496.9,Exit After X Bars,,None,None,None,None
1929_240906003_B,184,XAUUSD,Buy,2024-05-01 20:00:00,2024-05-02 00:00:00,2317.7,2319.3,1,160,85656.9,Exit After X Bars,,None,None,None,None
1932_240906003_B,184,XAUUSD,Buy,2024-05-09 12:00:00,2024-05-09 16:00:00,2323.38,2326.59,1,321,85977.9,Exit After X Bars,,None,None,None,None
1937_240906003_B,184,XAUUSD,Buy,2024-05-27 12:00:00,2024-05-27 16:00:00,2347.1,2347.06,1,-4,85973.9,Exit After X Bars,,None,None,None,None
1938_240906003_B,184,XAUUSD,Buy,2024-05-28 16:00:00,2024-05-28 20:00:00,2358.19,2356.51,1,-168,85805.9,Exit After X Bars,,None,None,None,None
1940_240906003_B,184,XAUUSD,Buy,2024-05-30 16:00:00,2024-05-30 20:00:00,2346.92,2347.76,1,84,85889.9,Exit After X Bars,,None,None,None,None
1941_240906003_B,184,XAUUSD,Buy,2024-05-31 12:00:00,2024-05-31 16:00:00,2351.5,2354.55,1,305,86194.9,Exit After X Bars,,None,None,None,None
1946_240906003_B,184,XAUUSD,Buy,2024-06-11 12:00:00,2024-06-11 16:00:00,2313.53,2317.84,1,431,86625.9,Exit After X Bars,,None,None,None,None
1947_240906003_B,184,XAUUSD,Buy,2024-06-12 12:00:00,2024-06-12 16:00:00,2319.74,2335.82,1,1608,88233.9,Exit After X Bars,,None,None,None,None
1949_240906003_B,184,XAUUSD,Buy,2024-06-14 12:00:00,2024-06-14 16:00:00,2326.36,2330.23,1,387,88620.9,Exit After X Bars,,None,None,None,None
1950_240906003_B,184,XAUUSD,Buy,2024-06-18 16:00:00,2024-06-18 20:00:00,2327.37,2330.19,1,282,88902.9,Exit After X Bars,,None,None,None,None
1952_240906003_B,184,XAUUSD,Buy,2024-06-25 12:00:00,2024-06-25 16:00:00,2334.47,2324.05,1,-1042,87860.9,Exit After X Bars,,None,None,None,None
1954_240906003_B,184,XAUUSD,Buy,2024-06-27 12:00:00,2024-06-27 16:00:00,2318.19,2322.74,1,455,88315.9,Exit After X Bars,,None,None,None,None
1958_240906003_B,184,XAUUSD,Buy,2024-07-23 12:00:00,2024-07-23 16:00:00,2408.06,2405.27,1,-279,88036.9,Exit After X Bars,,None,None,None,None
1959_240906003_B,184,XAUUSD,Buy,2024-07-24 12:00:00,2024-07-24 16:00:00,2411.71,2421.36,1,965,89001.9,Exit After X Bars,,None,None,None,None
1961_240906003_B,184,XAUUSD,Buy,2024-07-26 16:00:00,2024-07-26 20:00:00,2382.29,2389.07,1,678,89679.9,Exit After X Bars,,None,None,None,None
1962_240906003_B,184,XAUUSD,Buy,2024-07-30 16:00:00,2024-07-30 20:00:00,2396.41,2399.83,1,342,90021.9,Exit After X Bars,,None,None,None,None
1966_240906003_B,184,XAUUSD,Buy,2024-08-08 12:00:00,2024-08-08 16:00:00,2406.71,2407.93,1,122,90143.9,Exit After X Bars,,None,None,None,None
1968_240906003_B,184,XAUUSD,Buy,2024-08-16 12:00:00,2024-08-16 16:00:00,2469.78,2491.56,1,2178,92321.9,Exit After X Bars,,None,None,None,None
1971_240906003_B,184,XAUUSD,Buy,2024-08-23 16:00:00,2024-08-23 20:00:00,2508.76,2510.2,1,144,92465.9,Exit After X Bars,,None,None,None,None
1972_240906003_B,184,XAUUSD,Buy,2024-08-28 00:00:00,2024-08-28 04:00:00,2526.51,2524.28,1,-223,92242.9,Exit After X Bars,,None,None,None,None
1973_240906003_B,184,XAUUSD,Buy,2024-08-29 16:00:00,2024-08-29 20:00:00,2515.01,2525.14,1,1013,93255.9,Exit After X Bars,,None,None,None,None
