orderId,strategyRunId,symbol,orderType,openTime,closeTime,openPrice,closePrice,size,profit,balance,closeType,comment,sl,tp,swap,commission
4_240906002_B,183,XAUUSD,Buy,2011-01-07 16:00:00,2011-01-07 20:00:00,1376.84,1367.74,1,-910,9090,Exit After X Bars,,None,None,None,None
6_240906002_B,183,XAUUSD,Buy,2011-01-18 08:00:00,2011-01-18 12:00:00,1370.07,1370.18,1,11,9101,Exit After X Bars,,None,None,None,None
11_240906002_B,183,XAUUSD,Buy,2011-01-26 20:00:00,2011-01-27 00:00:00,1334.96,1345.98,1,1102,10203,Exit After X Bars,,None,None,None,None
13_240906002_B,183,XAUUSD,Buy,2011-01-28 16:00:00,2011-01-28 20:00:00,1340.66,1343.01,1,235,10438,Exit After X Bars,,None,None,None,None
16_240906002_B,183,XAUUSD,Buy,2011-02-03 16:00:00,2011-02-03 20:00:00,1339.37,1353.88,1,1451,11889,Exit After X Bars,,None,None,None,None
17_240906002_B,183,XAUUSD,Buy,2011-02-11 12:00:00,2011-02-11 16:00:00,1366.79,1365.53,1,-126,11763,Exit After X Bars,,None,None,None,None
18_240906002_B,183,XAUUSD,Buy,2011-02-15 08:00:00,2011-02-15 12:00:00,1368.26,1371.67,1,341,12104,Exit After X Bars,,None,None,None,None
19_240906002_B,183,XAUUSD,Buy,2011-02-23 16:00:00,2011-02-23 20:00:00,1410.58,1415.25,1,467,12571,Exit After X Bars,,None,None,None,None
22_240906002_B,183,XAUUSD,Buy,2011-03-04 16:00:00,2011-03-04 20:00:00,1431.86,1427.88,1,-398,12173,Exit After X Bars,,None,None,None,None
29_240906002_B,183,XAUUSD,Buy,2011-03-18 00:00:00,2011-03-18 04:00:00,1405.89,1406.99,1,110,12283,Exit After X Bars,,None,None,None,None
30_240906002_B,183,XAUUSD,Buy,2011-03-23 16:00:00,2011-03-23 20:00:00,1434.68,1439.58,1,490,12773,Exit After X Bars,,None,None,None,None
33_240906002_B,183,XAUUSD,Buy,2011-03-29 16:00:00,2011-03-29 20:00:00,1423.14,1416.52,1,-662,12111,Exit After X Bars,,None,None,None,None
36_240906002_B,183,XAUUSD,Buy,2011-04-14 16:00:00,2011-04-14 20:00:00,1466.91,1471.83,1,492,12603,Exit After X Bars,,None,None,None,None
37_240906002_B,183,XAUUSD,Buy,2011-04-27 20:00:00,2011-04-28 00:00:00,1518.01,1526.72,1,871,13474,Exit After X Bars,,None,None,None,None
47_240906002_B,183,XAUUSD,Buy,2011-05-20 08:00:00,2011-05-20 12:00:00,1499.72,1502.02,1,230,13704,Exit After X Bars,,None,None,None,None
48_240906002_B,183,XAUUSD,Buy,2011-05-27 16:00:00,2011-05-27 20:00:00,1532.05,1537.36,1,531,14235,Exit After X Bars,,None,None,None,None
49_240906002_B,183,XAUUSD,Buy,2011-06-01 16:00:00,2011-06-01 20:00:00,1540.64,1545.4,1,476,14711,Exit After X Bars,,None,None,None,None
51_240906002_B,183,XAUUSD,Buy,2011-06-03 16:00:00,2011-06-03 20:00:00,1544.33,1541.86,1,-247,14464,Exit After X Bars,,None,None,None,None
53_240906002_B,183,XAUUSD,Buy,2011-06-09 16:00:00,2011-06-09 20:00:00,1542.95,1544.6,1,165,14629,Exit After X Bars,,None,None,None,None
57_240906002_B,183,XAUUSD,Buy,2011-06-15 16:00:00,2011-06-15 20:00:00,1527.16,1524.58,1,-258,14371,Exit After X Bars,,None,None,None,None
58_240906002_B,183,XAUUSD,Buy,2011-06-17 16:00:00,2011-06-17 20:00:00,1532.78,1534.88,1,210,14581,Exit After X Bars,,None,None,None,None
62_240906002_B,183,XAUUSD,Buy,2011-06-28 12:00:00,2011-06-28 16:00:00,1503.07,1500.35,1,-272,14309,Exit After X Bars,,None,None,None,None
65_240906002_B,183,XAUUSD,Buy,2011-07-04 16:00:00,2011-07-04 20:00:00,1494.69,1495.57,1,88,14397,Exit After X Bars,,None,None,None,None
68_240906002_B,183,XAUUSD,Buy,2011-07-22 12:00:00,2011-07-22 16:00:00,1601.9,1602.23,1,33,14430,Exit After X Bars,,None,None,None,None
71_240906002_B,183,XAUUSD,Buy,2011-07-29 12:00:00,2011-07-29 16:00:00,1619.86,1623.19,1,333,14763,Exit After X Bars,,None,None,None,None
75_240906002_B,183,XAUUSD,Buy,2011-08-15 20:00:00,2011-08-16 00:00:00,1763.68,1765.36,1,168,14931,Exit After X Bars,,None,None,None,None
81_240906002_B,183,XAUUSD,Buy,2011-09-08 12:00:00,2011-09-08 16:00:00,1846.46,1858.15,1,1169,16100,Exit After X Bars,,None,None,None,None
87_240906002_B,183,XAUUSD,Buy,2011-09-16 16:00:00,2011-09-16 20:00:00,1815.34,1813.72,1,-162,15938,Exit After X Bars,,None,None,None,None
95_240906002_B,183,XAUUSD,Buy,2011-09-30 16:00:00,2011-09-30 20:00:00,1630.06,1628.65,1,-141,15797,Exit After X Bars,,None,None,None,None
104_240906002_B,183,XAUUSD,Buy,2011-10-21 12:00:00,2011-10-21 16:00:00,1630.14,1642.71,1,1257,17054,Exit After X Bars,,None,None,None,None
106_240906002_B,183,XAUUSD,Buy,2011-11-02 04:00:00,2011-11-02 08:00:00,1727.35,1721.86,1,-549,16505,Exit After X Bars,,None,None,None,None
108_240906002_B,183,XAUUSD,Buy,2011-11-11 16:00:00,2011-11-11 20:00:00,1775.12,1786.78,1,1166,17671,Exit After X Bars,,None,None,None,None
117_240906002_B,183,XAUUSD,Buy,2011-11-30 12:00:00,2011-11-30 16:00:00,1726.34,1744.48,1,1814,19485,Exit After X Bars,,None,None,None,None
120_240906002_B,183,XAUUSD,Buy,2011-12-07 12:00:00,2011-12-07 16:00:00,1732.8,1733.37,1,57,19542,Exit After X Bars,,None,None,None,None
127_240906002_B,183,XAUUSD,Buy,2011-12-16 16:00:00,2011-12-16 20:00:00,1593.36,1593.08,1,-28,19514,Exit After X Bars,,None,None,None,None
134_240906002_B,183,XAUUSD,Buy,2012-01-10 12:00:00,2012-01-10 16:00:00,1630.63,1636.35,1,572,20086,Exit After X Bars,,None,None,None,None
136_240906002_B,183,XAUUSD,Buy,2012-01-19 08:00:00,2012-01-19 12:00:00,1666.63,1665.42,1,-121,19965,Exit After X Bars,,None,None,None,None
137_240906002_B,183,XAUUSD,Buy,2012-01-20 16:00:00,2012-01-20 20:00:00,1665.61,1663.26,1,-235,19730,Exit After X Bars,,None,None,None,None
139_240906002_B,183,XAUUSD,Buy,2012-01-25 16:00:00,2012-01-25 20:00:00,1670.78,1689.7,1,1892,21622,Exit After X Bars,,None,None,None,None
142_240906002_B,183,XAUUSD,Buy,2012-02-07 16:00:00,2012-02-07 20:00:00,1725.08,1746.27,1,2119,23741,Exit After X Bars,,None,None,None,None
144_240906002_B,183,XAUUSD,Buy,2012-02-13 16:00:00,2012-02-13 20:00:00,1724.19,1723.02,1,-117,23624,Exit After X Bars,,None,None,None,None
145_240906002_B,183,XAUUSD,Buy,2012-02-15 12:00:00,2012-02-15 16:00:00,1732.41,1730.85,1,-156,23468,Exit After X Bars,,None,None,None,None
148_240906002_B,183,XAUUSD,Buy,2012-02-28 12:00:00,2012-02-28 16:00:00,1782.27,1780.06,1,-221,23247,Exit After X Bars,,None,None,None,None
154_240906002_B,183,XAUUSD,Buy,2012-03-08 08:00:00,2012-03-08 12:00:00,1692.68,1701.02,1,834,24081,Exit After X Bars,,None,None,None,None
155_240906002_B,183,XAUUSD,Buy,2012-03-09 16:00:00,2012-03-09 20:00:00,1703.71,1711.65,1,794,24875,Exit After X Bars,,None,None,None,None
162_240906002_B,183,XAUUSD,Buy,2012-03-21 16:00:00,2012-03-21 20:00:00,1657.76,1650.22,1,-754,24121,Exit After X Bars,,None,None,None,None
163_240906002_B,183,XAUUSD,Buy,2012-03-23 16:00:00,2012-03-23 20:00:00,1661.73,1662.57,1,84,24205,Exit After X Bars,,None,None,None,None
166_240906002_B,183,XAUUSD,Buy,2012-03-30 12:00:00,2012-03-30 16:00:00,1663.64,1665.58,1,194,24399,Exit After X Bars,,None,None,None,None
169_240906002_B,183,XAUUSD,Buy,2012-04-06 12:00:00,2012-04-06 16:00:00,1633.25,1641.71,1,846,25245,Exit After X Bars,,None,None,None,None
173_240906002_B,183,XAUUSD,Buy,2012-04-19 16:00:00,2012-04-19 20:00:00,1648.76,1639.67,1,-909,24336,Exit After X Bars,,None,None,None,None
176_240906002_B,183,XAUUSD,Buy,2012-04-24 12:00:00,2012-04-24 16:00:00,1639.07,1642.25,1,318,24654,Exit After X Bars,,None,None,None,None
177_240906002_B,183,XAUUSD,Buy,2012-04-26 08:00:00,2012-04-26 12:00:00,1649.13,1648.76,1,-37,24617,Exit After X Bars,,None,None,None,None
178_240906002_B,183,XAUUSD,Buy,2012-05-01 00:00:00,2012-05-01 04:00:00,1667.27,1665.58,1,-169,24448,Exit After X Bars,,None,None,None,None
185_240906002_B,183,XAUUSD,Buy,2012-05-10 16:00:00,2012-05-10 20:00:00,1595.7,1595.78,1,8,24456,Exit After X Bars,,None,None,None,None
189_240906002_B,183,XAUUSD,Buy,2012-05-17 16:00:00,2012-05-17 20:00:00,1563.84,1576.13,1,1229,25685,Exit After X Bars,,None,None,None,None
192_240906002_B,183,XAUUSD,Buy,2012-05-24 12:00:00,2012-05-24 16:00:00,1564.44,1575.66,1,1122,26807,Exit After X Bars,,None,None,None,None
195_240906002_B,183,XAUUSD,Buy,2012-06-01 12:00:00,2012-06-01 16:00:00,1573.25,1581.44,1,819,27626,Exit After X Bars,,None,None,None,None
198_240906002_B,183,XAUUSD,Buy,2012-06-11 12:00:00,2012-06-11 16:00:00,1594.83,1593.62,1,-121,27505,Exit After X Bars,,None,None,None,None
199_240906002_B,183,XAUUSD,Buy,2012-06-19 08:00:00,2012-06-19 12:00:00,1632.33,1629.85,1,-248,27257,Exit After X Bars,,None,None,None,None
203_240906002_B,183,XAUUSD,Buy,2012-06-25 16:00:00,2012-06-25 20:00:00,1573.15,1583.29,1,1014,28271,Exit After X Bars,,None,None,None,None
206_240906002_B,183,XAUUSD,Buy,2012-06-29 12:00:00,2012-06-29 16:00:00,1582.86,1597.36,1,1450,29721,Exit After X Bars,,None,None,None,None
210_240906002_B,183,XAUUSD,Buy,2012-07-10 12:00:00,2012-07-10 16:00:00,1592.73,1600.83,1,810,30531,Exit After X Bars,,None,None,None,None
212_240906002_B,183,XAUUSD,Buy,2012-07-13 12:00:00,2012-07-13 16:00:00,1581.21,1582.39,1,118,30649,Exit After X Bars,,None,None,None,None
214_240906002_B,183,XAUUSD,Buy,2012-07-19 12:00:00,2012-07-19 16:00:00,1583.07,1584.15,1,108,30757,Exit After X Bars,,None,None,None,None
217_240906002_B,183,XAUUSD,Buy,2012-07-24 16:00:00,2012-07-24 20:00:00,1580.29,1575.79,1,-450,30307,Exit After X Bars,,None,None,None,None
223_240906002_B,183,XAUUSD,Buy,2012-08-10 16:00:00,2012-08-10 20:00:00,1618.28,1621.52,1,324,30631,Exit After X Bars,,None,None,None,None
225_240906002_B,183,XAUUSD,Buy,2012-08-16 16:00:00,2012-08-16 20:00:00,1615.41,1615.3,1,-11,30620,Exit After X Bars,,None,None,None,None
229_240906002_B,183,XAUUSD,Buy,2012-08-31 16:00:00,2012-08-31 20:00:00,1664.02,1681.56,1,1754,32374,Exit After X Bars,,None,None,None,None
230_240906002_B,183,XAUUSD,Buy,2012-09-06 08:00:00,2012-09-06 12:00:00,1698.78,1709.11,1,1033,33407,Exit After X Bars,,None,None,None,None
232_240906002_B,183,XAUUSD,Buy,2012-09-13 16:00:00,2012-09-13 20:00:00,1745.43,1752.67,1,724,34131,Exit After X Bars,,None,None,None,None
233_240906002_B,183,XAUUSD,Buy,2012-09-18 16:00:00,2012-09-18 20:00:00,1773.1,1766.65,1,-645,33486,Exit After X Bars,,None,None,None,None
234_240906002_B,183,XAUUSD,Buy,2012-09-21 12:00:00,2012-09-21 16:00:00,1775.58,1786.55,1,1097,34583,Exit After X Bars,,None,None,None,None
238_240906002_B,183,XAUUSD,Buy,2012-09-27 12:00:00,2012-09-27 16:00:00,1765.49,1764.21,1,-128,34455,Exit After X Bars,,None,None,None,None
241_240906002_B,183,XAUUSD,Buy,2012-10-09 12:00:00,2012-10-09 16:00:00,1777.99,1774.13,1,-386,34069,Exit After X Bars,,None,None,None,None
245_240906002_B,183,XAUUSD,Buy,2012-10-17 00:00:00,2012-10-17 04:00:00,1748.66,1750.45,1,179,34248,Exit After X Bars,,None,None,None,None
251_240906002_B,183,XAUUSD,Buy,2012-10-26 16:00:00,2012-10-26 20:00:00,1717.83,1712.97,1,-486,33762,Exit After X Bars,,None,None,None,None
252_240906002_B,183,XAUUSD,Buy,2012-10-31 12:00:00,2012-10-31 16:00:00,1718.26,1717.66,1,-60,33702,Exit After X Bars,,None,None,None,None
257_240906002_B,183,XAUUSD,Buy,2012-11-14 16:00:00,2012-11-14 20:00:00,1732.9,1729.65,1,-325,33377,Exit After X Bars,,None,None,None,None
260_240906002_B,183,XAUUSD,Buy,2012-11-23 16:00:00,2012-11-23 20:00:00,1735.5,1750.79,1,1529,34906,Exit After X Bars,,None,None,None,None
264_240906002_B,183,XAUUSD,Buy,2012-11-30 12:00:00,2012-11-30 16:00:00,1728.28,1723.27,1,-501,34405,Exit After X Bars,,None,None,None,None
271_240906002_B,183,XAUUSD,Buy,2012-12-17 16:00:00,2012-12-17 20:00:00,1699.1,1696.31,1,-279,34126,Exit After X Bars,,None,None,None,None
280_240906002_B,183,XAUUSD,Buy,2013-01-07 12:00:00,2013-01-07 16:00:00,1658.55,1646.09,1,-1246,32880,Exit After X Bars,,None,None,None,None
281_240906002_B,183,XAUUSD,Buy,2013-01-10 08:00:00,2013-01-10 12:00:00,1662.43,1662.25,1,-18,32862,Exit After X Bars,,None,None,None,None
283_240906002_B,183,XAUUSD,Buy,2013-01-15 08:00:00,2013-01-15 12:00:00,1676.77,1681.15,1,438,33300,Exit After X Bars,,None,None,None,None
284_240906002_B,183,XAUUSD,Buy,2013-01-17 16:00:00,2013-01-17 20:00:00,1683.57,1694.35,1,1078,34378,Exit After X Bars,,None,None,None,None
285_240906002_B,183,XAUUSD,Buy,2013-01-22 16:00:00,2013-01-22 20:00:00,1695.14,1694.39,1,-75,34303,Exit After X Bars,,None,None,None,None
289_240906002_B,183,XAUUSD,Buy,2013-01-30 12:00:00,2013-01-30 16:00:00,1671.2,1675.33,1,413,34716,Exit After X Bars,,None,None,None,None
291_240906002_B,183,XAUUSD,Buy,2013-02-01 16:00:00,2013-02-01 20:00:00,1677.19,1671.47,1,-572,34144,Exit After X Bars,,None,None,None,None
292_240906002_B,183,XAUUSD,Buy,2013-02-05 12:00:00,2013-02-05 16:00:00,1682.01,1682.95,1,94,34238,Exit After X Bars,,None,None,None,None
297_240906002_B,183,XAUUSD,Buy,2013-02-13 12:00:00,2013-02-13 16:00:00,1653.26,1651.73,1,-153,34085,Exit After X Bars,,None,None,None,None
318_240906002_B,183,XAUUSD,Buy,2013-03-27 16:00:00,2013-03-27 20:00:00,1600.89,1605.55,1,466,34551,Exit After X Bars,,None,None,None,None
324_240906002_B,183,XAUUSD,Buy,2013-04-05 12:00:00,2013-04-05 16:00:00,1556.61,1568.42,1,1181,35732,Exit After X Bars,,None,None,None,None
330_240906002_B,183,XAUUSD,Buy,2013-04-19 08:00:00,2013-04-19 12:00:00,1402.56,1416.26,1,1370,37102,Exit After X Bars,,None,None,None,None
331_240906002_B,183,XAUUSD,Buy,2013-04-25 04:00:00,2013-04-25 08:00:00,1438.55,1446.95,1,840,37942,Exit After X Bars,,None,None,None,None
333_240906002_B,183,XAUUSD,Buy,2013-05-02 16:00:00,2013-05-02 20:00:00,1472.02,1468.85,1,-317,37625,Exit After X Bars,,None,None,None,None
335_240906002_B,183,XAUUSD,Buy,2013-05-08 12:00:00,2013-05-08 16:00:00,1465.49,1466.24,1,75,37700,Exit After X Bars,,None,None,None,None
342_240906002_B,183,XAUUSD,Buy,2013-05-20 16:00:00,2013-05-20 20:00:00,1383.43,1384.75,1,132,37832,Exit After X Bars,,None,None,None,None
343_240906002_B,183,XAUUSD,Buy,2013-05-23 08:00:00,2013-05-23 12:00:00,1385.26,1390.09,1,483,38315,Exit After X Bars,,None,None,None,None
344_240906002_B,183,XAUUSD,Buy,2013-05-28 16:00:00,2013-05-28 20:00:00,1396.44,1386.04,1,-1040,37275,Exit After X Bars,,None,None,None,None
345_240906002_B,183,XAUUSD,Buy,2013-05-30 08:00:00,2013-05-30 12:00:00,1401.09,1406.81,1,572,37847,Exit After X Bars,,None,None,None,None
347_240906002_B,183,XAUUSD,Buy,2013-06-03 16:00:00,2013-06-03 20:00:00,1415.69,1412.84,1,-285,37562,Exit After X Bars,,None,None,None,None
349_240906002_B,183,XAUUSD,Buy,2013-06-05 12:00:00,2013-06-05 16:00:00,1406.66,1401.81,1,-485,37077,Exit After X Bars,,None,None,None,None
350_240906002_B,183,XAUUSD,Buy,2013-06-06 16:00:00,2013-06-06 20:00:00,1410.42,1416.45,1,603,37680,Exit After X Bars,,None,None,None,None
354_240906002_B,183,XAUUSD,Buy,2013-06-12 16:00:00,2013-06-12 20:00:00,1380.78,1390.86,1,1008,38688,Exit After X Bars,,None,None,None,None
368_240906002_B,183,XAUUSD,Buy,2013-07-09 04:00:00,2013-07-09 08:00:00,1243.07,1254.4,1,1133,39821,Exit After X Bars,,None,None,None,None
374_240906002_B,183,XAUUSD,Buy,2013-07-31 04:00:00,2013-07-31 08:00:00,1338.11,1333.29,1,-482,39339,Exit After X Bars,,None,None,None,None
379_240906002_B,183,XAUUSD,Buy,2013-08-08 08:00:00,2013-08-08 12:00:00,1296.59,1289.08,1,-751,38588,Exit After X Bars,,None,None,None,None
381_240906002_B,183,XAUUSD,Buy,2013-08-14 20:00:00,2013-08-15 00:00:00,1336.13,1335.72,1,-41,38547,Exit After X Bars,,None,None,None,None
382_240906002_B,183,XAUUSD,Buy,2013-08-15 16:00:00,2013-08-15 20:00:00,1346.13,1358.25,1,1212,39759,Exit After X Bars,,None,None,None,None
385_240906002_B,183,XAUUSD,Buy,2013-08-21 20:00:00,2013-08-22 00:00:00,1377.3,1366.09,1,-1121,38638,Exit After X Bars,,None,None,None,None
389_240906002_B,183,XAUUSD,Buy,2013-09-03 12:00:00,2013-09-03 16:00:00,1395.03,1398.01,1,298,38936,Exit After X Bars,,None,None,None,None
399_240906002_B,183,XAUUSD,Buy,2013-09-18 20:00:00,2013-09-19 00:00:00,1323.32,1362.63,1,3931,42867,Exit After X Bars,,None,None,None,None
402_240906002_B,183,XAUUSD,Buy,2013-09-25 16:00:00,2013-09-25 20:00:00,1329.98,1337.14,1,716,43583,Exit After X Bars,,None,None,None,None
404_240906002_B,183,XAUUSD,Buy,2013-09-27 12:00:00,2013-09-27 16:00:00,1337.95,1335.57,1,-238,43345,Exit After X Bars,,None,None,None,None
408_240906002_B,183,XAUUSD,Buy,2013-10-04 12:00:00,2013-10-04 16:00:00,1323.65,1317.36,1,-629,42716,Exit After X Bars,,None,None,None,None
413_240906002_B,183,XAUUSD,Buy,2013-10-17 08:00:00,2013-10-17 12:00:00,1289.72,1305.41,1,1569,44285,Exit After X Bars,,None,None,None,None
414_240906002_B,183,XAUUSD,Buy,2013-10-22 12:00:00,2013-10-22 16:00:00,1319.6,1328.04,1,844,45129,Exit After X Bars,,None,None,None,None
416_240906002_B,183,XAUUSD,Buy,2013-10-30 12:00:00,2013-10-30 16:00:00,1352.8,1354.15,1,135,45264,Exit After X Bars,,None,None,None,None
420_240906002_B,183,XAUUSD,Buy,2013-11-07 12:00:00,2013-11-07 16:00:00,1322.34,1303.74,1,-1860,43404,Exit After X Bars,,None,None,None,None
424_240906002_B,183,XAUUSD,Buy,2013-11-14 00:00:00,2013-11-14 04:00:00,1285.15,1282.24,1,-291,43113,Exit After X Bars,,None,None,None,None
430_240906002_B,183,XAUUSD,Buy,2013-11-25 20:00:00,2013-11-26 00:00:00,1248.76,1251.21,1,245,43358,Exit After X Bars,,None,None,None,None
433_240906002_B,183,XAUUSD,Buy,2013-11-29 16:00:00,2013-11-29 20:00:00,1254.52,1251.04,1,-348,43010,Exit After X Bars,,None,None,None,None
436_240906002_B,183,XAUUSD,Buy,2013-12-04 12:00:00,2013-12-04 16:00:00,1226.03,1225.9,1,-13,42997,Exit After X Bars,,None,None,None,None
438_240906002_B,183,XAUUSD,Buy,2013-12-10 08:00:00,2013-12-10 12:00:00,1244.16,1242.99,1,-117,42880,Exit After X Bars,,None,None,None,None
441_240906002_B,183,XAUUSD,Buy,2013-12-16 16:00:00,2013-12-16 20:00:00,1238.48,1246.12,1,764,43644,Exit After X Bars,,None,None,None,None
443_240906002_B,183,XAUUSD,Buy,2013-12-18 20:00:00,2013-12-19 00:00:00,1242.91,1218.09,1,-2482,41162,Exit After X Bars,,None,None,None,None
446_240906002_B,183,XAUUSD,Buy,2013-12-26 12:00:00,2013-12-26 16:00:00,1207.32,1212.34,1,502,41664,Exit After X Bars,,None,None,None,None
448_240906002_B,183,XAUUSD,Buy,2013-12-31 16:00:00,2013-12-31 20:00:00,1208.4,1204.8,1,-360,41304,Exit After X Bars,,None,None,None,None
451_240906002_B,183,XAUUSD,Buy,2014-01-10 04:00:00,2014-01-10 08:00:00,1231.72,1236.55,1,483,41787,Exit After X Bars,,None,None,None,None
454_240906002_B,183,XAUUSD,Buy,2014-01-16 16:00:00,2014-01-16 20:00:00,1242.39,1241.14,1,-125,41662,Exit After X Bars,,None,None,None,None
456_240906002_B,183,XAUUSD,Buy,2014-01-23 12:00:00,2014-01-23 16:00:00,1248.9,1255.97,1,707,42369,Exit After X Bars,,None,None,None,None
458_240906002_B,183,XAUUSD,Buy,2014-01-29 12:00:00,2014-01-29 16:00:00,1261.31,1266.85,1,554,42923,Exit After X Bars,,None,None,None,None
461_240906002_B,183,XAUUSD,Buy,2014-02-03 16:00:00,2014-02-03 20:00:00,1254.81,1259.36,1,455,43378,Exit After X Bars,,None,None,None,None
464_240906002_B,183,XAUUSD,Buy,2014-02-20 20:00:00,2014-02-21 00:00:00,1321.85,1322.82,1,97,43475,Exit After X Bars,,None,None,None,None
469_240906002_B,183,XAUUSD,Buy,2014-03-05 16:00:00,2014-03-05 20:00:00,1340.57,1341.02,1,45,43520,Exit After X Bars,,None,None,None,None
470_240906002_B,183,XAUUSD,Buy,2014-03-06 16:00:00,2014-03-06 20:00:00,1341.73,1348.87,1,714,44234,Exit After X Bars,,None,None,None,None
472_240906002_B,183,XAUUSD,Buy,2014-03-12 04:00:00,2014-03-12 08:00:00,1352.81,1357.11,1,430,44664,Exit After X Bars,,None,None,None,None
484_240906002_B,183,XAUUSD,Buy,2014-04-02 12:00:00,2014-04-02 16:00:00,1287.71,1291.57,1,386,45050,Exit After X Bars,,None,None,None,None
485_240906002_B,183,XAUUSD,Buy,2014-04-04 12:00:00,2014-04-04 16:00:00,1294.41,1299.0,1,459,45509,Exit After X Bars,,None,None,None,None
486_240906002_B,183,XAUUSD,Buy,2014-04-09 20:00:00,2014-04-10 00:00:00,1314.23,1311.64,1,-259,45250,Exit After X Bars,,None,None,None,None
493_240906002_B,183,XAUUSD,Buy,2014-04-24 16:00:00,2014-04-24 20:00:00,1288.81,1289.87,1,106,45356,Exit After X Bars,,None,None,None,None
498_240906002_B,183,XAUUSD,Buy,2014-05-02 16:00:00,2014-05-02 20:00:00,1288.72,1298.41,1,969,46325,Exit After X Bars,,None,None,None,None
506_240906002_B,183,XAUUSD,Buy,2014-05-22 12:00:00,2014-05-22 16:00:00,1296.79,1300.41,1,362,46687,Exit After X Bars,,None,None,None,None
516_240906002_B,183,XAUUSD,Buy,2014-06-05 12:00:00,2014-06-05 16:00:00,1248.88,1254.85,1,597,47284,Exit After X Bars,,None,None,None,None
518_240906002_B,183,XAUUSD,Buy,2014-06-18 12:00:00,2014-06-18 16:00:00,1272.27,1271.69,1,-58,47226,Exit After X Bars,,None,None,None,None
521_240906002_B,183,XAUUSD,Buy,2014-06-30 20:00:00,2014-07-01 00:00:00,1320.88,1327.15,1,627,47853,Exit After X Bars,,None,None,None,None
524_240906002_B,183,XAUUSD,Buy,2014-07-08 12:00:00,2014-07-08 16:00:00,1322.08,1321.99,1,-9,47844,Exit After X Bars,,None,None,None,None
527_240906002_B,183,XAUUSD,Buy,2014-07-17 16:00:00,2014-07-17 20:00:00,1313.58,1317.39,1,381,48225,Exit After X Bars,,None,None,None,None
531_240906002_B,183,XAUUSD,Buy,2014-07-25 20:00:00,2014-07-28 00:00:00,1301.19,1307.57,1,638,48863,End Of Friday,,None,None,None,None
537_240906002_B,183,XAUUSD,Buy,2014-08-06 12:00:00,2014-08-06 16:00:00,1294.8,1302.07,1,727,49590,Exit After X Bars,,None,None,None,None
538_240906002_B,183,XAUUSD,Buy,2014-08-14 12:00:00,2014-08-14 16:00:00,1319.0,1314.57,1,-443,49147,Exit After X Bars,,None,None,None,None
545_240906002_B,183,XAUUSD,Buy,2014-08-26 04:00:00,2014-08-26 08:00:00,1282.72,1282.24,1,-48,49099,Exit After X Bars,,None,None,None,None
550_240906002_B,183,XAUUSD,Buy,2014-09-04 16:00:00,2014-09-04 20:00:00,1271.4,1266.49,1,-491,48608,Exit After X Bars,,None,None,None,None
557_240906002_B,183,XAUUSD,Buy,2014-09-16 08:00:00,2014-09-16 12:00:00,1238.95,1239.76,1,81,48689,Exit After X Bars,,None,None,None,None
560_240906002_B,183,XAUUSD,Buy,2014-09-23 08:00:00,2014-09-23 12:00:00,1225.63,1223.54,1,-209,48480,Exit After X Bars,,None,None,None,None
562_240906002_B,183,XAUUSD,Buy,2014-09-26 04:00:00,2014-09-26 08:00:00,1225.92,1222.61,1,-331,48149,Exit After X Bars,,None,None,None,None
564_240906002_B,183,XAUUSD,Buy,2014-10-02 04:00:00,2014-10-02 08:00:00,1220.03,1219.5,1,-53,48096,Exit After X Bars,,None,None,None,None
566_240906002_B,183,XAUUSD,Buy,2014-10-07 08:00:00,2014-10-07 12:00:00,1209.24,1208.79,1,-45,48051,Exit After X Bars,,None,None,None,None
567_240906002_B,183,XAUUSD,Buy,2014-10-15 12:00:00,2014-10-15 16:00:00,1238.03,1236.12,1,-191,47860,Exit After X Bars,,None,None,None,None
572_240906002_B,183,XAUUSD,Buy,2014-10-28 12:00:00,2014-10-28 16:00:00,1231.7,1232.63,1,93,47953,Exit After X Bars,,None,None,None,None
577_240906002_B,183,XAUUSD,Buy,2014-11-04 12:00:00,2014-11-04 16:00:00,1173.48,1169.24,1,-424,47529,Exit After X Bars,,None,None,None,None
580_240906002_B,183,XAUUSD,Buy,2014-11-07 12:00:00,2014-11-07 16:00:00,1149.18,1148.58,1,-60,47469,Exit After X Bars,,None,None,None,None
581_240906002_B,183,XAUUSD,Buy,2014-11-11 20:00:00,2014-11-12 00:00:00,1172.08,1164.0,1,-808,46661,Exit After X Bars,,None,None,None,None
582_240906002_B,183,XAUUSD,Buy,2014-11-14 16:00:00,2014-11-14 20:00:00,1167.75,1188.32,1,2057,48718,Exit After X Bars,,None,None,None,None
583_240906002_B,183,XAUUSD,Buy,2014-11-25 16:00:00,2014-11-25 20:00:00,1200.2,1196.17,1,-403,48315,Exit After X Bars,,None,None,None,None
587_240906002_B,183,XAUUSD,Buy,2014-12-01 16:00:00,2014-12-01 20:00:00,1189.15,1215.34,1,2619,50934,Exit After X Bars,,None,None,None,None
589_240906002_B,183,XAUUSD,Buy,2014-12-08 20:00:00,2014-12-09 00:00:00,1207.31,1202.88,1,-443,50491,Exit After X Bars,,None,None,None,None
593_240906002_B,183,XAUUSD,Buy,2014-12-16 12:00:00,2014-12-16 16:00:00,1216.99,1211.4,1,-559,49932,Exit After X Bars,,None,None,None,None
598_240906002_B,183,XAUUSD,Buy,2014-12-26 00:00:00,2014-12-26 04:00:00,1181.22,1183.63,1,241,50173,Exit After X Bars,,None,None,None,None
600_240906002_B,183,XAUUSD,Buy,2014-12-30 12:00:00,2014-12-30 16:00:00,1195.59,1198.09,1,250,50423,Exit After X Bars,,None,None,None,None
604_240906002_B,183,XAUUSD,Buy,2015-01-09 12:00:00,2015-01-09 16:00:00,1216.3,1214.26,1,-204,50219,Exit After X Bars,,None,None,None,None
605_240906002_B,183,XAUUSD,Buy,2015-01-14 16:00:00,2015-01-14 20:00:00,1242.73,1238.64,1,-409,49810,Exit After X Bars,,None,None,None,None
606_240906002_B,183,XAUUSD,Buy,2015-01-22 16:00:00,2015-01-22 20:00:00,1304.97,1300.98,1,-399,49411,Exit After X Bars,,None,None,None,None
609_240906002_B,183,XAUUSD,Buy,2015-01-27 12:00:00,2015-01-27 16:00:00,1287.33,1287.31,1,-2,49409,Exit After X Bars,,None,None,None,None
611_240906002_B,183,XAUUSD,Buy,2015-01-30 16:00:00,2015-01-30 20:00:00,1277.16,1275.44,1,-172,49237,Exit After X Bars,,None,None,None,None
620_240906002_B,183,XAUUSD,Buy,2015-02-13 12:00:00,2015-02-13 16:00:00,1227.65,1228.23,1,58,49295,Exit After X Bars,,None,None,None,None
626_240906002_B,183,XAUUSD,Buy,2015-02-25 00:00:00,2015-02-25 04:00:00,1210.14,1209.99,1,-15,49280,Exit After X Bars,,None,None,None,None
631_240906002_B,183,XAUUSD,Buy,2015-03-05 16:00:00,2015-03-05 20:00:00,1207.16,1199.08,1,-808,48472,Exit After X Bars,,None,None,None,None
639_240906002_B,183,XAUUSD,Buy,2015-03-17 16:00:00,2015-03-17 20:00:00,1159.31,1149.3,1,-1001,47471,Exit After X Bars,,None,None,None,None
640_240906002_B,183,XAUUSD,Buy,2015-03-18 20:00:00,2015-03-19 00:00:00,1159.75,1166.79,1,704,48175,Exit After X Bars,,None,None,None,None
644_240906002_B,183,XAUUSD,Buy,2015-04-01 12:00:00,2015-04-01 16:00:00,1190.63,1193.54,1,291,48466,Exit After X Bars,,None,None,None,None
650_240906002_B,183,XAUUSD,Buy,2015-04-15 20:00:00,2015-04-16 00:00:00,1198.9,1202.18,1,328,48794,Exit After X Bars,,None,None,None,None
651_240906002_B,183,XAUUSD,Buy,2015-04-17 12:00:00,2015-04-17 16:00:00,1207.49,1202.13,1,-536,48258,Exit After X Bars,,None,None,None,None
653_240906002_B,183,XAUUSD,Buy,2015-04-22 08:00:00,2015-04-22 12:00:00,1204.67,1200.73,1,-394,47864,Exit After X Bars,,None,None,None,None
656_240906002_B,183,XAUUSD,Buy,2015-04-27 16:00:00,2015-04-27 20:00:00,1192.65,1206.76,1,1411,49275,Exit After X Bars,,None,None,None,None
660_240906002_B,183,XAUUSD,Buy,2015-05-08 12:00:00,2015-05-08 16:00:00,1188.36,1189.59,1,123,49398,Exit After X Bars,,None,None,None,None
662_240906002_B,183,XAUUSD,Buy,2015-05-12 12:00:00,2015-05-12 16:00:00,1191.71,1195.14,1,343,49741,Exit After X Bars,,None,None,None,None
665_240906002_B,183,XAUUSD,Buy,2015-05-22 08:00:00,2015-05-22 12:00:00,1213.23,1212.43,1,-80,49661,Exit After X Bars,,None,None,None,None
669_240906002_B,183,XAUUSD,Buy,2015-05-28 16:00:00,2015-05-28 20:00:00,1188.91,1188.44,1,-47,49614,Exit After X Bars,,None,None,None,None
670_240906002_B,183,XAUUSD,Buy,2015-06-01 16:00:00,2015-06-01 20:00:00,1193.77,1191.04,1,-273,49341,Exit After X Bars,,None,None,None,None
675_240906002_B,183,XAUUSD,Buy,2015-06-09 04:00:00,2015-06-09 08:00:00,1176.52,1177.58,1,106,49447,Exit After X Bars,,None,None,None,None
678_240906002_B,183,XAUUSD,Buy,2015-06-15 16:00:00,2015-06-15 20:00:00,1183.43,1188.24,1,481,49928,Exit After X Bars,,None,None,None,None
680_240906002_B,183,XAUUSD,Buy,2015-06-17 20:00:00,2015-06-18 00:00:00,1184.7,1184.86,1,16,49944,Exit After X Bars,,None,None,None,None
685_240906002_B,183,XAUUSD,Buy,2015-06-29 00:00:00,2015-06-29 04:00:00,1184.23,1185.47,1,123.9,50067.9,Exit After X Bars,,None,None,None,None
689_240906002_B,183,XAUUSD,Buy,2015-07-03 12:00:00,2015-07-03 16:00:00,1169.3,1169.48,1,18,50085.9,Exit After X Bars,,None,None,None,None
690_240906002_B,183,XAUUSD,Buy,2015-07-06 16:00:00,2015-07-06 20:00:00,1169.81,1172.13,1,232,50317.9,Exit After X Bars,,None,None,None,None
694_240906002_B,183,XAUUSD,Buy,2015-07-14 16:00:00,2015-07-14 20:00:00,1159.37,1155.13,1,-424,49893.9,Exit After X Bars,,None,None,None,None
701_240906002_B,183,XAUUSD,Buy,2015-07-23 16:00:00,2015-07-23 20:00:00,1096.15,1095.26,1,-89,49804.9,Exit After X Bars,,None,None,None,None
703_240906002_B,183,XAUUSD,Buy,2015-07-27 16:00:00,2015-07-27 20:00:00,1101.3,1097.31,1,-399,49405.9,Exit After X Bars,,None,None,None,None
705_240906002_B,183,XAUUSD,Buy,2015-07-31 16:00:00,2015-07-31 20:00:00,1095.32,1094.21,1,-111,49294.9,Exit After X Bars,,None,None,None,None
708_240906002_B,183,XAUUSD,Buy,2015-08-06 16:00:00,2015-08-06 20:00:00,1092.51,1092.34,1,-17,49277.9,Exit After X Bars,,None,None,None,None
709_240906002_B,183,XAUUSD,Buy,2015-08-07 16:00:00,2015-08-07 20:00:00,1093.91,1094.27,1,36,49313.9,Exit After X Bars,,None,None,None,None
714_240906002_B,183,XAUUSD,Buy,2015-08-28 12:00:00,2015-08-28 16:00:00,1129.13,1129.06,1,-7,49306.9,Exit After X Bars,,None,None,None,None
719_240906002_B,183,XAUUSD,Buy,2015-09-08 12:00:00,2015-09-08 16:00:00,1123.13,1122.09,1,-104,49202.9,Exit After X Bars,,None,None,None,None
723_240906002_B,183,XAUUSD,Buy,2015-09-14 12:00:00,2015-09-14 16:00:00,1108.34,1105.19,1,-315,48887.9,Exit After X Bars,,None,None,None,None
724_240906002_B,183,XAUUSD,Buy,2015-09-16 12:00:00,2015-09-16 16:00:00,1110.33,1114.03,1,370,49257.9,Exit After X Bars,,None,None,None,None
726_240906002_B,183,XAUUSD,Buy,2015-09-24 04:00:00,2015-09-24 08:00:00,1134.91,1134.21,1,-70,49187.9,Exit After X Bars,,None,None,None,None
731_240906002_B,183,XAUUSD,Buy,2015-10-02 12:00:00,2015-10-02 16:00:00,1118.97,1131.89,1,1292,50479.9,Exit After X Bars,,None,None,None,None
732_240906002_B,183,XAUUSD,Buy,2015-10-09 08:00:00,2015-10-09 12:00:00,1153.47,1153.75,1,28,50507.9,Exit After X Bars,,None,None,None,None
733_240906002_B,183,XAUUSD,Buy,2015-10-14 00:00:00,2015-10-14 04:00:00,1168.85,1168.66,1,-19,50488.9,Exit After X Bars,,None,None,None,None
736_240906002_B,183,XAUUSD,Buy,2015-10-20 16:00:00,2015-10-20 20:00:00,1178.02,1176.93,1,-109,50379.9,Exit After X Bars,,None,None,None,None
738_240906002_B,183,XAUUSD,Buy,2015-10-23 12:00:00,2015-10-23 16:00:00,1177.74,1177.01,1,-73,50306.9,Exit After X Bars,,None,None,None,None
740_240906002_B,183,XAUUSD,Buy,2015-10-28 08:00:00,2015-10-28 12:00:00,1169.57,1172.1,1,253,50559.9,Exit After X Bars,,None,None,None,None
756_240906002_B,183,XAUUSD,Buy,2015-11-19 16:00:00,2015-11-19 20:00:00,1078.22,1080.32,1,210,50769.9,Exit After X Bars,,None,None,None,None
758_240906002_B,183,XAUUSD,Buy,2015-11-24 12:00:00,2015-11-24 16:00:00,1075.01,1077.21,1,220,50989.9,Exit After X Bars,,None,None,None,None
762_240906002_B,183,XAUUSD,Buy,2015-11-30 20:00:00,2015-12-01 00:00:00,1066.82,1064.8,1,-202,50787.9,Exit After X Bars,,None,None,None,None
764_240906002_B,183,XAUUSD,Buy,2015-12-04 12:00:00,2015-12-04 16:00:00,1067.64,1068.32,1,68,50855.9,Exit After X Bars,,None,None,None,None
766_240906002_B,183,XAUUSD,Buy,2015-12-09 12:00:00,2015-12-09 16:00:00,1079.03,1082.33,1,330,51185.9,Exit After X Bars,,None,None,None,None
768_240906002_B,183,XAUUSD,Buy,2015-12-11 16:00:00,2015-12-11 20:00:00,1075.44,1075.16,1,-28,51157.9,Exit After X Bars,,None,None,None,None
771_240906002_B,183,XAUUSD,Buy,2015-12-16 12:00:00,2015-12-16 16:00:00,1068.59,1072.87,1,428,51585.9,Exit After X Bars,,None,None,None,None
773_240906002_B,183,XAUUSD,Buy,2015-12-18 16:00:00,2015-12-18 20:00:00,1068.19,1065.61,1,-258,51327.9,Exit After X Bars,,None,None,None,None
775_240906002_B,183,XAUUSD,Buy,2015-12-24 16:00:00,2015-12-24 20:00:00,1074.21,1076.64,1,243,51570.9,Exit After X Bars,,None,None,None,None
777_240906002_B,183,XAUUSD,Buy,2015-12-29 12:00:00,2015-12-29 16:00:00,1072.59,1070.22,1,-237,51333.9,Exit After X Bars,,None,None,None,None
780_240906002_B,183,XAUUSD,Buy,2016-01-11 12:00:00,2016-01-11 16:00:00,1105.35,1100.89,1,-446,50887.9,Exit After X Bars,,None,None,None,None
782_240906002_B,183,XAUUSD,Buy,2016-01-13 20:00:00,2016-01-14 00:00:00,1095.3,1093.36,1,-194,50693.9,Exit After X Bars,,None,None,None,None
784_240906002_B,183,XAUUSD,Buy,2016-01-15 12:00:00,2016-01-15 16:00:00,1092.99,1093.84,1,85,50778.9,Exit After X Bars,,None,None,None,None
785_240906002_B,183,XAUUSD,Buy,2016-01-20 04:00:00,2016-01-20 08:00:00,1092.04,1091.18,1,-86,50692.9,Exit After X Bars,,None,None,None,None
786_240906002_B,183,XAUUSD,Buy,2016-01-22 16:00:00,2016-01-22 20:00:00,1102.59,1097.71,1,-488,50204.9,Exit After X Bars,,None,None,None,None
789_240906002_B,183,XAUUSD,Buy,2016-02-11 00:00:00,2016-02-11 04:00:00,1198.57,1207.95,1,938,51142.9,Exit After X Bars,,None,None,None,None
791_240906002_B,183,XAUUSD,Buy,2016-02-16 12:00:00,2016-02-16 16:00:00,1213.73,1214.62,1,89,51231.9,Exit After X Bars,,None,None,None,None
792_240906002_B,183,XAUUSD,Buy,2016-02-18 16:00:00,2016-02-18 20:00:00,1216.7,1227.06,1,1036,52267.9,Exit After X Bars,,None,None,None,None
795_240906002_B,183,XAUUSD,Buy,2016-02-29 20:00:00,2016-03-01 00:00:00,1237.99,1237.53,1,-46,52221.9,Exit After X Bars,,None,None,None,None
797_240906002_B,183,XAUUSD,Buy,2016-03-03 16:00:00,2016-03-03 20:00:00,1247.74,1256.9,1,916,53137.9,Exit After X Bars,,None,None,None,None
799_240906002_B,183,XAUUSD,Buy,2016-03-10 16:00:00,2016-03-10 20:00:00,1260.16,1272.46,1,1230,54367.9,Exit After X Bars,,None,None,None,None
802_240906002_B,183,XAUUSD,Buy,2016-03-16 20:00:00,2016-03-17 00:00:00,1237.89,1260.82,1,2293,56660.9,Exit After X Bars,,None,None,None,None
804_240906002_B,183,XAUUSD,Buy,2016-03-22 08:00:00,2016-03-22 12:00:00,1258.44,1252.25,1,-619,56041.9,Exit After X Bars,,None,None,None,None
807_240906002_B,183,XAUUSD,Buy,2016-03-29 16:00:00,2016-03-29 20:00:00,1223.55,1235.67,1,1212,57253.9,Exit After X Bars,,None,None,None,None
809_240906002_B,183,XAUUSD,Buy,2016-04-05 08:00:00,2016-04-05 12:00:00,1233.84,1232.66,1,-118,57135.9,Exit After X Bars,,None,None,None,None
810_240906002_B,183,XAUUSD,Buy,2016-04-07 12:00:00,2016-04-07 16:00:00,1236.66,1239.3,1,264,57399.9,Exit After X Bars,,None,None,None,None
816_240906002_B,183,XAUUSD,Buy,2016-04-26 16:00:00,2016-04-26 20:00:00,1242.13,1240.55,1,-158,57241.9,Exit After X Bars,,None,None,None,None
819_240906002_B,183,XAUUSD,Buy,2016-05-06 12:00:00,2016-05-06 16:00:00,1289.51,1291.99,1,248,57489.9,Exit After X Bars,,None,None,None,None
826_240906002_B,183,XAUUSD,Buy,2016-05-20 16:00:00,2016-05-20 20:00:00,1258.99,1250.82,1,-817,56672.9,Exit After X Bars,,None,None,None,None
833_240906002_B,183,XAUUSD,Buy,2016-05-31 12:00:00,2016-05-31 16:00:00,1212.47,1210.14,1,-233,56439.9,Exit After X Bars,,None,None,None,None
836_240906002_B,183,XAUUSD,Buy,2016-06-03 12:00:00,2016-06-03 16:00:00,1217.55,1236.96,1,1941,58380.9,Exit After X Bars,,None,None,None,None
837_240906002_B,183,XAUUSD,Buy,2016-06-08 04:00:00,2016-06-08 08:00:00,1247.29,1248.54,1,125,58505.9,Exit After X Bars,,None,None,None,None
842_240906002_B,183,XAUUSD,Buy,2016-06-24 00:00:00,2016-06-24 04:00:00,1269.22,1271.53,1,231,58736.9,Exit After X Bars,,None,None,None,None
843_240906002_B,183,XAUUSD,Buy,2016-07-01 08:00:00,2016-07-01 12:00:00,1333.0,1334.47,1,147,58883.9,Exit After X Bars,,None,None,None,None
844_240906002_B,183,XAUUSD,Buy,2016-07-08 16:00:00,2016-07-08 20:00:00,1367.63,1355.82,1,-1181,57702.9,Exit After X Bars,,None,None,None,None
849_240906002_B,183,XAUUSD,Buy,2016-07-15 20:00:00,2016-07-18 00:00:00,1336.57,1332.62,1,-395,57307.9,End Of Friday,,None,None,None,None
852_240906002_B,183,XAUUSD,Buy,2016-07-21 16:00:00,2016-07-21 20:00:00,1327.19,1330.09,1,290,57597.9,Exit After X Bars,,None,None,None,None
854_240906002_B,183,XAUUSD,Buy,2016-07-27 16:00:00,2016-07-27 20:00:00,1326.62,1327.14,1,52,57649.9,Exit After X Bars,,None,None,None,None
855_240906002_B,183,XAUUSD,Buy,2016-07-29 12:00:00,2016-07-29 16:00:00,1345.44,1345.52,1,8,57657.9,Exit After X Bars,,None,None,None,None
860_240906002_B,183,XAUUSD,Buy,2016-08-09 16:00:00,2016-08-09 20:00:00,1337.98,1339.93,1,195,57852.9,Exit After X Bars,,None,None,None,None
861_240906002_B,183,XAUUSD,Buy,2016-08-12 12:00:00,2016-08-12 16:00:00,1353.17,1355.01,1,184,58036.9,Exit After X Bars,,None,None,None,None
862_240906002_B,183,XAUUSD,Buy,2016-08-16 12:00:00,2016-08-16 16:00:00,1356.24,1349.02,1,-722,57314.9,Exit After X Bars,,None,None,None,None
865_240906002_B,183,XAUUSD,Buy,2016-08-23 12:00:00,2016-08-23 16:00:00,1339.97,1343.74,1,377,57691.9,Exit After X Bars,,None,None,None,None
868_240906002_B,183,XAUUSD,Buy,2016-08-26 12:00:00,2016-08-26 16:00:00,1326.81,1331.14,1,433,58124.9,Exit After X Bars,,None,None,None,None
872_240906002_B,183,XAUUSD,Buy,2016-09-01 16:00:00,2016-09-01 20:00:00,1314.75,1313.54,1,-121,58003.9,Exit After X Bars,,None,None,None,None
878_240906002_B,183,XAUUSD,Buy,2016-09-15 12:00:00,2016-09-15 16:00:00,1325.84,1320.64,1,-520,57483.9,Exit After X Bars,,None,None,None,None
880_240906002_B,183,XAUUSD,Buy,2016-09-19 16:00:00,2016-09-19 20:00:00,1316.04,1313.86,1,-218,57265.9,Exit After X Bars,,None,None,None,None
881_240906002_B,183,XAUUSD,Buy,2016-09-26 16:00:00,2016-09-26 20:00:00,1340.48,1340.09,1,-39,57226.9,Exit After X Bars,,None,None,None,None
884_240906002_B,183,XAUUSD,Buy,2016-09-30 08:00:00,2016-09-30 12:00:00,1326.83,1326.0,1,-83,57143.9,Exit After X Bars,,None,None,None,None
891_240906002_B,183,XAUUSD,Buy,2016-10-13 04:00:00,2016-10-13 08:00:00,1259.37,1259.34,1,-3,57140.9,Exit After X Bars,,None,None,None,None
893_240906002_B,183,XAUUSD,Buy,2016-10-18 04:00:00,2016-10-18 08:00:00,1259.35,1258.1,1,-125,57015.9,Exit After X Bars,,None,None,None,None
895_240906002_B,183,XAUUSD,Buy,2016-10-24 12:00:00,2016-10-24 16:00:00,1267.93,1271.24,1,331,57346.9,Exit After X Bars,,None,None,None,None
898_240906002_B,183,XAUUSD,Buy,2016-10-28 16:00:00,2016-10-28 20:00:00,1272.74,1269.81,1,-293,57053.9,Exit After X Bars,,None,None,None,None
900_240906002_B,183,XAUUSD,Buy,2016-11-08 16:00:00,2016-11-08 20:00:00,1288.82,1276.86,1,-1196,55857.9,Exit After X Bars,,None,None,None,None
901_240906002_B,183,XAUUSD,Buy,2016-11-10 08:00:00,2016-11-10 12:00:00,1290.47,1283.68,1,-679,55178.9,Exit After X Bars,,None,None,None,None
904_240906002_B,183,XAUUSD,Buy,2016-11-16 00:00:00,2016-11-16 04:00:00,1231.02,1231.18,1,16,55194.9,Exit After X Bars,,None,None,None,None
907_240906002_B,183,XAUUSD,Buy,2016-11-21 12:00:00,2016-11-21 16:00:00,1215.86,1214.42,1,-144,55050.9,Exit After X Bars,,None,None,None,None
910_240906002_B,183,XAUUSD,Buy,2016-11-25 12:00:00,2016-11-25 16:00:00,1189.48,1187.54,1,-194,54856.9,Exit After X Bars,,None,None,None,None
914_240906002_B,183,XAUUSD,Buy,2016-12-02 16:00:00,2016-12-02 20:00:00,1177.78,1175.36,1,-242,54614.9,Exit After X Bars,,None,None,None,None
916_240906002_B,183,XAUUSD,Buy,2016-12-07 12:00:00,2016-12-07 16:00:00,1175.83,1176.33,1,50,54664.9,Exit After X Bars,,None,None,None,None
922_240906002_B,183,XAUUSD,Buy,2016-12-16 16:00:00,2016-12-16 20:00:00,1137.28,1137.32,1,4,54668.9,Exit After X Bars,,None,None,None,None
924_240906002_B,183,XAUUSD,Buy,2016-12-21 12:00:00,2016-12-21 16:00:00,1134.85,1135.94,1,109,54777.9,Exit After X Bars,,None,None,None,None
926_240906002_B,183,XAUUSD,Buy,2016-12-23 16:00:00,2016-12-23 20:00:00,1133.95,1132.46,1,-149,54628.9,Exit After X Bars,,None,None,None,None
927_240906002_B,183,XAUUSD,Buy,2017-01-03 16:00:00,2017-01-03 20:00:00,1161.03,1162.01,1,98,54726.9,Exit After X Bars,,None,None,None,None
929_240906002_B,183,XAUUSD,Buy,2017-01-20 20:00:00,2017-01-23 00:00:00,1207.9,1209.46,1,156,54882.9,End Of Friday,,None,None,None,None
933_240906002_B,183,XAUUSD,Buy,2017-01-30 12:00:00,2017-01-30 16:00:00,1191.45,1193.3,1,185,55067.9,Exit After X Bars,,None,None,None,None
938_240906002_B,183,XAUUSD,Buy,2017-02-16 00:00:00,2017-02-16 04:00:00,1234.41,1236.16,1,175,55242.9,Exit After X Bars,,None,None,None,None
939_240906002_B,183,XAUUSD,Buy,2017-02-22 12:00:00,2017-02-22 16:00:00,1238.88,1238.65,1,-23,55219.9,Exit After X Bars,,None,None,None,None
949_240906002_B,183,XAUUSD,Buy,2017-03-15 20:00:00,2017-03-16 00:00:00,1207.47,1219.04,1,1157,56376.9,Exit After X Bars,,None,None,None,None
954_240906002_B,183,XAUUSD,Buy,2017-04-03 16:00:00,2017-04-03 20:00:00,1250.49,1252.34,1,185,56561.9,Exit After X Bars,,None,None,None,None
956_240906002_B,183,XAUUSD,Buy,2017-04-07 04:00:00,2017-04-07 08:00:00,1258.76,1263.51,1,475,57036.9,Exit After X Bars,,None,None,None,None
957_240906002_B,183,XAUUSD,Buy,2017-04-11 16:00:00,2017-04-11 20:00:00,1270.47,1271.2,1,73,57109.9,Exit After X Bars,,None,None,None,None
961_240906002_B,183,XAUUSD,Buy,2017-04-21 12:00:00,2017-04-21 16:00:00,1283.3,1282.38,1,-92,57017.9,Exit After X Bars,,None,None,None,None
966_240906002_B,183,XAUUSD,Buy,2017-05-01 16:00:00,2017-05-01 20:00:00,1268.44,1256.19,1,-1225,55792.9,Exit After X Bars,,None,None,None,None
971_240906002_B,183,XAUUSD,Buy,2017-05-08 12:00:00,2017-05-08 16:00:00,1235.4,1230.3,1,-510,55282.9,Exit After X Bars,,None,None,None,None
974_240906002_B,183,XAUUSD,Buy,2017-05-11 16:00:00,2017-05-11 20:00:00,1225.48,1224.91,1,-57,55225.9,Exit After X Bars,,None,None,None,None
978_240906002_B,183,XAUUSD,Buy,2017-05-26 08:00:00,2017-05-26 12:00:00,1258.84,1263.49,1,465,55690.9,Exit After X Bars,,None,None,None,None
980_240906002_B,183,XAUUSD,Buy,2017-05-31 12:00:00,2017-05-31 16:00:00,1265.28,1266.08,1,80,55770.9,Exit After X Bars,,None,None,None,None
982_240906002_B,183,XAUUSD,Buy,2017-06-02 12:00:00,2017-06-02 16:00:00,1268.77,1273.68,1,491,56261.9,Exit After X Bars,,None,None,None,None
986_240906002_B,183,XAUUSD,Buy,2017-06-14 12:00:00,2017-06-14 16:00:00,1270.25,1276.32,1,607,56868.9,Exit After X Bars,,None,None,None,None
991_240906002_B,183,XAUUSD,Buy,2017-06-22 00:00:00,2017-06-22 04:00:00,1247.99,1250.85,1,286,57154.9,Exit After X Bars,,None,None,None,None
997_240906002_B,183,XAUUSD,Buy,2017-07-06 00:00:00,2017-07-06 04:00:00,1227.27,1227.31,1,4,57158.9,Exit After X Bars,,None,None,None,None
998_240906002_B,183,XAUUSD,Buy,2017-07-07 12:00:00,2017-07-07 16:00:00,1227.24,1221.02,1,-622,56536.9,Exit After X Bars,,None,None,None,None
1000_240906002_B,183,XAUUSD,Buy,2017-07-11 16:00:00,2017-07-11 20:00:00,1215.89,1215.74,1,-15,56521.9,Exit After X Bars,,None,None,None,None
1001_240906002_B,183,XAUUSD,Buy,2017-07-20 16:00:00,2017-07-20 20:00:00,1243.86,1246.2,1,234,56755.9,Exit After X Bars,,None,None,None,None
1003_240906002_B,183,XAUUSD,Buy,2017-07-26 20:00:00,2017-07-27 00:00:00,1255.05,1260.47,1,542,57297.9,Exit After X Bars,,None,None,None,None
1008_240906002_B,183,XAUUSD,Buy,2017-08-08 20:00:00,2017-08-09 00:00:00,1259.82,1260.4,1,58,57355.9,Exit After X Bars,,None,None,None,None
1011_240906002_B,183,XAUUSD,Buy,2017-08-16 20:00:00,2017-08-17 00:00:00,1275.28,1283.5,1,822,58177.9,Exit After X Bars,,None,None,None,None
1013_240906002_B,183,XAUUSD,Buy,2017-08-23 12:00:00,2017-08-23 16:00:00,1290.89,1289.25,1,-164,58013.9,Exit After X Bars,,None,None,None,None
1014_240906002_B,183,XAUUSD,Buy,2017-08-25 16:00:00,2017-08-25 20:00:00,1291.33,1292.64,1,131,58144.9,Exit After X Bars,,None,None,None,None
1016_240906002_B,183,XAUUSD,Buy,2017-08-31 16:00:00,2017-08-31 20:00:00,1313.51,1316.85,1,334,58478.9,Exit After X Bars,,None,None,None,None
1017_240906002_B,183,XAUUSD,Buy,2017-09-07 12:00:00,2017-09-07 16:00:00,1344.2,1343.87,1,-33,58445.9,Exit After X Bars,,None,None,None,None
1020_240906002_B,183,XAUUSD,Buy,2017-09-13 12:00:00,2017-09-13 16:00:00,1334.45,1331.65,1,-280,58165.9,Exit After X Bars,,None,None,None,None
1024_240906002_B,183,XAUUSD,Buy,2017-09-20 12:00:00,2017-09-20 16:00:00,1315.89,1311.3,1,-459,57706.9,Exit After X Bars,,None,None,None,None
1026_240906002_B,183,XAUUSD,Buy,2017-09-22 16:00:00,2017-09-22 20:00:00,1297.51,1294.74,1,-277,57429.9,Exit After X Bars,,None,None,None,None
1027_240906002_B,183,XAUUSD,Buy,2017-09-25 16:00:00,2017-09-25 20:00:00,1298.33,1310.15,1,1182,58611.9,Exit After X Bars,,None,None,None,None
1033_240906002_B,183,XAUUSD,Buy,2017-10-04 08:00:00,2017-10-04 12:00:00,1277.09,1275.54,1,-155,58456.9,Exit After X Bars,,None,None,None,None
1041_240906002_B,183,XAUUSD,Buy,2017-10-26 08:00:00,2017-10-26 12:00:00,1281.21,1277.93,1,-328,58128.9,Exit After X Bars,,None,None,None,None
1043_240906002_B,183,XAUUSD,Buy,2017-10-30 16:00:00,2017-10-30 20:00:00,1273.91,1278.05,1,414,58542.9,Exit After X Bars,,None,None,None,None
1044_240906002_B,183,XAUUSD,Buy,2017-11-01 12:00:00,2017-11-01 16:00:00,1278.72,1275.13,1,-359,58183.9,Exit After X Bars,,None,None,None,None
1046_240906002_B,183,XAUUSD,Buy,2017-11-06 16:00:00,2017-11-06 20:00:00,1280.1,1280.84,1,74,58257.9,Exit After X Bars,,None,None,None,None
1049_240906002_B,183,XAUUSD,Buy,2017-11-14 16:00:00,2017-11-14 20:00:00,1279.67,1281.0,1,133,58390.9,Exit After X Bars,,None,None,None,None
1051_240906002_B,183,XAUUSD,Buy,2017-11-17 16:00:00,2017-11-17 20:00:00,1289.41,1293.4,1,399,58789.9,Exit After X Bars,,None,None,None,None
1054_240906002_B,183,XAUUSD,Buy,2017-11-22 12:00:00,2017-11-22 16:00:00,1284.64,1285.34,1,70,58859.9,Exit After X Bars,,None,None,None,None
1058_240906002_B,183,XAUUSD,Buy,2017-12-01 16:00:00,2017-12-01 20:00:00,1283.21,1283.66,1,45,58904.9,Exit After X Bars,,None,None,None,None
1066_240906002_B,183,XAUUSD,Buy,2017-12-13 12:00:00,2017-12-13 16:00:00,1244.84,1244.63,1,-21,58883.9,Exit After X Bars,,None,None,None,None
1068_240906002_B,183,XAUUSD,Buy,2018-01-10 12:00:00,2018-01-10 16:00:00,1315.85,1319.7,1,385,59268.9,Exit After X Bars,,None,None,None,None
1069_240906002_B,183,XAUUSD,Buy,2018-01-17 00:00:00,2018-01-17 04:00:00,1343.56,1343.65,1,9,59277.9,Exit After X Bars,,None,None,None,None
1073_240906002_B,183,XAUUSD,Buy,2018-01-30 16:00:00,2018-01-30 20:00:00,1348.59,1338.57,1,-1002,58275.9,Exit After X Bars,,None,None,None,None
1074_240906002_B,183,XAUUSD,Buy,2018-02-01 20:00:00,2018-02-02 00:00:00,1348.79,1348.64,1,-15,58260.9,Exit After X Bars,,None,None,None,None
1087_240906002_B,183,XAUUSD,Buy,2018-03-02 12:00:00,2018-03-02 16:00:00,1322.45,1325.0,1,255,58515.9,Exit After X Bars,,None,None,None,None
1091_240906002_B,183,XAUUSD,Buy,2018-03-13 00:00:00,2018-03-13 04:00:00,1325.05,1324.25,1,-80,58435.9,Exit After X Bars,,None,None,None,None
1095_240906002_B,183,XAUUSD,Buy,2018-03-21 16:00:00,2018-03-21 20:00:00,1319.54,1323.92,1,438,58873.9,Exit After X Bars,,None,None,None,None
1100_240906002_B,183,XAUUSD,Buy,2018-04-06 16:00:00,2018-04-06 20:00:00,1332.15,1331.36,1,-79,58794.9,Exit After X Bars,,None,None,None,None
1103_240906002_B,183,XAUUSD,Buy,2018-04-18 12:00:00,2018-04-18 16:00:00,1350.36,1353.13,1,277,59071.9,Exit After X Bars,,None,None,None,None
1106_240906002_B,183,XAUUSD,Buy,2018-04-24 16:00:00,2018-04-24 20:00:00,1329.35,1331.84,1,249,59320.9,Exit After X Bars,,None,None,None,None
1108_240906002_B,183,XAUUSD,Buy,2018-04-26 12:00:00,2018-04-26 16:00:00,1325.58,1324.72,1,-86,59234.9,Exit After X Bars,,None,None,None,None
1112_240906002_B,183,XAUUSD,Buy,2018-05-02 12:00:00,2018-05-02 16:00:00,1310.17,1308.94,1,-123,59111.9,Exit After X Bars,,None,None,None,None
1114_240906002_B,183,XAUUSD,Buy,2018-05-08 20:00:00,2018-05-09 00:00:00,1316.96,1314.58,1,-238,58873.9,Exit After X Bars,,None,None,None,None
1115_240906002_B,183,XAUUSD,Buy,2018-05-10 12:00:00,2018-05-10 16:00:00,1317.72,1322.01,1,429,59302.9,Exit After X Bars,,None,None,None,None
1120_240906002_B,183,XAUUSD,Buy,2018-05-18 16:00:00,2018-05-18 20:00:00,1291.61,1292.53,1,92,59394.9,Exit After X Bars,,None,None,None,None
1121_240906002_B,183,XAUUSD,Buy,2018-05-22 08:00:00,2018-05-22 12:00:00,1294.0,1293.72,1,-28,59366.9,Exit After X Bars,,None,None,None,None
1122_240906002_B,183,XAUUSD,Buy,2018-05-24 08:00:00,2018-05-24 12:00:00,1296.03,1296.93,1,90,59456.9,Exit After X Bars,,None,None,None,None
1124_240906002_B,183,XAUUSD,Buy,2018-05-29 16:00:00,2018-05-29 20:00:00,1301.2,1302.01,1,81,59537.9,Exit After X Bars,,None,None,None,None
1127_240906002_B,183,XAUUSD,Buy,2018-06-05 16:00:00,2018-06-05 20:00:00,1297.98,1298.38,1,40,59577.9,Exit After X Bars,,None,None,None,None
1128_240906002_B,183,XAUUSD,Buy,2018-06-11 16:00:00,2018-06-11 20:00:00,1300.5,1300.19,1,-31,59546.9,Exit After X Bars,,None,None,None,None
1130_240906002_B,183,XAUUSD,Buy,2018-06-13 20:00:00,2018-06-14 00:00:00,1299.66,1299.25,1,-41,59505.9,Exit After X Bars,,None,None,None,None
1136_240906002_B,183,XAUUSD,Buy,2018-06-22 12:00:00,2018-06-22 16:00:00,1269.94,1268.64,1,-130,59375.9,Exit After X Bars,,None,None,None,None
1141_240906002_B,183,XAUUSD,Buy,2018-06-29 16:00:00,2018-06-29 20:00:00,1254.15,1255.26,1,111,59486.9,Exit After X Bars,,None,None,None,None
1143_240906002_B,183,XAUUSD,Buy,2018-07-03 16:00:00,2018-07-03 20:00:00,1250.67,1252.72,1,205,59691.9,Exit After X Bars,,None,None,None,None
1148_240906002_B,183,XAUUSD,Buy,2018-07-17 08:00:00,2018-07-17 12:00:00,1243.6,1244.67,1,107,59798.9,Exit After X Bars,,None,None,None,None
1150_240906002_B,183,XAUUSD,Buy,2018-07-19 20:00:00,2018-07-20 00:00:00,1228.37,1223.01,1,-536,59262.9,Exit After X Bars,,None,None,None,None
1151_240906002_B,183,XAUUSD,Buy,2018-07-20 12:00:00,2018-07-20 16:00:00,1228.88,1229.95,1,107,59369.9,Exit After X Bars,,None,None,None,None
1153_240906002_B,183,XAUUSD,Buy,2018-07-25 12:00:00,2018-07-25 16:00:00,1232.49,1232.4,1,-9,59360.9,Exit After X Bars,,None,None,None,None
1157_240906002_B,183,XAUUSD,Buy,2018-07-31 16:00:00,2018-07-31 20:00:00,1224.98,1225.98,1,100,59460.9,Exit After X Bars,,None,None,None,None
1160_240906002_B,183,XAUUSD,Buy,2018-08-03 16:00:00,2018-08-03 20:00:00,1218.24,1215.78,1,-246,59214.9,Exit After X Bars,,None,None,None,None
1162_240906002_B,183,XAUUSD,Buy,2018-08-09 08:00:00,2018-08-09 12:00:00,1216.05,1212.92,1,-313,58901.9,Exit After X Bars,,None,None,None,None
1168_240906002_B,183,XAUUSD,Buy,2018-08-17 20:00:00,2018-08-20 00:00:00,1181.53,1183.33,1,180,59081.9,End Of Friday,,None,None,None,None
1170_240906002_B,183,XAUUSD,Buy,2018-08-24 12:00:00,2018-08-24 16:00:00,1192.77,1193.8,1,103,59184.9,Exit After X Bars,,None,None,None,None
1172_240906002_B,183,XAUUSD,Buy,2018-08-31 08:00:00,2018-08-31 12:00:00,1207.72,1206.3,1,-142,59042.9,Exit After X Bars,,None,None,None,None
1175_240906002_B,183,XAUUSD,Buy,2018-09-05 16:00:00,2018-09-05 20:00:00,1196.5,1195.41,1,-109,58933.9,Exit After X Bars,,None,None,None,None
1178_240906002_B,183,XAUUSD,Buy,2018-09-11 20:00:00,2018-09-12 00:00:00,1198.4,1198.01,1,-39,58894.9,Exit After X Bars,,None,None,None,None
1181_240906002_B,183,XAUUSD,Buy,2018-09-19 12:00:00,2018-09-19 16:00:00,1204.72,1205.23,1,51,58945.9,Exit After X Bars,,None,None,None,None
1188_240906002_B,183,XAUUSD,Buy,2018-10-02 08:00:00,2018-10-02 12:00:00,1193.76,1193.13,1,-63,58882.9,Exit After X Bars,,None,None,None,None
1193_240906002_B,183,XAUUSD,Buy,2018-10-10 20:00:00,2018-10-11 00:00:00,1190.51,1194.76,1,425,59307.9,Exit After X Bars,,None,None,None,None
1195_240906002_B,183,XAUUSD,Buy,2018-10-18 16:00:00,2018-10-18 20:00:00,1229.26,1227.71,1,-155,59152.9,Exit After X Bars,,None,None,None,None
1196_240906002_B,183,XAUUSD,Buy,2018-10-23 08:00:00,2018-10-23 12:00:00,1230.67,1235.63,1,496,59648.9,Exit After X Bars,,None,None,None,None
1198_240906002_B,183,XAUUSD,Buy,2018-10-26 08:00:00,2018-10-26 12:00:00,1236.56,1237.36,1,80,59728.9,Exit After X Bars,,None,None,None,None
1201_240906002_B,183,XAUUSD,Buy,2018-11-01 08:00:00,2018-11-01 12:00:00,1226.43,1225.73,1,-70,59658.9,Exit After X Bars,,None,None,None,None
1203_240906002_B,183,XAUUSD,Buy,2018-11-07 08:00:00,2018-11-07 12:00:00,1233.12,1233.49,1,37,59695.9,Exit After X Bars,,None,None,None,None
1208_240906002_B,183,XAUUSD,Buy,2018-11-14 16:00:00,2018-11-14 20:00:00,1204.22,1208.29,1,407,60102.9,Exit After X Bars,,None,None,None,None
1210_240906002_B,183,XAUUSD,Buy,2018-11-26 16:00:00,2018-11-26 20:00:00,1225.24,1222.39,1,-285,59817.9,Exit After X Bars,,None,None,None,None
1212_240906002_B,183,XAUUSD,Buy,2018-11-28 16:00:00,2018-11-28 20:00:00,1225.16,1221.12,1,-404,59413.9,Exit After X Bars,,None,None,None,None
1218_240906002_B,183,XAUUSD,Buy,2018-12-17 12:00:00,2018-12-17 16:00:00,1240.27,1241.54,1,127,59540.9,Exit After X Bars,,None,None,None,None
1222_240906002_B,183,XAUUSD,Buy,2019-01-09 16:00:00,2019-01-09 20:00:00,1286.96,1289.85,1,289,59829.9,Exit After X Bars,,None,None,None,None
1227_240906002_B,183,XAUUSD,Buy,2019-01-23 16:00:00,2019-01-23 20:00:00,1285.56,1284.65,1,-91,59738.9,Exit After X Bars,,None,None,None,None
1228_240906002_B,183,XAUUSD,Buy,2019-01-25 12:00:00,2019-01-25 16:00:00,1285.72,1288.55,1,283,60021.9,Exit After X Bars,,None,None,None,None
1231_240906002_B,183,XAUUSD,Buy,2019-02-05 12:00:00,2019-02-05 16:00:00,1315.09,1314.58,1,-51,59970.9,Exit After X Bars,,None,None,None,None
1233_240906002_B,183,XAUUSD,Buy,2019-02-08 12:00:00,2019-02-08 16:00:00,1311.83,1314.73,1,290,60260.9,Exit After X Bars,,None,None,None,None
1234_240906002_B,183,XAUUSD,Buy,2019-02-13 16:00:00,2019-02-13 20:00:00,1315.52,1311.68,1,-384,59876.9,Exit After X Bars,,None,None,None,None
1235_240906002_B,183,XAUUSD,Buy,2019-02-15 12:00:00,2019-02-15 16:00:00,1318.04,1317.47,1,-57,59819.9,Exit After X Bars,,None,None,None,None
1244_240906002_B,183,XAUUSD,Buy,2019-03-06 08:00:00,2019-03-06 12:00:00,1289.54,1285.95,1,-359,59460.9,Exit After X Bars,,None,None,None,None
1245_240906002_B,183,XAUUSD,Buy,2019-03-07 16:00:00,2019-03-07 20:00:00,1288.3,1285.38,1,-292,59168.9,Exit After X Bars,,None,None,None,None
1246_240906002_B,183,XAUUSD,Buy,2019-03-12 20:00:00,2019-03-13 00:00:00,1300.6,1301.22,1,62,59230.9,Exit After X Bars,,None,None,None,None
1248_240906002_B,183,XAUUSD,Buy,2019-03-20 20:00:00,2019-03-21 00:00:00,1310.78,1312.96,1,218,59448.9,Exit After X Bars,,None,None,None,None
1250_240906002_B,183,XAUUSD,Buy,2019-03-27 12:00:00,2019-03-27 16:00:00,1318.7,1315.07,1,-363,59085.9,Exit After X Bars,,None,None,None,None
1265_240906002_B,183,XAUUSD,Buy,2019-04-24 12:00:00,2019-04-24 16:00:00,1273.85,1270.9,1,-295,58790.9,Exit After X Bars,,None,None,None,None
1267_240906002_B,183,XAUUSD,Buy,2019-04-30 16:00:00,2019-04-30 20:00:00,1284.34,1283.46,1,-88,58702.9,Exit After X Bars,,None,None,None,None
1268_240906002_B,183,XAUUSD,Buy,2019-05-01 20:00:00,2019-05-02 00:00:00,1286.07,1276.65,1,-942,57760.9,Exit After X Bars,,None,None,None,None
1270_240906002_B,183,XAUUSD,Buy,2019-05-03 12:00:00,2019-05-03 16:00:00,1272.9,1275.84,1,294,58054.9,Exit After X Bars,,None,None,None,None
1273_240906002_B,183,XAUUSD,Buy,2019-05-13 12:00:00,2019-05-13 16:00:00,1289.28,1291.42,1,214,58268.9,Exit After X Bars,,None,None,None,None
1278_240906002_B,183,XAUUSD,Buy,2019-05-22 12:00:00,2019-05-22 16:00:00,1276.17,1275.58,1,-59,58209.9,Exit After X Bars,,None,None,None,None
1281_240906002_B,183,XAUUSD,Buy,2019-05-30 16:00:00,2019-05-30 20:00:00,1285.42,1287.07,1,165,58374.9,Exit After X Bars,,None,None,None,None
1283_240906002_B,183,XAUUSD,Buy,2019-06-12 04:00:00,2019-06-12 08:00:00,1329.93,1332.3,1,237,58611.9,Exit After X Bars,,None,None,None,None
1284_240906002_B,183,XAUUSD,Buy,2019-06-19 20:00:00,2019-06-20 00:00:00,1355.54,1360.32,1,478,59089.9,Exit After X Bars,,None,None,None,None
1286_240906002_B,183,XAUUSD,Buy,2019-06-28 00:00:00,2019-06-28 04:00:00,1414.9,1414.25,1,-65,59024.9,Exit After X Bars,,None,None,None,None
1288_240906002_B,183,XAUUSD,Buy,2019-07-02 16:00:00,2019-07-02 20:00:00,1396.16,1404.96,1,880,59904.9,Exit After X Bars,,None,None,None,None
1292_240906002_B,183,XAUUSD,Buy,2019-07-10 12:00:00,2019-07-10 16:00:00,1399.9,1410.09,1,1019,60923.9,Exit After X Bars,,None,None,None,None
1294_240906002_B,183,XAUUSD,Buy,2019-07-15 20:00:00,2019-07-16 00:00:00,1416.72,1414.49,1,-223,60700.9,Exit After X Bars,,None,None,None,None
1296_240906002_B,183,XAUUSD,Buy,2019-07-17 16:00:00,2019-07-17 20:00:00,1416.14,1422.27,1,613,61313.9,Exit After X Bars,,None,None,None,None
1299_240906002_B,183,XAUUSD,Buy,2019-07-23 16:00:00,2019-07-23 20:00:00,1428.94,1419.41,1,-953,60360.9,Exit After X Bars,,None,None,None,None
1302_240906002_B,183,XAUUSD,Buy,2019-07-29 20:00:00,2019-07-30 00:00:00,1424.7,1426.49,1,179,60539.9,Exit After X Bars,,None,None,None,None
1304_240906002_B,183,XAUUSD,Buy,2019-08-01 20:00:00,2019-08-02 00:00:00,1434.2,1444.8,1,1060,61599.9,Exit After X Bars,,None,None,None,None
1309_240906002_B,183,XAUUSD,Buy,2019-08-20 12:00:00,2019-08-20 16:00:00,1503.27,1504.12,1,85,61684.9,Exit After X Bars,,None,None,None,None
1312_240906002_B,183,XAUUSD,Buy,2019-08-23 12:00:00,2019-08-23 16:00:00,1504.44,1502.29,1,-215,61469.9,Exit After X Bars,,None,None,None,None
1315_240906002_B,183,XAUUSD,Buy,2019-09-03 08:00:00,2019-09-03 12:00:00,1532.61,1532.2,1,-41,61428.9,Exit After X Bars,,None,None,None,None
1320_240906002_B,183,XAUUSD,Buy,2019-09-12 08:00:00,2019-09-12 12:00:00,1500.77,1504.38,1,361,61789.9,Exit After X Bars,,None,None,None,None
1322_240906002_B,183,XAUUSD,Buy,2019-09-17 16:00:00,2019-09-17 20:00:00,1506.12,1505.75,1,-37,61752.9,Exit After X Bars,,None,None,None,None
1323_240906002_B,183,XAUUSD,Buy,2019-09-20 20:00:00,2019-09-23 00:00:00,1511.5,1513.99,1,249,62001.9,End Of Friday,,None,None,None,None
1328_240906002_B,183,XAUUSD,Buy,2019-10-02 12:00:00,2019-10-02 16:00:00,1488.17,1492.34,1,417,62418.9,Exit After X Bars,,None,None,None,None
1331_240906002_B,183,XAUUSD,Buy,2019-10-08 12:00:00,2019-10-08 16:00:00,1503.94,1503.57,1,-37,62381.9,Exit After X Bars,,None,None,None,None
1338_240906002_B,183,XAUUSD,Buy,2019-10-23 16:00:00,2019-10-23 20:00:00,1495.17,1492.28,1,-289,62092.9,Exit After X Bars,,None,None,None,None
1341_240906002_B,183,XAUUSD,Buy,2019-10-30 12:00:00,2019-10-30 16:00:00,1494.42,1492.42,1,-200,61892.9,Exit After X Bars,,None,None,None,None
1347_240906002_B,183,XAUUSD,Buy,2019-11-13 08:00:00,2019-11-13 12:00:00,1466.19,1465.85,1,-34,61858.9,Exit After X Bars,,None,None,None,None
1349_240906002_B,183,XAUUSD,Buy,2019-11-18 16:00:00,2019-11-18 20:00:00,1469.05,1471.97,1,292,62150.9,Exit After X Bars,,None,None,None,None
1350_240906002_B,183,XAUUSD,Buy,2019-11-20 04:00:00,2019-11-20 08:00:00,1475.28,1475.31,1,3,62153.9,Exit After X Bars,,None,None,None,None
1354_240906002_B,183,XAUUSD,Buy,2019-11-26 16:00:00,2019-11-26 20:00:00,1460.65,1460.05,1,-60,62093.9,Exit After X Bars,,None,None,None,None
1357_240906002_B,183,XAUUSD,Buy,2019-11-29 16:00:00,2019-11-29 20:00:00,1457.5,1463.89,1,639,62732.9,Exit After X Bars,,None,None,None,None
1358_240906002_B,183,XAUUSD,Buy,2019-12-03 08:00:00,2019-12-03 12:00:00,1466.48,1466.06,1,-42,62690.9,Exit After X Bars,,None,None,None,None
1361_240906002_B,183,XAUUSD,Buy,2019-12-10 12:00:00,2019-12-10 16:00:00,1465.24,1466.97,1,173,62863.9,Exit After X Bars,,None,None,None,None
1365_240906002_B,183,XAUUSD,Buy,2019-12-19 16:00:00,2019-12-19 20:00:00,1479.16,1479.76,1,60,62923.9,Exit After X Bars,,None,None,None,None
1368_240906002_B,183,XAUUSD,Buy,2020-01-10 12:00:00,2020-01-10 16:00:00,1556.29,1548.64,1,-765,62158.9,Exit After X Bars,,None,None,None,None
1370_240906002_B,183,XAUUSD,Buy,2020-01-15 16:00:00,2020-01-15 20:00:00,1555.93,1553.85,1,-208,61950.9,Exit After X Bars,,None,None,None,None
1372_240906002_B,183,XAUUSD,Buy,2020-01-23 00:00:00,2020-01-23 04:00:00,1559.89,1559.89,1,0,61950.9,Exit After X Bars,,None,None,None,None
1374_240906002_B,183,XAUUSD,Buy,2020-01-30 04:00:00,2020-01-30 08:00:00,1580.58,1578.08,1,-250,61700.9,Exit After X Bars,,None,None,None,None
1377_240906002_B,183,XAUUSD,Buy,2020-02-07 16:00:00,2020-02-07 20:00:00,1571.45,1568.99,1,-246,61454.9,Exit After X Bars,,None,None,None,None
1379_240906002_B,183,XAUUSD,Buy,2020-02-13 04:00:00,2020-02-13 08:00:00,1573.91,1574.09,1,18,61472.9,Exit After X Bars,,None,None,None,None
1381_240906002_B,183,XAUUSD,Buy,2020-02-27 16:00:00,2020-02-27 20:00:00,1658.12,1640.75,1,-1737,59735.9,Exit After X Bars,,None,None,None,None
1384_240906002_B,183,XAUUSD,Buy,2020-03-03 16:00:00,2020-03-03 20:00:00,1610.75,1645.16,1,3441,63176.9,Exit After X Bars,,None,None,None,None
1386_240906002_B,183,XAUUSD,Buy,2020-03-11 12:00:00,2020-03-11 16:00:00,1667.21,1665.52,1,-169,63007.9,Exit After X Bars,,None,None,None,None
1390_240906002_B,183,XAUUSD,Buy,2020-03-17 16:00:00,2020-03-17 20:00:00,1540.3,1527.22,1,-1308,61699.9,Exit After X Bars,,None,None,None,None
1395_240906002_B,183,XAUUSD,Buy,2020-04-02 12:00:00,2020-04-02 16:00:00,1596.68,1601.04,1,436,62135.9,Exit After X Bars,,None,None,None,None
1398_240906002_B,183,XAUUSD,Buy,2020-04-20 16:00:00,2020-04-20 20:00:00,1701.39,1693.91,1,-748,61387.9,Exit After X Bars,,None,None,None,None
1399_240906002_B,183,XAUUSD,Buy,2020-04-22 12:00:00,2020-04-22 16:00:00,1701.98,1705.99,1,401,61788.9,Exit After X Bars,,None,None,None,None
1402_240906002_B,183,XAUUSD,Buy,2020-04-29 20:00:00,2020-04-30 00:00:00,1714.43,1711.6,1,-283,61505.9,Exit After X Bars,,None,None,None,None
1406_240906002_B,183,XAUUSD,Buy,2020-05-07 16:00:00,2020-05-07 20:00:00,1704.77,1715.17,1,1040,62545.9,Exit After X Bars,,None,None,None,None
1408_240906002_B,183,XAUUSD,Buy,2020-05-12 16:00:00,2020-05-12 20:00:00,1708.09,1702.46,1,-563,61982.9,Exit After X Bars,,None,None,None,None
1415_240906002_B,183,XAUUSD,Buy,2020-05-29 12:00:00,2020-05-29 16:00:00,1729.04,1730.55,1,151,62133.9,Exit After X Bars,,None,None,None,None
1420_240906002_B,183,XAUUSD,Buy,2020-06-09 12:00:00,2020-06-09 16:00:00,1711.44,1716.31,1,487,62620.9,Exit After X Bars,,None,None,None,None
1422_240906002_B,183,XAUUSD,Buy,2020-06-18 08:00:00,2020-06-18 12:00:00,1731.89,1732.86,1,97,62717.9,Exit After X Bars,,None,None,None,None
1423_240906002_B,183,XAUUSD,Buy,2020-06-26 16:00:00,2020-06-26 20:00:00,1766.27,1767.46,1,119,62836.9,Exit After X Bars,,None,None,None,None
1429_240906002_B,183,XAUUSD,Buy,2020-07-17 16:00:00,2020-07-17 20:00:00,1808.68,1807.75,1,-93,62743.9,Exit After X Bars,,None,None,None,None
1430_240906002_B,183,XAUUSD,Buy,2020-07-31 08:00:00,2020-07-31 12:00:00,1980.49,1976.84,1,-365,62378.9,Exit After X Bars,,None,None,None,None
1435_240906002_B,183,XAUUSD,Buy,2020-08-13 16:00:00,2020-08-13 20:00:00,1948.8,1953.66,1,486,62864.9,Exit After X Bars,,None,None,None,None
1441_240906002_B,183,XAUUSD,Buy,2020-08-26 16:00:00,2020-08-26 20:00:00,1931.71,1943.23,1,1152,64016.9,Exit After X Bars,,None,None,None,None
1442_240906002_B,183,XAUUSD,Buy,2020-08-28 08:00:00,2020-08-28 12:00:00,1954.73,1955.77,1,104,64120.9,Exit After X Bars,,None,None,None,None
1445_240906002_B,183,XAUUSD,Buy,2020-09-04 12:00:00,2020-09-04 16:00:00,1945.61,1927.17,1,-1844,62276.9,Exit After X Bars,,None,None,None,None
1447_240906002_B,183,XAUUSD,Buy,2020-09-08 16:00:00,2020-09-08 20:00:00,1932.43,1938.77,1,634,62910.9,Exit After X Bars,,None,None,None,None
1450_240906002_B,183,XAUUSD,Buy,2020-09-18 16:00:00,2020-09-18 20:00:00,1951.72,1958.73,1,701,63611.9,Exit After X Bars,,None,None,None,None
1456_240906002_B,183,XAUUSD,Buy,2020-09-28 12:00:00,2020-09-28 16:00:00,1872.3,1867.97,1,-433,63178.9,Exit After X Bars,,None,None,None,None
1459_240906002_B,183,XAUUSD,Buy,2020-10-08 20:00:00,2020-10-09 00:00:00,1891.67,1893.54,1,187,63365.9,Exit After X Bars,,None,None,None,None
1462_240906002_B,183,XAUUSD,Buy,2020-10-16 12:00:00,2020-10-16 16:00:00,1912.71,1906.71,1,-600,62765.9,Exit After X Bars,,None,None,None,None
1463_240906002_B,183,XAUUSD,Buy,2020-10-21 04:00:00,2020-10-21 08:00:00,1918.26,1918.98,1,72,62837.9,Exit After X Bars,,None,None,None,None
1467_240906002_B,183,XAUUSD,Buy,2020-10-27 16:00:00,2020-10-27 20:00:00,1908.4,1909.17,1,77,62914.9,Exit After X Bars,,None,None,None,None
1470_240906002_B,183,XAUUSD,Buy,2020-10-30 12:00:00,2020-10-30 16:00:00,1881.62,1887.35,1,573,63487.9,Exit After X Bars,,None,None,None,None
1471_240906002_B,183,XAUUSD,Buy,2020-11-05 08:00:00,2020-11-05 12:00:00,1916.13,1917.0,1,87,63574.9,Exit After X Bars,,None,None,None,None
1475_240906002_B,183,XAUUSD,Buy,2020-11-12 16:00:00,2020-11-12 20:00:00,1881.59,1877.3,1,-429,63145.9,Exit After X Bars,,None,None,None,None
1478_240906002_B,183,XAUUSD,Buy,2020-11-20 12:00:00,2020-11-20 16:00:00,1867.53,1867.3,1,-23,63122.9,Exit After X Bars,,None,None,None,None
1484_240906002_B,183,XAUUSD,Buy,2020-12-01 12:00:00,2020-12-01 16:00:00,1809.45,1812.76,1,331,63453.9,Exit After X Bars,,None,None,None,None
1485_240906002_B,183,XAUUSD,Buy,2020-12-07 16:00:00,2020-12-07 20:00:00,1847.91,1865.34,1,1743,65196.9,Exit After X Bars,,None,None,None,None
1489_240906002_B,183,XAUUSD,Buy,2020-12-15 12:00:00,2020-12-15 16:00:00,1847.55,1852.64,1,509,65705.9,Exit After X Bars,,None,None,None,None
1492_240906002_B,183,XAUUSD,Buy,2020-12-24 20:00:00,2020-12-28 00:00:00,1881.23,1882.92,1,169,65874.9,End Of Friday,,None,None,None,None
1493_240906002_B,183,XAUUSD,Buy,2020-12-30 16:00:00,2020-12-30 20:00:00,1886.22,1888.73,1,251,66125.9,Exit After X Bars,,None,None,None,None
1498_240906002_B,183,XAUUSD,Buy,2021-01-12 20:00:00,2021-01-13 00:00:00,1852.12,1854.33,1,221,66346.9,Exit After X Bars,,None,None,None,None
1501_240906002_B,183,XAUUSD,Buy,2021-01-20 08:00:00,2021-01-20 12:00:00,1855.59,1854.51,1,-108,66238.9,Exit After X Bars,,None,None,None,None
1503_240906002_B,183,XAUUSD,Buy,2021-01-25 12:00:00,2021-01-25 16:00:00,1858.94,1864.87,1,593,66831.9,Exit After X Bars,,None,None,None,None
1506_240906002_B,183,XAUUSD,Buy,2021-01-28 12:00:00,2021-01-28 16:00:00,1850.42,1856.92,1,650,67481.9,Exit After X Bars,,None,None,None,None
1517_240906002_B,183,XAUUSD,Buy,2021-02-19 16:00:00,2021-02-19 20:00:00,1789.28,1783.0,1,-628,66853.9,Exit After X Bars,,None,None,None,None
1526_240906002_B,183,XAUUSD,Buy,2021-03-09 12:00:00,2021-03-09 16:00:00,1707.44,1713.35,1,591,67444.9,Exit After X Bars,,None,None,None,None
1528_240906002_B,183,XAUUSD,Buy,2021-03-17 20:00:00,2021-03-18 00:00:00,1741.02,1744.8,1,378,67822.9,Exit After X Bars,,None,None,None,None
1533_240906002_B,183,XAUUSD,Buy,2021-03-25 16:00:00,2021-03-25 20:00:00,1738.27,1728.18,1,-1009,66813.9,Exit After X Bars,,None,None,None,None
1537_240906002_B,183,XAUUSD,Buy,2021-03-31 16:00:00,2021-03-31 20:00:00,1700.7,1711.84,1,1114,67927.9,Exit After X Bars,,None,None,None,None
1540_240906002_B,183,XAUUSD,Buy,2021-04-13 16:00:00,2021-04-13 20:00:00,1744.86,1742.5,1,-236,67691.9,Exit After X Bars,,None,None,None,None
1541_240906002_B,183,XAUUSD,Buy,2021-04-15 12:00:00,2021-04-15 16:00:00,1748.87,1746.8,1,-207,67484.9,Exit After X Bars,,None,None,None,None
1542_240906002_B,183,XAUUSD,Buy,2021-04-21 16:00:00,2021-04-21 20:00:00,1789.83,1790.73,1,90,67574.9,Exit After X Bars,,None,None,None,None
1544_240906002_B,183,XAUUSD,Buy,2021-04-23 12:00:00,2021-04-23 16:00:00,1790.48,1793.44,1,296,67870.9,Exit After X Bars,,None,None,None,None
1547_240906002_B,183,XAUUSD,Buy,2021-04-29 00:00:00,2021-04-29 04:00:00,1785.41,1784.61,1,-80,67790.9,Exit After X Bars,,None,None,None,None
1550_240906002_B,183,XAUUSD,Buy,2021-05-06 16:00:00,2021-05-06 20:00:00,1798.82,1815.7,1,1688,69478.9,Exit After X Bars,,None,None,None,None
1553_240906002_B,183,XAUUSD,Buy,2021-05-14 20:00:00,2021-05-17 00:00:00,1843.42,1844.53,1,111,69589.9,End Of Friday,,None,None,None,None
1555_240906002_B,183,XAUUSD,Buy,2021-05-28 16:00:00,2021-05-28 20:00:00,1898.65,1899.75,1,110,69699.9,Exit After X Bars,,None,None,None,None
1559_240906002_B,183,XAUUSD,Buy,2021-06-07 20:00:00,2021-06-08 00:00:00,1896.01,1897.97,1,196,69895.9,Exit After X Bars,,None,None,None,None
1561_240906002_B,183,XAUUSD,Buy,2021-06-10 20:00:00,2021-06-11 00:00:00,1898.83,1897.78,1,-105,69790.9,Exit After X Bars,,None,None,None,None
1569_240906002_B,183,XAUUSD,Buy,2021-06-23 16:00:00,2021-06-23 20:00:00,1787.33,1783.21,1,-412,69378.9,Exit After X Bars,,None,None,None,None
1573_240906002_B,183,XAUUSD,Buy,2021-07-01 04:00:00,2021-07-01 08:00:00,1775.78,1774.39,1,-139,69239.9,Exit After X Bars,,None,None,None,None
1574_240906002_B,183,XAUUSD,Buy,2021-07-09 16:00:00,2021-07-09 20:00:00,1809.52,1810.33,1,81,69320.9,Exit After X Bars,,None,None,None,None
1575_240906002_B,183,XAUUSD,Buy,2021-07-13 16:00:00,2021-07-13 20:00:00,1808.36,1811.44,1,308,69628.9,Exit After X Bars,,None,None,None,None
1578_240906002_B,183,XAUUSD,Buy,2021-07-20 12:00:00,2021-07-20 16:00:00,1815.38,1822.68,1,730,70358.9,Exit After X Bars,,None,None,None,None
1580_240906002_B,183,XAUUSD,Buy,2021-07-23 08:00:00,2021-07-23 12:00:00,1808.77,1804.31,1,-446,69912.9,Exit After X Bars,,None,None,None,None
1582_240906002_B,183,XAUUSD,Buy,2021-07-29 00:00:00,2021-07-29 04:00:00,1809.75,1809.44,1,-31,69881.9,Exit After X Bars,,None,None,None,None
1585_240906002_B,183,XAUUSD,Buy,2021-08-04 12:00:00,2021-08-04 16:00:00,1819.34,1827.06,1,772,70653.9,Exit After X Bars,,None,None,None,None
1590_240906002_B,183,XAUUSD,Buy,2021-08-11 12:00:00,2021-08-11 16:00:00,1733.35,1744.61,1,1126,71779.9,Exit After X Bars,,None,None,None,None
1595_240906002_B,183,XAUUSD,Buy,2021-08-26 16:00:00,2021-08-26 20:00:00,1797.6,1792.11,1,-549,71230.9,Exit After X Bars,,None,None,None,None
1597_240906002_B,183,XAUUSD,Buy,2021-09-01 12:00:00,2021-09-01 16:00:00,1816.87,1819.32,1,245,71475.9,Exit After X Bars,,None,None,None,None
1598_240906002_B,183,XAUUSD,Buy,2021-09-03 12:00:00,2021-09-03 16:00:00,1819.82,1823.4,1,358,71833.9,Exit After X Bars,,None,None,None,None
1601_240906002_B,183,XAUUSD,Buy,2021-09-10 08:00:00,2021-09-10 12:00:00,1801.99,1801.59,1,-40,71793.9,Exit After X Bars,,None,None,None,None
1603_240906002_B,183,XAUUSD,Buy,2021-09-14 12:00:00,2021-09-14 16:00:00,1798.15,1797.16,1,-99,71694.9,Exit After X Bars,,None,None,None,None
1607_240906002_B,183,XAUUSD,Buy,2021-09-21 12:00:00,2021-09-21 16:00:00,1767.29,1771.79,1,450,72144.9,Exit After X Bars,,None,None,None,None
1610_240906002_B,183,XAUUSD,Buy,2021-09-27 16:00:00,2021-09-27 20:00:00,1757.47,1752.14,1,-533,71611.9,Exit After X Bars,,None,None,None,None
1612_240906002_B,183,XAUUSD,Buy,2021-09-29 12:00:00,2021-09-29 16:00:00,1743.66,1738.32,1,-534,71077.9,Exit After X Bars,,None,None,None,None
1613_240906002_B,183,XAUUSD,Buy,2021-09-30 16:00:00,2021-09-30 20:00:00,1745.3,1758.15,1,1285,72362.9,Exit After X Bars,,None,None,None,None
1615_240906002_B,183,XAUUSD,Buy,2021-10-06 16:00:00,2021-10-06 20:00:00,1762.83,1762.34,1,-49,72313.9,Exit After X Bars,,None,None,None,None
1617_240906002_B,183,XAUUSD,Buy,2021-10-08 12:00:00,2021-10-08 16:00:00,1764.53,1775.77,1,1124,73437.9,Exit After X Bars,,None,None,None,None
1618_240906002_B,183,XAUUSD,Buy,2021-10-13 16:00:00,2021-10-13 20:00:00,1781.16,1792.5,1,1134,74571.9,Exit After X Bars,,None,None,None,None
1621_240906002_B,183,XAUUSD,Buy,2021-10-19 20:00:00,2021-10-20 00:00:00,1770.99,1769.57,1,-142,74429.9,Exit After X Bars,,None,None,None,None
1623_240906002_B,183,XAUUSD,Buy,2021-10-28 12:00:00,2021-10-28 16:00:00,1804.41,1798.98,1,-543,73886.9,Exit After X Bars,,None,None,None,None
1627_240906002_B,183,XAUUSD,Buy,2021-11-04 12:00:00,2021-11-04 16:00:00,1785.48,1792.52,1,704,74590.9,Exit After X Bars,,None,None,None,None
1635_240906002_B,183,XAUUSD,Buy,2021-11-25 12:00:00,2021-11-25 16:00:00,1792.89,1791.1,1,-179,74411.9,Exit After X Bars,,None,None,None,None
1641_240906002_B,183,XAUUSD,Buy,2021-12-03 16:00:00,2021-12-03 20:00:00,1781.07,1780.42,1,-65,74346.9,Exit After X Bars,,None,None,None,None
1642_240906002_B,183,XAUUSD,Buy,2021-12-07 16:00:00,2021-12-07 20:00:00,1784.81,1783.02,1,-179,74167.9,Exit After X Bars,,None,None,None,None
1644_240906002_B,183,XAUUSD,Buy,2021-12-10 12:00:00,2021-12-10 16:00:00,1783.96,1784.07,1,11,74178.9,Exit After X Bars,,None,None,None,None
1646_240906002_B,183,XAUUSD,Buy,2021-12-16 08:00:00,2021-12-16 12:00:00,1785.54,1785.43,1,-11,74167.9,Exit After X Bars,,None,None,None,None
1648_240906002_B,183,XAUUSD,Buy,2021-12-21 12:00:00,2021-12-21 16:00:00,1799.98,1797.87,1,-211,73956.9,Exit After X Bars,,None,None,None,None
1649_240906002_B,183,XAUUSD,Buy,2021-12-22 20:00:00,2021-12-23 00:00:00,1800.35,1803.8,1,345,74301.9,Exit After X Bars,,None,None,None,None
1651_240906002_B,183,XAUUSD,Buy,2021-12-30 16:00:00,2021-12-30 20:00:00,1805.58,1813.42,1,784,75085.9,Exit After X Bars,,None,None,None,None
1653_240906002_B,183,XAUUSD,Buy,2022-01-05 12:00:00,2022-01-05 16:00:00,1827.35,1825.4,1,-195,74890.9,Exit After X Bars,,None,None,None,None
1656_240906002_B,183,XAUUSD,Buy,2022-01-10 16:00:00,2022-01-10 20:00:00,1798.42,1799.26,1,84,74974.9,Exit After X Bars,,None,None,None,None
1658_240906002_B,183,XAUUSD,Buy,2022-01-19 12:00:00,2022-01-19 16:00:00,1822.18,1823.91,1,173,75147.9,Exit After X Bars,,None,None,None,None
1660_240906002_B,183,XAUUSD,Buy,2022-01-24 20:00:00,2022-01-25 00:00:00,1843.03,1842.67,1,-36,75111.9,Exit After X Bars,,None,None,None,None
1664_240906002_B,183,XAUUSD,Buy,2022-01-31 12:00:00,2022-01-31 16:00:00,1792.71,1797.59,1,488,75599.9,Exit After X Bars,,None,None,None,None
1665_240906002_B,183,XAUUSD,Buy,2022-02-04 16:00:00,2022-02-04 20:00:00,1807.46,1806.29,1,-117,75482.9,Exit After X Bars,,None,None,None,None
1666_240906002_B,183,XAUUSD,Buy,2022-02-11 20:00:00,2022-02-14 00:00:00,1841.75,1859.23,1,1748,77230.9,End Of Friday,,None,None,None,None
1667_240906002_B,183,XAUUSD,Buy,2022-02-17 04:00:00,2022-02-17 08:00:00,1873.87,1874.93,1,106,77336.9,Exit After X Bars,,None,None,None,None
1668_240906002_B,183,XAUUSD,Buy,2022-02-23 16:00:00,2022-02-23 20:00:00,1906.9,1908.22,1,132,77468.9,Exit After X Bars,,None,None,None,None
1670_240906002_B,183,XAUUSD,Buy,2022-02-28 12:00:00,2022-02-28 16:00:00,1913.68,1917.14,1,346,77814.9,Exit After X Bars,,None,None,None,None
1676_240906002_B,183,XAUUSD,Buy,2022-03-17 04:00:00,2022-03-17 08:00:00,1934.59,1935.8,1,121,77935.9,Exit After X Bars,,None,None,None,None
1678_240906002_B,183,XAUUSD,Buy,2022-03-21 20:00:00,2022-03-22 00:00:00,1940.52,1935.43,1,-509,77426.9,Exit After X Bars,,None,None,None,None
1679_240906002_B,183,XAUUSD,Buy,2022-03-23 20:00:00,2022-03-24 00:00:00,1941.01,1942.89,1,188,77614.9,Exit After X Bars,,None,None,None,None
1682_240906002_B,183,XAUUSD,Buy,2022-03-30 12:00:00,2022-03-30 16:00:00,1921.2,1927.08,1,588,78202.9,Exit After X Bars,,None,None,None,None
1684_240906002_B,183,XAUUSD,Buy,2022-04-07 16:00:00,2022-04-07 20:00:00,1936.79,1934.09,1,-270,77932.9,Exit After X Bars,,None,None,None,None
1692_240906002_B,183,XAUUSD,Buy,2022-04-29 08:00:00,2022-04-29 12:00:00,1906.7,1913.84,1,714,78646.9,Exit After X Bars,,None,None,None,None
1695_240906002_B,183,XAUUSD,Buy,2022-05-04 20:00:00,2022-05-05 00:00:00,1877.87,1881.3,1,343,78989.9,Exit After X Bars,,None,None,None,None
1702_240906002_B,183,XAUUSD,Buy,2022-05-16 20:00:00,2022-05-17 00:00:00,1824.33,1824.7,1,37,79026.9,Exit After X Bars,,None,None,None,None
1703_240906002_B,183,XAUUSD,Buy,2022-05-19 12:00:00,2022-05-19 16:00:00,1835.85,1838.19,1,234,79260.9,Exit After X Bars,,None,None,None,None
1705_240906002_B,183,XAUUSD,Buy,2022-05-27 08:00:00,2022-05-27 12:00:00,1859.16,1856.65,1,-251,79009.9,Exit After X Bars,,None,None,None,None
1707_240906002_B,183,XAUUSD,Buy,2022-06-02 12:00:00,2022-06-02 16:00:00,1855.26,1856.51,1,125,79134.9,Exit After X Bars,,None,None,None,None
1710_240906002_B,183,XAUUSD,Buy,2022-06-08 16:00:00,2022-06-08 20:00:00,1857.68,1855.32,1,-236,78898.9,Exit After X Bars,,None,None,None,None
1711_240906002_B,183,XAUUSD,Buy,2022-06-10 16:00:00,2022-06-10 20:00:00,1852.47,1871.61,1,1914,80812.9,Exit After X Bars,,None,None,None,None
1714_240906002_B,183,XAUUSD,Buy,2022-06-15 12:00:00,2022-06-15 16:00:00,1825.58,1831.58,1,600,81412.9,Exit After X Bars,,None,None,None,None
1717_240906002_B,183,XAUUSD,Buy,2022-06-22 12:00:00,2022-06-22 16:00:00,1843.42,1844.59,1,117,81529.9,Exit After X Bars,,None,None,None,None
1722_240906002_B,183,XAUUSD,Buy,2022-06-29 12:00:00,2022-06-29 16:00:00,1827.7,1831.18,1,348,81877.9,Exit After X Bars,,None,None,None,None
1725_240906002_B,183,XAUUSD,Buy,2022-07-05 04:00:00,2022-07-05 08:00:00,1811.61,1811.34,1,-27,81850.9,Exit After X Bars,,None,None,None,None
1728_240906002_B,183,XAUUSD,Buy,2022-07-08 16:00:00,2022-07-08 20:00:00,1748.78,1742.24,1,-654,81196.9,Exit After X Bars,,None,None,None,None
1731_240906002_B,183,XAUUSD,Buy,2022-07-13 16:00:00,2022-07-13 20:00:00,1739.08,1737.85,1,-123,81073.9,Exit After X Bars,,None,None,None,None
1735_240906002_B,183,XAUUSD,Buy,2022-07-21 16:00:00,2022-07-21 20:00:00,1714.32,1711.62,1,-270,80803.9,Exit After X Bars,,None,None,None,None
1737_240906002_B,183,XAUUSD,Buy,2022-07-27 20:00:00,2022-07-28 00:00:00,1724.26,1734.05,1,979,81782.9,Exit After X Bars,,None,None,None,None
1738_240906002_B,183,XAUUSD,Buy,2022-08-04 12:00:00,2022-08-04 16:00:00,1787.75,1780.64,1,-711,81071.9,Exit After X Bars,,None,None,None,None
1740_240906002_B,183,XAUUSD,Buy,2022-08-08 16:00:00,2022-08-08 20:00:00,1789.02,1787.56,1,-146,80925.9,Exit After X Bars,,None,None,None,None
1742_240906002_B,183,XAUUSD,Buy,2022-08-12 20:00:00,2022-08-15 00:00:00,1799.07,1802.31,1,324,81249.9,End Of Friday,,None,None,None,None
1749_240906002_B,183,XAUUSD,Buy,2022-08-23 16:00:00,2022-08-23 20:00:00,1739.78,1749.64,1,986,82235.9,Exit After X Bars,,None,None,None,None
1755_240906002_B,183,XAUUSD,Buy,2022-09-02 12:00:00,2022-09-02 16:00:00,1708.44,1708.73,1,29,82264.9,Exit After X Bars,,None,None,None,None
1757_240906002_B,183,XAUUSD,Buy,2022-09-07 16:00:00,2022-09-07 20:00:00,1714.84,1714.98,1,14,82278.9,Exit After X Bars,,None,None,None,None
1758_240906002_B,183,XAUUSD,Buy,2022-09-09 04:00:00,2022-09-09 08:00:00,1719.24,1721.24,1,200,82478.9,Exit After X Bars,,None,None,None,None
1765_240906002_B,183,XAUUSD,Buy,2022-09-21 20:00:00,2022-09-22 00:00:00,1669.99,1673.04,1,305,82783.9,Exit After X Bars,,None,None,None,None
1769_240906002_B,183,XAUUSD,Buy,2022-09-28 16:00:00,2022-09-28 20:00:00,1642.19,1659.16,1,1697,84480.9,Exit After X Bars,,None,None,None,None
1777_240906002_B,183,XAUUSD,Buy,2022-10-17 12:00:00,2022-10-17 16:00:00,1663.68,1666.48,1,280,84760.9,Exit After X Bars,,None,None,None,None
1780_240906002_B,183,XAUUSD,Buy,2022-10-20 16:00:00,2022-10-20 20:00:00,1641.91,1636.03,1,-588,84172.9,Exit After X Bars,,None,None,None,None
1781_240906002_B,183,XAUUSD,Buy,2022-10-21 16:00:00,2022-10-21 20:00:00,1645.31,1651.3,1,599,84771.9,Exit After X Bars,,None,None,None,None
1782_240906002_B,183,XAUUSD,Buy,2022-10-25 16:00:00,2022-10-25 20:00:00,1654.19,1653.14,1,-105,84666.9,Exit After X Bars,,None,None,None,None
1784_240906002_B,183,XAUUSD,Buy,2022-11-01 12:00:00,2022-11-01 16:00:00,1652.81,1653.8,1,99,84765.9,Exit After X Bars,,None,None,None,None
1785_240906002_B,183,XAUUSD,Buy,2022-11-04 16:00:00,2022-11-04 20:00:00,1669.17,1673.16,1,399,85164.9,Exit After X Bars,,None,None,None,None
1790_240906002_B,183,XAUUSD,Buy,2022-11-23 20:00:00,2022-11-24 00:00:00,1749.49,1749.33,1,-16,85148.9,Exit After X Bars,,None,None,None,None
1792_240906002_B,183,XAUUSD,Buy,2022-11-29 08:00:00,2022-11-29 12:00:00,1756.12,1753.91,1,-221,84927.9,Exit After X Bars,,None,None,None,None
1795_240906002_B,183,XAUUSD,Buy,2022-12-07 16:00:00,2022-12-07 20:00:00,1780.57,1782.96,1,239,85166.9,Exit After X Bars,,None,None,None,None
1797_240906002_B,183,XAUUSD,Buy,2022-12-13 12:00:00,2022-12-13 16:00:00,1795.25,1810.86,1,1561,86727.9,Exit After X Bars,,None,None,None,None
1799_240906002_B,183,XAUUSD,Buy,2022-12-16 12:00:00,2022-12-16 16:00:00,1785.81,1785.4,1,-41,86686.9,Exit After X Bars,,None,None,None,None
1804_240906002_B,183,XAUUSD,Buy,2023-01-06 12:00:00,2023-01-06 16:00:00,1850.91,1851.63,1,72,86758.9,Exit After X Bars,,None,None,None,None
1805_240906002_B,183,XAUUSD,Buy,2023-01-18 12:00:00,2023-01-18 16:00:00,1919.03,1921.2,1,217,86975.9,Exit After X Bars,,None,None,None,None
1806_240906002_B,183,XAUUSD,Buy,2023-01-23 20:00:00,2023-01-24 00:00:00,1931.11,1930.6,1,-51,86924.9,Exit After X Bars,,None,None,None,None
1807_240906002_B,183,XAUUSD,Buy,2023-01-25 16:00:00,2023-01-25 20:00:00,1939.2,1937.2,1,-200,86724.9,Exit After X Bars,,None,None,None,None
1811_240906002_B,183,XAUUSD,Buy,2023-01-31 20:00:00,2023-02-01 00:00:00,1930.57,1927.54,1,-303,86421.9,Exit After X Bars,,None,None,None,None
1815_240906002_B,183,XAUUSD,Buy,2023-02-07 16:00:00,2023-02-07 20:00:00,1875.46,1880.47,1,501,86922.9,Exit After X Bars,,None,None,None,None
1818_240906002_B,183,XAUUSD,Buy,2023-02-14 12:00:00,2023-02-14 16:00:00,1868.25,1862.46,1,-579,86343.9,Exit After X Bars,,None,None,None,None
1820_240906002_B,183,XAUUSD,Buy,2023-02-16 16:00:00,2023-02-16 20:00:00,1842.05,1842.34,1,29,86372.9,Exit After X Bars,,None,None,None,None
1823_240906002_B,183,XAUUSD,Buy,2023-02-22 12:00:00,2023-02-22 16:00:00,1843.66,1838.54,1,-512,85860.9,Exit After X Bars,,None,None,None,None
1827_240906002_B,183,XAUUSD,Buy,2023-02-28 16:00:00,2023-02-28 20:00:00,1819.97,1829.15,1,918,86778.9,Exit After X Bars,,None,None,None,None
1830_240906002_B,183,XAUUSD,Buy,2023-03-09 12:00:00,2023-03-09 16:00:00,1824.08,1825.06,1,98,86876.9,Exit After X Bars,,None,None,None,None
1831_240906002_B,183,XAUUSD,Buy,2023-03-15 12:00:00,2023-03-15 16:00:00,1911.59,1927.72,1,1613,88489.9,Exit After X Bars,,None,None,None,None
1833_240906002_B,183,XAUUSD,Buy,2023-03-22 20:00:00,2023-03-23 00:00:00,1969.52,1969.71,1,19,88508.9,Exit After X Bars,,None,None,None,None
1835_240906002_B,183,XAUUSD,Buy,2023-03-28 16:00:00,2023-03-28 20:00:00,1968.46,1968.94,1,48,88556.9,Exit After X Bars,,None,None,None,None
1836_240906002_B,183,XAUUSD,Buy,2023-03-30 12:00:00,2023-03-30 16:00:00,1975.03,1970.18,1,-485,88071.9,Exit After X Bars,,None,None,None,None
1837_240906002_B,183,XAUUSD,Buy,2023-04-03 16:00:00,2023-04-03 20:00:00,1987.4,1986.82,1,-58,88013.9,Exit After X Bars,,None,None,None,None
1840_240906002_B,183,XAUUSD,Buy,2023-04-11 16:00:00,2023-04-11 20:00:00,2002.73,2006.04,1,331,88344.9,Exit After X Bars,,None,None,None,None
1844_240906002_B,183,XAUUSD,Buy,2023-04-20 16:00:00,2023-04-20 20:00:00,2011.64,2005.64,1,-600,87744.9,Exit After X Bars,,None,None,None,None
1846_240906002_B,183,XAUUSD,Buy,2023-04-25 00:00:00,2023-04-25 04:00:00,1997.73,1996.92,1,-81,87663.9,Exit After X Bars,,None,None,None,None
1850_240906002_B,183,XAUUSD,Buy,2023-05-01 12:00:00,2023-05-01 16:00:00,1994.86,2004.07,1,921,88584.9,Exit After X Bars,,None,None,None,None
1851_240906002_B,183,XAUUSD,Buy,2023-05-02 16:00:00,2023-05-02 20:00:00,2005.8,2015.04,1,924,89508.9,Exit After X Bars,,None,None,None,None
1854_240906002_B,183,XAUUSD,Buy,2023-05-09 12:00:00,2023-05-09 16:00:00,2029.17,2026.93,1,-224,89284.9,Exit After X Bars,,None,None,None,None
1861_240906002_B,183,XAUUSD,Buy,2023-05-19 16:00:00,2023-05-19 20:00:00,1978.67,1978.26,1,-41,89243.9,Exit After X Bars,,None,None,None,None
1862_240906002_B,183,XAUUSD,Buy,2023-05-24 12:00:00,2023-05-24 16:00:00,1982.36,1979.84,1,-252,88991.9,Exit After X Bars,,None,None,None,None
1865_240906002_B,183,XAUUSD,Buy,2023-05-30 12:00:00,2023-05-30 16:00:00,1954.0,1956.33,1,233,89224.9,Exit After X Bars,,None,None,None,None
1866_240906002_B,183,XAUUSD,Buy,2023-06-01 16:00:00,2023-06-01 20:00:00,1974.55,1978.31,1,376,89600.9,Exit After X Bars,,None,None,None,None
1869_240906002_B,183,XAUUSD,Buy,2023-06-06 12:00:00,2023-06-06 16:00:00,1963.87,1961.75,1,-212,89388.9,Exit After X Bars,,None,None,None,None
1871_240906002_B,183,XAUUSD,Buy,2023-06-08 16:00:00,2023-06-08 20:00:00,1970.01,1966.18,1,-383,89005.9,Exit After X Bars,,None,None,None,None
1875_240906002_B,183,XAUUSD,Buy,2023-06-16 04:00:00,2023-06-16 08:00:00,1960.15,1955.39,1,-476,88529.9,Exit After X Bars,,None,None,None,None
1880_240906002_B,183,XAUUSD,Buy,2023-06-23 16:00:00,2023-06-23 20:00:00,1930.78,1918.59,1,-1219,87310.9,Exit After X Bars,,None,None,None,None
1884_240906002_B,183,XAUUSD,Buy,2023-06-30 12:00:00,2023-06-30 16:00:00,1912.92,1910.94,1,-198,87112.9,Exit After X Bars,,None,None,None,None
1887_240906002_B,183,XAUUSD,Buy,2023-07-07 12:00:00,2023-07-07 16:00:00,1927.45,1918.66,1,-879,86233.9,Exit After X Bars,,None,None,None,None
1888_240906002_B,183,XAUUSD,Buy,2023-07-11 08:00:00,2023-07-11 12:00:00,1934.69,1936.49,1,180,86413.9,Exit After X Bars,,None,None,None,None
1889_240906002_B,183,XAUUSD,Buy,2023-07-18 08:00:00,2023-07-18 12:00:00,1962.45,1961.65,1,-80,86333.9,Exit After X Bars,,None,None,None,None
1893_240906002_B,183,XAUUSD,Buy,2023-07-26 08:00:00,2023-07-26 12:00:00,1967.66,1972.0,1,434,86767.9,Exit After X Bars,,None,None,None,None
1896_240906002_B,183,XAUUSD,Buy,2023-07-31 12:00:00,2023-07-31 16:00:00,1963.31,1965.36,1,205,86972.9,Exit After X Bars,,None,None,None,None
1900_240906002_B,183,XAUUSD,Buy,2023-08-04 12:00:00,2023-08-04 16:00:00,1938.56,1938.92,1,36,87008.9,Exit After X Bars,,None,None,None,None
1904_240906002_B,183,XAUUSD,Buy,2023-08-10 12:00:00,2023-08-10 16:00:00,1928.18,1926.09,1,-209,86799.9,Exit After X Bars,,None,None,None,None
1911_240906002_B,183,XAUUSD,Buy,2023-08-21 12:00:00,2023-08-21 16:00:00,1896.6,1897.12,1,52,86851.9,Exit After X Bars,,None,None,None,None
1913_240906002_B,183,XAUUSD,Buy,2023-08-28 16:00:00,2023-08-28 20:00:00,1922.18,1920.52,1,-166,86685.9,Exit After X Bars,,None,None,None,None
1919_240906002_B,183,XAUUSD,Buy,2023-09-08 16:00:00,2023-09-08 20:00:00,1924.32,1919.53,1,-479,86206.9,Exit After X Bars,,None,None,None,None
1922_240906002_B,183,XAUUSD,Buy,2023-09-15 04:00:00,2023-09-15 08:00:00,1915.61,1916.0,1,39,86245.9,Exit After X Bars,,None,None,None,None
1923_240906002_B,183,XAUUSD,Buy,2023-09-20 16:00:00,2023-09-20 20:00:00,1937.21,1946.6,1,939,87184.9,Exit After X Bars,,None,None,None,None
1925_240906002_B,183,XAUUSD,Buy,2023-09-22 20:00:00,2023-09-25 00:00:00,1925.94,1924.34,1,-160,87024.9,End Of Friday,,None,None,None,None
1930_240906002_B,183,XAUUSD,Buy,2023-09-29 16:00:00,2023-09-29 20:00:00,1879.32,1853.54,1,-2578,84446.9,Exit After X Bars,,None,None,None,None
1935_240906002_B,183,XAUUSD,Buy,2023-10-06 16:00:00,2023-10-06 20:00:00,1823.66,1829.1,1,544,84990.9,Exit After X Bars,,None,None,None,None
1937_240906002_B,183,XAUUSD,Buy,2023-10-25 16:00:00,2023-10-25 20:00:00,1977.31,1978.15,1,84,85074.9,Exit After X Bars,,None,None,None,None
1940_240906002_B,183,XAUUSD,Buy,2023-11-03 12:00:00,2023-11-03 16:00:00,1991.83,2000.05,1,822,85896.9,Exit After X Bars,,None,None,None,None
1947_240906002_B,183,XAUUSD,Buy,2023-11-14 12:00:00,2023-11-14 16:00:00,1948.99,1954.21,1,522,86418.9,Exit After X Bars,,None,None,None,None
1948_240906002_B,183,XAUUSD,Buy,2023-11-21 04:00:00,2023-11-21 08:00:00,1993.22,1991.69,1,-153,86265.9,Exit After X Bars,,None,None,None,None
1949_240906002_B,183,XAUUSD,Buy,2023-11-24 16:00:00,2023-11-27 00:00:00,2003.16,2001.0,1,-216,86049.9,End Of Friday,,None,None,None,None
1950_240906002_B,183,XAUUSD,Buy,2023-12-01 08:00:00,2023-12-01 12:00:00,2049.3,2046.33,1,-297,85752.9,Exit After X Bars,,None,None,None,None
1953_240906002_B,183,XAUUSD,Buy,2023-12-06 12:00:00,2023-12-06 16:00:00,2030.64,2030.17,1,-47,85705.9,Exit After X Bars,,None,None,None,None
1956_240906002_B,183,XAUUSD,Buy,2023-12-12 12:00:00,2023-12-12 16:00:00,1996.47,1984.35,1,-1212,84493.9,Exit After X Bars,,None,None,None,None
1957_240906002_B,183,XAUUSD,Buy,2023-12-13 20:00:00,2023-12-14 00:00:00,1996.45,2025.95,1,2950,87443.9,Exit After X Bars,,None,None,None,None
1959_240906002_B,183,XAUUSD,Buy,2023-12-19 16:00:00,2023-12-19 20:00:00,2033.46,2040.32,1,686,88129.9,Exit After X Bars,,None,None,None,None
1961_240906002_B,183,XAUUSD,Buy,2024-01-02 16:00:00,2024-01-02 20:00:00,2068.66,2062.65,1,-601,87528.9,Exit After X Bars,,None,None,None,None
1964_240906002_B,183,XAUUSD,Buy,2024-01-05 16:00:00,2024-01-05 20:00:00,2050.68,2041.84,1,-884,86644.9,Exit After X Bars,,None,None,None,None
1966_240906002_B,183,XAUUSD,Buy,2024-01-09 12:00:00,2024-01-09 16:00:00,2036.66,2038.49,1,183,86827.9,Exit After X Bars,,None,None,None,None
1967_240906002_B,183,XAUUSD,Buy,2024-01-11 12:00:00,2024-01-11 16:00:00,2041.8,2029.37,1,-1243,85584.9,Exit After X Bars,,None,None,None,None
1970_240906002_B,183,XAUUSD,Buy,2024-01-19 08:00:00,2024-01-19 12:00:00,2028.81,2029.64,1,83,85667.9,Exit After X Bars,,None,None,None,None
1977_240906002_B,183,XAUUSD,Buy,2024-02-06 12:00:00,2024-02-06 16:00:00,2028.43,2029.07,1,64,85731.9,Exit After X Bars,,None,None,None,None
1984_240906002_B,183,XAUUSD,Buy,2024-02-23 16:00:00,2024-02-23 20:00:00,2031.05,2037.91,1,686,86417.9,Exit After X Bars,,None,None,None,None
1985_240906002_B,183,XAUUSD,Buy,2024-02-29 12:00:00,2024-02-29 16:00:00,2038.94,2047.56,1,862,87279.9,Exit After X Bars,,None,None,None,None
1992_240906002_B,183,XAUUSD,Buy,2024-03-20 16:00:00,2024-03-20 20:00:00,2159.51,2157.61,1,-190,87089.9,Exit After X Bars,,None,None,None,None
1994_240906002_B,183,XAUUSD,Buy,2024-03-25 16:00:00,2024-03-25 20:00:00,2179.94,2175.72,1,-422,86667.9,Exit After X Bars,,None,None,None,None
1996_240906002_B,183,XAUUSD,Buy,2024-04-11 20:00:00,2024-04-12 00:00:00,2354.54,2371.5,1,1696,88363.9,Exit After X Bars,,None,None,None,None
2000_240906002_B,183,XAUUSD,Buy,2024-04-24 16:00:00,2024-04-24 20:00:00,2331.89,2324.97,1,-692,87671.9,Exit After X Bars,,None,None,None,None
2002_240906002_B,183,XAUUSD,Buy,2024-05-01 20:00:00,2024-05-02 00:00:00,2317.8,2319.3,1,150,87821.9,Exit After X Bars,,None,None,None,None
2006_240906002_B,183,XAUUSD,Buy,2024-05-09 12:00:00,2024-05-09 16:00:00,2320.87,2326.59,1,572,88393.9,Exit After X Bars,,None,None,None,None
2008_240906002_B,183,XAUUSD,Buy,2024-05-14 12:00:00,2024-05-14 16:00:00,2349.55,2348.16,1,-139,88254.9,Exit After X Bars,,None,None,None,None
2012_240906002_B,183,XAUUSD,Buy,2024-05-27 12:00:00,2024-05-27 16:00:00,2347.13,2347.06,1,-7,88247.9,Exit After X Bars,,None,None,None,None
2014_240906002_B,183,XAUUSD,Buy,2024-05-30 16:00:00,2024-05-30 20:00:00,2346.93,2347.76,1,83,88330.9,Exit After X Bars,,None,None,None,None
2015_240906002_B,183,XAUUSD,Buy,2024-05-31 12:00:00,2024-05-31 16:00:00,2351.57,2354.55,1,298,88628.9,Exit After X Bars,,None,None,None,None
2018_240906002_B,183,XAUUSD,Buy,2024-06-05 12:00:00,2024-06-05 16:00:00,2337.86,2342.02,1,416,89044.9,Exit After X Bars,,None,None,None,None
2021_240906002_B,183,XAUUSD,Buy,2024-06-11 12:00:00,2024-06-11 16:00:00,2313.51,2317.84,1,433,89477.9,Exit After X Bars,,None,None,None,None
2023_240906002_B,183,XAUUSD,Buy,2024-06-18 16:00:00,2024-06-18 20:00:00,2327.4,2330.19,1,279,89756.9,Exit After X Bars,,None,None,None,None
2026_240906002_B,183,XAUUSD,Buy,2024-06-25 12:00:00,2024-06-25 16:00:00,2334.51,2324.05,1,-1046,88710.9,Exit After X Bars,,None,None,None,None
2028_240906002_B,183,XAUUSD,Buy,2024-06-27 12:00:00,2024-06-27 16:00:00,2318.19,2322.74,1,455,89165.9,Exit After X Bars,,None,None,None,None
2029_240906002_B,183,XAUUSD,Buy,2024-07-03 08:00:00,2024-07-03 12:00:00,2338.32,2344.55,1,623,89788.9,Exit After X Bars,,None,None,None,None
2031_240906002_B,183,XAUUSD,Buy,2024-07-10 12:00:00,2024-07-10 16:00:00,2379.28,2377.69,1,-159,89629.9,Exit After X Bars,,None,None,None,None
2035_240906002_B,183,XAUUSD,Buy,2024-07-23 12:00:00,2024-07-23 16:00:00,2408.12,2405.27,1,-285,89344.9,Exit After X Bars,,None,None,None,None
2037_240906002_B,183,XAUUSD,Buy,2024-07-26 16:00:00,2024-07-26 20:00:00,2382.3,2389.07,1,677,90021.9,Exit After X Bars,,None,None,None,None
2041_240906002_B,183,XAUUSD,Buy,2024-08-08 16:00:00,2024-08-08 20:00:00,2416.04,2417.99,1,195,90216.9,Exit After X Bars,,None,None,None,None
2043_240906002_B,183,XAUUSD,Buy,2024-08-16 12:00:00,2024-08-16 16:00:00,2479.54,2491.56,1,1202,91418.9,Exit After X Bars,,None,None,None,None
2045_240906002_B,183,XAUUSD,Buy,2024-08-23 16:00:00,2024-08-23 20:00:00,2508.87,2510.2,1,133,91551.9,Exit After X Bars,,None,None,None,None
2047_240906002_B,183,XAUUSD,Buy,2024-08-29 16:00:00,2024-08-29 20:00:00,2515.1,2525.14,1,1004,92555.9,Exit After X Bars,,None,None,None,None
