orderId,strategyRunId,symbol,orderType,openTime,closeTime,openPrice,closePrice,size,profit,balance,closeType,comment,sl,tp,swap,commission
4_240906004_B,185,XAUUSD,Buy,2011-01-07 16:00:00,2011-01-07 20:00:00,1377.0,1367.74,1,-926,9074,Exit After X Bars,,None,None,None,None
6_240906004_B,185,XAUUSD,Buy,2011-01-18 08:00:00,2011-01-18 12:00:00,1370.12,1370.18,1,6,9080,Exit After X Bars,,None,None,None,None
11_240906004_B,185,XAUUSD,Buy,2011-01-26 20:00:00,2011-01-27 00:00:00,1335.09,1345.98,1,1089,10169,Exit After X Bars,,None,None,None,None
13_240906004_B,185,XAUUSD,Buy,2011-01-28 16:00:00,2011-01-28 20:00:00,1340.8,1343.01,1,221,10390,Exit After X Bars,,None,None,None,None
16_240906004_B,185,XAUUSD,Buy,2011-02-03 16:00:00,2011-02-03 20:00:00,1339.44,1353.88,1,1444,11834,Exit After X Bars,,None,None,None,None
17_240906004_B,185,XAUUSD,Buy,2011-02-11 12:00:00,2011-02-11 16:00:00,1366.88,1365.53,1,-135,11699,Exit After X Bars,,None,None,None,None
18_240906004_B,185,XAUUSD,Buy,2011-02-15 08:00:00,2011-02-15 12:00:00,1368.33,1371.67,1,334,12033,Exit After X Bars,,None,None,None,None
19_240906004_B,185,XAUUSD,Buy,2011-02-23 16:00:00,2011-02-23 20:00:00,1410.71,1415.25,1,454,12487,Exit After X Bars,,None,None,None,None
22_240906004_B,185,XAUUSD,Buy,2011-03-04 16:00:00,2011-03-04 20:00:00,1431.94,1427.88,1,-406,12081,Exit After X Bars,,None,None,None,None
29_240906004_B,185,XAUUSD,Buy,2011-03-18 00:00:00,2011-03-18 04:00:00,1406.0,1406.99,1,99,12180,Exit After X Bars,,None,None,None,None
30_240906004_B,185,XAUUSD,Buy,2011-03-23 16:00:00,2011-03-23 20:00:00,1434.79,1439.58,1,479,12659,Exit After X Bars,,None,None,None,None
33_240906004_B,185,XAUUSD,Buy,2011-03-29 16:00:00,2011-03-29 20:00:00,1423.19,1416.52,1,-667,11992,Exit After X Bars,,None,None,None,None
36_240906004_B,185,XAUUSD,Buy,2011-04-14 16:00:00,2011-04-14 20:00:00,1467.01,1471.83,1,482,12474,Exit After X Bars,,None,None,None,None
37_240906004_B,185,XAUUSD,Buy,2011-04-27 20:00:00,2011-04-28 00:00:00,1518.09,1526.72,1,863,13337,Exit After X Bars,,None,None,None,None
47_240906004_B,185,XAUUSD,Buy,2011-05-20 08:00:00,2011-05-20 12:00:00,1499.8,1502.02,1,222,13559,Exit After X Bars,,None,None,None,None
48_240906004_B,185,XAUUSD,Buy,2011-05-27 16:00:00,2011-05-27 20:00:00,1532.17,1537.36,1,519,14078,Exit After X Bars,,None,None,None,None
49_240906004_B,185,XAUUSD,Buy,2011-06-01 16:00:00,2011-06-01 20:00:00,1540.69,1545.4,1,471,14549,Exit After X Bars,,None,None,None,None
51_240906004_B,185,XAUUSD,Buy,2011-06-03 16:00:00,2011-06-03 20:00:00,1544.37,1541.86,1,-251,14298,Exit After X Bars,,None,None,None,None
53_240906004_B,185,XAUUSD,Buy,2011-06-09 16:00:00,2011-06-09 20:00:00,1542.99,1544.6,1,161,14459,Exit After X Bars,,None,None,None,None
57_240906004_B,185,XAUUSD,Buy,2011-06-15 16:00:00,2011-06-15 20:00:00,1527.24,1524.58,1,-266,14193,Exit After X Bars,,None,None,None,None
58_240906004_B,185,XAUUSD,Buy,2011-06-17 16:00:00,2011-06-17 20:00:00,1532.85,1534.88,1,203,14396,Exit After X Bars,,None,None,None,None
62_240906004_B,185,XAUUSD,Buy,2011-06-28 12:00:00,2011-06-28 16:00:00,1503.22,1500.35,1,-287,14109,Exit After X Bars,,None,None,None,None
65_240906004_B,185,XAUUSD,Buy,2011-07-04 16:00:00,2011-07-04 20:00:00,1494.78,1495.57,1,79,14188,Exit After X Bars,,None,None,None,None
68_240906004_B,185,XAUUSD,Buy,2011-07-22 12:00:00,2011-07-22 16:00:00,1601.95,1602.23,1,28,14216,Exit After X Bars,,None,None,None,None
71_240906004_B,185,XAUUSD,Buy,2011-07-29 12:00:00,2011-07-29 16:00:00,1619.94,1623.19,1,325,14541,Exit After X Bars,,None,None,None,None
75_240906004_B,185,XAUUSD,Buy,2011-08-15 20:00:00,2011-08-16 00:00:00,1763.99,1765.36,1,137,14678,Exit After X Bars,,None,None,None,None
79_240906004_B,185,XAUUSD,Buy,2011-08-26 16:00:00,2011-08-26 20:00:00,1774.48,1786.25,1,1177,15855,Exit After X Bars,,None,None,None,None
82_240906004_B,185,XAUUSD,Buy,2011-09-08 12:00:00,2011-09-08 16:00:00,1846.66,1858.15,1,1149,17004,Exit After X Bars,,None,None,None,None
88_240906004_B,185,XAUUSD,Buy,2011-09-16 16:00:00,2011-09-16 20:00:00,1815.49,1813.72,1,-177,16827,Exit After X Bars,,None,None,None,None
96_240906004_B,185,XAUUSD,Buy,2011-09-30 16:00:00,2011-09-30 20:00:00,1630.53,1628.65,1,-188,16639,Exit After X Bars,,None,None,None,None
105_240906004_B,185,XAUUSD,Buy,2011-10-21 12:00:00,2011-10-21 16:00:00,1630.3,1642.71,1,1241,17880,Exit After X Bars,,None,None,None,None
107_240906004_B,185,XAUUSD,Buy,2011-11-02 04:00:00,2011-11-02 08:00:00,1727.64,1721.86,1,-578,17302,Exit After X Bars,,None,None,None,None
109_240906004_B,185,XAUUSD,Buy,2011-11-11 16:00:00,2011-11-11 20:00:00,1775.27,1786.78,1,1151,18453,Exit After X Bars,,None,None,None,None
118_240906004_B,185,XAUUSD,Buy,2011-11-30 12:00:00,2011-11-30 16:00:00,1726.42,1744.48,1,1806,20259,Exit After X Bars,,None,None,None,None
121_240906004_B,185,XAUUSD,Buy,2011-12-07 12:00:00,2011-12-07 16:00:00,1732.9,1733.37,1,47,20306,Exit After X Bars,,None,None,None,None
128_240906004_B,185,XAUUSD,Buy,2011-12-16 16:00:00,2011-12-16 20:00:00,1593.79,1593.08,1,-71,20235,Exit After X Bars,,None,None,None,None
135_240906004_B,185,XAUUSD,Buy,2012-01-10 12:00:00,2012-01-10 16:00:00,1630.85,1636.35,1,550,20785,Exit After X Bars,,None,None,None,None
137_240906004_B,185,XAUUSD,Buy,2012-01-19 08:00:00,2012-01-19 12:00:00,1666.72,1665.42,1,-130,20655,Exit After X Bars,,None,None,None,None
138_240906004_B,185,XAUUSD,Buy,2012-01-20 16:00:00,2012-01-20 20:00:00,1665.66,1663.26,1,-240,20415,Exit After X Bars,,None,None,None,None
140_240906004_B,185,XAUUSD,Buy,2012-01-25 16:00:00,2012-01-25 20:00:00,1670.85,1689.7,1,1885,22300,Exit After X Bars,,None,None,None,None
143_240906004_B,185,XAUUSD,Buy,2012-02-07 16:00:00,2012-02-07 20:00:00,1725.15,1746.27,1,2112,24412,Exit After X Bars,,None,None,None,None
145_240906004_B,185,XAUUSD,Buy,2012-02-13 16:00:00,2012-02-13 20:00:00,1724.29,1723.02,1,-127,24285,Exit After X Bars,,None,None,None,None
146_240906004_B,185,XAUUSD,Buy,2012-02-15 16:00:00,2012-02-15 20:00:00,1732.49,1727.41,1,-508,23777,Exit After X Bars,,None,None,None,None
149_240906004_B,185,XAUUSD,Buy,2012-02-28 12:00:00,2012-02-28 16:00:00,1782.43,1780.06,1,-237,23540,Exit After X Bars,,None,None,None,None
155_240906004_B,185,XAUUSD,Buy,2012-03-08 08:00:00,2012-03-08 12:00:00,1692.95,1701.02,1,807,24347,Exit After X Bars,,None,None,None,None
156_240906004_B,185,XAUUSD,Buy,2012-03-09 16:00:00,2012-03-09 20:00:00,1703.86,1711.65,1,779,25126,Exit After X Bars,,None,None,None,None
163_240906004_B,185,XAUUSD,Buy,2012-03-21 16:00:00,2012-03-21 20:00:00,1657.91,1650.22,1,-769,24357,Exit After X Bars,,None,None,None,None
164_240906004_B,185,XAUUSD,Buy,2012-03-23 16:00:00,2012-03-23 20:00:00,1661.83,1662.57,1,74,24431,Exit After X Bars,,None,None,None,None
167_240906004_B,185,XAUUSD,Buy,2012-03-30 12:00:00,2012-03-30 16:00:00,1663.76,1665.58,1,182,24613,Exit After X Bars,,None,None,None,None
170_240906004_B,185,XAUUSD,Buy,2012-04-06 12:00:00,2012-04-06 16:00:00,1633.4,1641.71,1,831,25444,Exit After X Bars,,None,None,None,None
174_240906004_B,185,XAUUSD,Buy,2012-04-19 16:00:00,2012-04-19 20:00:00,1648.83,1639.67,1,-916,24528,Exit After X Bars,,None,None,None,None
177_240906004_B,185,XAUUSD,Buy,2012-04-24 12:00:00,2012-04-24 16:00:00,1639.14,1642.25,1,311,24839,Exit After X Bars,,None,None,None,None
178_240906004_B,185,XAUUSD,Buy,2012-04-26 08:00:00,2012-04-26 12:00:00,1649.17,1648.76,1,-41,24798,Exit After X Bars,,None,None,None,None
179_240906004_B,185,XAUUSD,Buy,2012-05-01 00:00:00,2012-05-01 04:00:00,1667.34,1665.58,1,-176,24622,Exit After X Bars,,None,None,None,None
186_240906004_B,185,XAUUSD,Buy,2012-05-10 16:00:00,2012-05-10 20:00:00,1595.88,1595.78,1,-10,24612,Exit After X Bars,,None,None,None,None
190_240906004_B,185,XAUUSD,Buy,2012-05-17 16:00:00,2012-05-17 20:00:00,1564.05,1576.13,1,1208,25820,Exit After X Bars,,None,None,None,None
193_240906004_B,185,XAUUSD,Buy,2012-05-24 12:00:00,2012-05-24 16:00:00,1564.59,1575.66,1,1107,26927,Exit After X Bars,,None,None,None,None
196_240906004_B,185,XAUUSD,Buy,2012-06-01 12:00:00,2012-06-01 16:00:00,1573.32,1581.44,1,812,27739,Exit After X Bars,,None,None,None,None
199_240906004_B,185,XAUUSD,Buy,2012-06-11 12:00:00,2012-06-11 16:00:00,1595.02,1593.62,1,-140,27599,Exit After X Bars,,None,None,None,None
200_240906004_B,185,XAUUSD,Buy,2012-06-19 08:00:00,2012-06-19 12:00:00,1632.45,1629.85,1,-260,27339,Exit After X Bars,,None,None,None,None
204_240906004_B,185,XAUUSD,Buy,2012-06-25 16:00:00,2012-06-25 20:00:00,1573.33,1583.29,1,996,28335,Exit After X Bars,,None,None,None,None
207_240906004_B,185,XAUUSD,Buy,2012-06-29 12:00:00,2012-06-29 16:00:00,1583.01,1597.36,1,1435,29770,Exit After X Bars,,None,None,None,None
211_240906004_B,185,XAUUSD,Buy,2012-07-10 12:00:00,2012-07-10 16:00:00,1592.83,1600.83,1,800,30570,Exit After X Bars,,None,None,None,None
213_240906004_B,185,XAUUSD,Buy,2012-07-13 12:00:00,2012-07-13 16:00:00,1581.33,1582.39,1,106,30676,Exit After X Bars,,None,None,None,None
215_240906004_B,185,XAUUSD,Buy,2012-07-19 12:00:00,2012-07-19 16:00:00,1583.13,1584.15,1,102,30778,Exit After X Bars,,None,None,None,None
218_240906004_B,185,XAUUSD,Buy,2012-07-24 16:00:00,2012-07-24 20:00:00,1580.34,1575.79,1,-455,30323,Exit After X Bars,,None,None,None,None
224_240906004_B,185,XAUUSD,Buy,2012-08-10 16:00:00,2012-08-10 20:00:00,1618.34,1621.52,1,318,30641,Exit After X Bars,,None,None,None,None
226_240906004_B,185,XAUUSD,Buy,2012-08-16 16:00:00,2012-08-16 20:00:00,1615.45,1615.3,1,-15,30626,Exit After X Bars,,None,None,None,None
230_240906004_B,185,XAUUSD,Buy,2012-08-31 16:00:00,2012-08-31 20:00:00,1664.07,1681.56,1,1749,32375,Exit After X Bars,,None,None,None,None
231_240906004_B,185,XAUUSD,Buy,2012-09-06 08:00:00,2012-09-06 12:00:00,1698.88,1709.11,1,1023,33398,Exit After X Bars,,None,None,None,None
233_240906004_B,185,XAUUSD,Buy,2012-09-13 16:00:00,2012-09-13 20:00:00,1745.55,1752.67,1,712,34110,Exit After X Bars,,None,None,None,None
234_240906004_B,185,XAUUSD,Buy,2012-09-18 16:00:00,2012-09-18 20:00:00,1773.24,1766.65,1,-659,33451,Exit After X Bars,,None,None,None,None
235_240906004_B,185,XAUUSD,Buy,2012-09-21 12:00:00,2012-09-21 16:00:00,1775.69,1786.55,1,1086,34537,Exit After X Bars,,None,None,None,None
239_240906004_B,185,XAUUSD,Buy,2012-09-27 12:00:00,2012-09-27 16:00:00,1765.54,1764.21,1,-133,34404,Exit After X Bars,,None,None,None,None
242_240906004_B,185,XAUUSD,Buy,2012-10-09 12:00:00,2012-10-09 16:00:00,1778.03,1774.13,1,-390,34014,Exit After X Bars,,None,None,None,None
246_240906004_B,185,XAUUSD,Buy,2012-10-17 00:00:00,2012-10-17 04:00:00,1748.75,1750.45,1,170,34184,Exit After X Bars,,None,None,None,None
252_240906004_B,185,XAUUSD,Buy,2012-10-26 16:00:00,2012-10-26 20:00:00,1717.93,1712.97,1,-496,33688,Exit After X Bars,,None,None,None,None
253_240906004_B,185,XAUUSD,Buy,2012-10-31 12:00:00,2012-10-31 16:00:00,1718.33,1717.66,1,-67,33621,Exit After X Bars,,None,None,None,None
258_240906004_B,185,XAUUSD,Buy,2012-11-14 16:00:00,2012-11-14 20:00:00,1733.04,1729.65,1,-339,33282,Exit After X Bars,,None,None,None,None
261_240906004_B,185,XAUUSD,Buy,2012-11-23 16:00:00,2012-11-23 20:00:00,1735.54,1750.79,1,1525,34807,Exit After X Bars,,None,None,None,None
265_240906004_B,185,XAUUSD,Buy,2012-11-30 12:00:00,2012-11-30 16:00:00,1728.36,1723.27,1,-509,34298,Exit After X Bars,,None,None,None,None
272_240906004_B,185,XAUUSD,Buy,2012-12-17 16:00:00,2012-12-17 20:00:00,1699.15,1696.31,1,-284,34014,Exit After X Bars,,None,None,None,None
281_240906004_B,185,XAUUSD,Buy,2013-01-07 12:00:00,2013-01-07 16:00:00,1658.64,1646.09,1,-1255,32759,Exit After X Bars,,None,None,None,None
282_240906004_B,185,XAUUSD,Buy,2013-01-10 08:00:00,2013-01-10 12:00:00,1662.54,1662.25,1,-29,32730,Exit After X Bars,,None,None,None,None
284_240906004_B,185,XAUUSD,Buy,2013-01-15 08:00:00,2013-01-15 12:00:00,1676.84,1681.15,1,431,33161,Exit After X Bars,,None,None,None,None
285_240906004_B,185,XAUUSD,Buy,2013-01-17 16:00:00,2013-01-17 20:00:00,1683.64,1694.35,1,1071,34232,Exit After X Bars,,None,None,None,None
286_240906004_B,185,XAUUSD,Buy,2013-01-22 16:00:00,2013-01-22 20:00:00,1695.2,1694.39,1,-81,34151,Exit After X Bars,,None,None,None,None
290_240906004_B,185,XAUUSD,Buy,2013-01-30 12:00:00,2013-01-30 16:00:00,1671.28,1675.33,1,405,34556,Exit After X Bars,,None,None,None,None
292_240906004_B,185,XAUUSD,Buy,2013-02-01 16:00:00,2013-02-01 20:00:00,1677.27,1671.47,1,-580,33976,Exit After X Bars,,None,None,None,None
293_240906004_B,185,XAUUSD,Buy,2013-02-05 12:00:00,2013-02-05 16:00:00,1682.06,1682.95,1,89,34065,Exit After X Bars,,None,None,None,None
298_240906004_B,185,XAUUSD,Buy,2013-02-13 12:00:00,2013-02-13 16:00:00,1653.34,1651.73,1,-161,33904,Exit After X Bars,,None,None,None,None
319_240906004_B,185,XAUUSD,Buy,2013-03-27 16:00:00,2013-03-27 20:00:00,1600.92,1605.55,1,463,34367,Exit After X Bars,,None,None,None,None
325_240906004_B,185,XAUUSD,Buy,2013-04-05 12:00:00,2013-04-05 16:00:00,1556.77,1568.42,1,1165,35532,Exit After X Bars,,None,None,None,None
331_240906004_B,185,XAUUSD,Buy,2013-04-19 08:00:00,2013-04-19 12:00:00,1403.27,1416.26,1,1299,36831,Exit After X Bars,,None,None,None,None
332_240906004_B,185,XAUUSD,Buy,2013-04-25 04:00:00,2013-04-25 08:00:00,1438.85,1446.95,1,810,37641,Exit After X Bars,,None,None,None,None
334_240906004_B,185,XAUUSD,Buy,2013-05-02 16:00:00,2013-05-02 20:00:00,1472.18,1468.85,1,-333,37308,Exit After X Bars,,None,None,None,None
336_240906004_B,185,XAUUSD,Buy,2013-05-08 12:00:00,2013-05-08 16:00:00,1465.55,1466.24,1,69,37377,Exit After X Bars,,None,None,None,None
343_240906004_B,185,XAUUSD,Buy,2013-05-20 16:00:00,2013-05-20 20:00:00,1383.71,1384.75,1,104,37481,Exit After X Bars,,None,None,None,None
344_240906004_B,185,XAUUSD,Buy,2013-05-23 08:00:00,2013-05-23 12:00:00,1385.48,1390.09,1,461,37942,Exit After X Bars,,None,None,None,None
345_240906004_B,185,XAUUSD,Buy,2013-05-28 16:00:00,2013-05-28 20:00:00,1396.54,1386.04,1,-1050,36892,Exit After X Bars,,None,None,None,None
346_240906004_B,185,XAUUSD,Buy,2013-05-30 08:00:00,2013-05-30 12:00:00,1401.18,1406.81,1,563,37455,Exit After X Bars,,None,None,None,None
348_240906004_B,185,XAUUSD,Buy,2013-06-03 16:00:00,2013-06-03 20:00:00,1415.78,1412.84,1,-294,37161,Exit After X Bars,,None,None,None,None
350_240906004_B,185,XAUUSD,Buy,2013-06-05 12:00:00,2013-06-05 16:00:00,1406.74,1401.81,1,-493,36668,Exit After X Bars,,None,None,None,None
351_240906004_B,185,XAUUSD,Buy,2013-06-06 16:00:00,2013-06-06 20:00:00,1410.51,1416.45,1,594,37262,Exit After X Bars,,None,None,None,None
355_240906004_B,185,XAUUSD,Buy,2013-06-12 16:00:00,2013-06-12 20:00:00,1380.89,1390.86,1,997,38259,Exit After X Bars,,None,None,None,None
369_240906004_B,185,XAUUSD,Buy,2013-07-09 04:00:00,2013-07-09 08:00:00,1243.24,1254.4,1,1116,39375,Exit After X Bars,,None,None,None,None
375_240906004_B,185,XAUUSD,Buy,2013-07-31 04:00:00,2013-07-31 08:00:00,1338.23,1333.29,1,-494,38881,Exit After X Bars,,None,None,None,None
380_240906004_B,185,XAUUSD,Buy,2013-08-08 08:00:00,2013-08-08 12:00:00,1296.73,1289.08,1,-765,38116,Exit After X Bars,,None,None,None,None
382_240906004_B,185,XAUUSD,Buy,2013-08-15 00:00:00,2013-08-15 04:00:00,1336.31,1341.41,1,510,38626,Exit After X Bars,,None,None,None,None
385_240906004_B,185,XAUUSD,Buy,2013-08-21 20:00:00,2013-08-22 00:00:00,1377.47,1366.09,1,-1138,37488,Exit After X Bars,,None,None,None,None
389_240906004_B,185,XAUUSD,Buy,2013-09-03 12:00:00,2013-09-03 16:00:00,1395.14,1398.01,1,287,37775,Exit After X Bars,,None,None,None,None
399_240906004_B,185,XAUUSD,Buy,2013-09-18 20:00:00,2013-09-19 00:00:00,1323.57,1362.63,1,3906,41681,Exit After X Bars,,None,None,None,None
402_240906004_B,185,XAUUSD,Buy,2013-09-25 16:00:00,2013-09-25 20:00:00,1330.17,1337.14,1,697,42378,Exit After X Bars,,None,None,None,None
404_240906004_B,185,XAUUSD,Buy,2013-09-27 12:00:00,2013-09-27 16:00:00,1338.14,1335.57,1,-257,42121,Exit After X Bars,,None,None,None,None
408_240906004_B,185,XAUUSD,Buy,2013-10-04 12:00:00,2013-10-04 16:00:00,1323.79,1317.36,1,-643,41478,Exit After X Bars,,None,None,None,None
413_240906004_B,185,XAUUSD,Buy,2013-10-17 08:00:00,2013-10-17 12:00:00,1289.9,1305.41,1,1551,43029,Exit After X Bars,,None,None,None,None
414_240906004_B,185,XAUUSD,Buy,2013-10-22 12:00:00,2013-10-22 16:00:00,1319.8,1328.04,1,824,43853,Exit After X Bars,,None,None,None,None
416_240906004_B,185,XAUUSD,Buy,2013-10-30 12:00:00,2013-10-30 16:00:00,1352.9,1354.15,1,125,43978,Exit After X Bars,,None,None,None,None
420_240906004_B,185,XAUUSD,Buy,2013-11-07 12:00:00,2013-11-07 16:00:00,1322.48,1303.74,1,-1874,42104,Exit After X Bars,,None,None,None,None
424_240906004_B,185,XAUUSD,Buy,2013-11-14 00:00:00,2013-11-14 04:00:00,1285.29,1282.24,1,-305,41799,Exit After X Bars,,None,None,None,None
430_240906004_B,185,XAUUSD,Buy,2013-11-25 20:00:00,2013-11-26 00:00:00,1248.93,1251.21,1,228,42027,Exit After X Bars,,None,None,None,None
433_240906004_B,185,XAUUSD,Buy,2013-11-29 16:00:00,2013-11-29 20:00:00,1254.63,1251.04,1,-359,41668,Exit After X Bars,,None,None,None,None
436_240906004_B,185,XAUUSD,Buy,2013-12-04 12:00:00,2013-12-04 16:00:00,1226.12,1225.9,1,-22,41646,Exit After X Bars,,None,None,None,None
438_240906004_B,185,XAUUSD,Buy,2013-12-10 08:00:00,2013-12-10 12:00:00,1244.26,1242.99,1,-127,41519,Exit After X Bars,,None,None,None,None
441_240906004_B,185,XAUUSD,Buy,2013-12-16 16:00:00,2013-12-16 20:00:00,1238.6,1246.12,1,752,42271,Exit After X Bars,,None,None,None,None
443_240906004_B,185,XAUUSD,Buy,2013-12-18 20:00:00,2013-12-19 00:00:00,1243.02,1218.09,1,-2493,39778,Exit After X Bars,,None,None,None,None
446_240906004_B,185,XAUUSD,Buy,2013-12-26 12:00:00,2013-12-26 16:00:00,1207.49,1212.34,1,485,40263,Exit After X Bars,,None,None,None,None
448_240906004_B,185,XAUUSD,Buy,2013-12-31 16:00:00,2013-12-31 20:00:00,1208.45,1204.8,1,-365,39898,Exit After X Bars,,None,None,None,None
451_240906004_B,185,XAUUSD,Buy,2014-01-10 04:00:00,2014-01-10 08:00:00,1231.87,1236.55,1,468,40366,Exit After X Bars,,None,None,None,None
454_240906004_B,185,XAUUSD,Buy,2014-01-16 16:00:00,2014-01-16 20:00:00,1242.48,1241.14,1,-134,40232,Exit After X Bars,,None,None,None,None
456_240906004_B,185,XAUUSD,Buy,2014-01-23 12:00:00,2014-01-23 16:00:00,1248.96,1255.97,1,701,40933,Exit After X Bars,,None,None,None,None
458_240906004_B,185,XAUUSD,Buy,2014-01-29 12:00:00,2014-01-29 16:00:00,1261.41,1266.85,1,544,41477,Exit After X Bars,,None,None,None,None
461_240906004_B,185,XAUUSD,Buy,2014-02-03 16:00:00,2014-02-03 20:00:00,1254.9,1259.36,1,446,41923,Exit After X Bars,,None,None,None,None
464_240906004_B,185,XAUUSD,Buy,2014-02-20 20:00:00,2014-02-21 00:00:00,1321.99,1322.82,1,83,42006,Exit After X Bars,,None,None,None,None
469_240906004_B,185,XAUUSD,Buy,2014-03-05 16:00:00,2014-03-05 20:00:00,1340.63,1341.02,1,39,42045,Exit After X Bars,,None,None,None,None
470_240906004_B,185,XAUUSD,Buy,2014-03-06 16:00:00,2014-03-06 20:00:00,1341.79,1348.87,1,708,42753,Exit After X Bars,,None,None,None,None
472_240906004_B,185,XAUUSD,Buy,2014-03-12 04:00:00,2014-03-12 08:00:00,1352.88,1357.11,1,423,43176,Exit After X Bars,,None,None,None,None
484_240906004_B,185,XAUUSD,Buy,2014-04-02 12:00:00,2014-04-02 16:00:00,1287.81,1291.57,1,376,43552,Exit After X Bars,,None,None,None,None
485_240906004_B,185,XAUUSD,Buy,2014-04-04 12:00:00,2014-04-04 16:00:00,1294.49,1299.0,1,451,44003,Exit After X Bars,,None,None,None,None
486_240906004_B,185,XAUUSD,Buy,2014-04-09 20:00:00,2014-04-10 00:00:00,1314.32,1311.64,1,-268,43735,Exit After X Bars,,None,None,None,None
493_240906004_B,185,XAUUSD,Buy,2014-04-24 16:00:00,2014-04-24 20:00:00,1288.94,1289.87,1,93,43828,Exit After X Bars,,None,None,None,None
498_240906004_B,185,XAUUSD,Buy,2014-05-02 16:00:00,2014-05-02 20:00:00,1288.78,1298.41,1,963,44791,Exit After X Bars,,None,None,None,None
506_240906004_B,185,XAUUSD,Buy,2014-05-22 12:00:00,2014-05-22 16:00:00,1296.83,1300.41,1,358,45149,Exit After X Bars,,None,None,None,None
516_240906004_B,185,XAUUSD,Buy,2014-06-05 12:00:00,2014-06-05 16:00:00,1248.98,1254.85,1,587,45736,Exit After X Bars,,None,None,None,None
518_240906004_B,185,XAUUSD,Buy,2014-06-18 12:00:00,2014-06-18 16:00:00,1272.35,1271.69,1,-66,45670,Exit After X Bars,,None,None,None,None
521_240906004_B,185,XAUUSD,Buy,2014-06-30 20:00:00,2014-07-01 00:00:00,1320.94,1327.15,1,621,46291,Exit After X Bars,,None,None,None,None
524_240906004_B,185,XAUUSD,Buy,2014-07-08 12:00:00,2014-07-08 16:00:00,1322.11,1321.99,1,-12,46279,Exit After X Bars,,None,None,None,None
527_240906004_B,185,XAUUSD,Buy,2014-07-17 16:00:00,2014-07-17 20:00:00,1313.7,1317.39,1,369,46648,Exit After X Bars,,None,None,None,None
531_240906004_B,185,XAUUSD,Buy,2014-07-25 20:00:00,2014-07-28 00:00:00,1301.25,1307.57,1,632,47280,End Of Friday,,None,None,None,None
537_240906004_B,185,XAUUSD,Buy,2014-08-06 12:00:00,2014-08-06 16:00:00,1294.87,1302.07,1,720,48000,Exit After X Bars,,None,None,None,None
538_240906004_B,185,XAUUSD,Buy,2014-08-14 12:00:00,2014-08-14 16:00:00,1319.11,1314.57,1,-454,47546,Exit After X Bars,,None,None,None,None
545_240906004_B,185,XAUUSD,Buy,2014-08-26 04:00:00,2014-08-26 08:00:00,1282.84,1282.24,1,-60,47486,Exit After X Bars,,None,None,None,None
550_240906004_B,185,XAUUSD,Buy,2014-09-04 16:00:00,2014-09-04 20:00:00,1271.48,1266.49,1,-499,46987,Exit After X Bars,,None,None,None,None
557_240906004_B,185,XAUUSD,Buy,2014-09-16 08:00:00,2014-09-16 12:00:00,1239.06,1239.76,1,70,47057,Exit After X Bars,,None,None,None,None
560_240906004_B,185,XAUUSD,Buy,2014-09-23 08:00:00,2014-09-23 12:00:00,1225.7,1223.54,1,-216,46841,Exit After X Bars,,None,None,None,None
562_240906004_B,185,XAUUSD,Buy,2014-09-26 04:00:00,2014-09-26 08:00:00,1225.99,1222.61,1,-338,46503,Exit After X Bars,,None,None,None,None
564_240906004_B,185,XAUUSD,Buy,2014-10-02 04:00:00,2014-10-02 08:00:00,1220.07,1219.5,1,-57,46446,Exit After X Bars,,None,None,None,None
566_240906004_B,185,XAUUSD,Buy,2014-10-07 08:00:00,2014-10-07 12:00:00,1209.32,1208.79,1,-53,46393,Exit After X Bars,,None,None,None,None
567_240906004_B,185,XAUUSD,Buy,2014-10-15 12:00:00,2014-10-15 16:00:00,1238.15,1236.12,1,-203,46190,Exit After X Bars,,None,None,None,None
572_240906004_B,185,XAUUSD,Buy,2014-10-28 12:00:00,2014-10-28 16:00:00,1231.77,1232.63,1,86,46276,Exit After X Bars,,None,None,None,None
577_240906004_B,185,XAUUSD,Buy,2014-11-04 12:00:00,2014-11-04 16:00:00,1173.74,1169.24,1,-450,45826,Exit After X Bars,,None,None,None,None
580_240906004_B,185,XAUUSD,Buy,2014-11-07 12:00:00,2014-11-07 16:00:00,1149.45,1148.58,1,-87,45739,Exit After X Bars,,None,None,None,None
581_240906004_B,185,XAUUSD,Buy,2014-11-11 20:00:00,2014-11-12 00:00:00,1172.19,1164.0,1,-819,44920,Exit After X Bars,,None,None,None,None
582_240906004_B,185,XAUUSD,Buy,2014-11-14 16:00:00,2014-11-14 20:00:00,1167.85,1188.32,1,2047,46967,Exit After X Bars,,None,None,None,None
583_240906004_B,185,XAUUSD,Buy,2014-11-25 16:00:00,2014-11-25 20:00:00,1200.3,1196.17,1,-413,46554,Exit After X Bars,,None,None,None,None
587_240906004_B,185,XAUUSD,Buy,2014-12-01 16:00:00,2014-12-01 20:00:00,1189.25,1215.34,1,2609,49163,Exit After X Bars,,None,None,None,None
589_240906004_B,185,XAUUSD,Buy,2014-12-08 20:00:00,2014-12-09 00:00:00,1207.46,1202.88,1,-458,48705,Exit After X Bars,,None,None,None,None
593_240906004_B,185,XAUUSD,Buy,2014-12-16 12:00:00,2014-12-16 16:00:00,1217.13,1211.4,1,-573,48132,Exit After X Bars,,None,None,None,None
598_240906004_B,185,XAUUSD,Buy,2014-12-26 00:00:00,2014-12-26 04:00:00,1181.32,1183.63,1,231,48363,Exit After X Bars,,None,None,None,None
600_240906004_B,185,XAUUSD,Buy,2014-12-30 12:00:00,2014-12-30 16:00:00,1195.67,1198.09,1,242,48605,Exit After X Bars,,None,None,None,None
604_240906004_B,185,XAUUSD,Buy,2015-01-09 12:00:00,2015-01-09 16:00:00,1216.41,1214.26,1,-215,48390,Exit After X Bars,,None,None,None,None
605_240906004_B,185,XAUUSD,Buy,2015-01-14 16:00:00,2015-01-14 20:00:00,1242.84,1238.64,1,-420,47970,Exit After X Bars,,None,None,None,None
606_240906004_B,185,XAUUSD,Buy,2015-01-22 16:00:00,2015-01-22 20:00:00,1305.2,1300.98,1,-422,47548,Exit After X Bars,,None,None,None,None
609_240906004_B,185,XAUUSD,Buy,2015-01-27 12:00:00,2015-01-27 16:00:00,1287.41,1287.31,1,-10,47538,Exit After X Bars,,None,None,None,None
611_240906004_B,185,XAUUSD,Buy,2015-01-30 16:00:00,2015-01-30 20:00:00,1277.25,1275.44,1,-181,47357,Exit After X Bars,,None,None,None,None
620_240906004_B,185,XAUUSD,Buy,2015-02-13 12:00:00,2015-02-13 16:00:00,1227.82,1228.23,1,41,47398,Exit After X Bars,,None,None,None,None
626_240906004_B,185,XAUUSD,Buy,2015-02-25 08:00:00,2015-02-25 12:00:00,1210.26,1208.09,1,-217,47181,Exit After X Bars,,None,None,None,None
631_240906004_B,185,XAUUSD,Buy,2015-03-05 16:00:00,2015-03-05 20:00:00,1207.22,1199.08,1,-814,46367,Exit After X Bars,,None,None,None,None
639_240906004_B,185,XAUUSD,Buy,2015-03-17 16:00:00,2015-03-17 20:00:00,1159.39,1149.3,1,-1009,45358,Exit After X Bars,,None,None,None,None
640_240906004_B,185,XAUUSD,Buy,2015-03-18 20:00:00,2015-03-19 00:00:00,1159.8,1166.79,1,699,46057,Exit After X Bars,,None,None,None,None
644_240906004_B,185,XAUUSD,Buy,2015-04-01 12:00:00,2015-04-01 16:00:00,1190.69,1193.54,1,285,46342,Exit After X Bars,,None,None,None,None
650_240906004_B,185,XAUUSD,Buy,2015-04-15 20:00:00,2015-04-16 00:00:00,1198.98,1202.18,1,320,46662,Exit After X Bars,,None,None,None,None
651_240906004_B,185,XAUUSD,Buy,2015-04-17 12:00:00,2015-04-17 16:00:00,1207.55,1202.13,1,-542,46120,Exit After X Bars,,None,None,None,None
653_240906004_B,185,XAUUSD,Buy,2015-04-22 08:00:00,2015-04-22 12:00:00,1204.72,1200.73,1,-399,45721,Exit After X Bars,,None,None,None,None
656_240906004_B,185,XAUUSD,Buy,2015-04-27 16:00:00,2015-04-27 20:00:00,1192.73,1206.76,1,1403,47124,Exit After X Bars,,None,None,None,None
660_240906004_B,185,XAUUSD,Buy,2015-05-08 12:00:00,2015-05-08 16:00:00,1188.46,1189.59,1,113,47237,Exit After X Bars,,None,None,None,None
662_240906004_B,185,XAUUSD,Buy,2015-05-12 12:00:00,2015-05-12 16:00:00,1191.76,1195.14,1,338,47575,Exit After X Bars,,None,None,None,None
665_240906004_B,185,XAUUSD,Buy,2015-05-22 08:00:00,2015-05-22 12:00:00,1213.35,1212.43,1,-92,47483,Exit After X Bars,,None,None,None,None
669_240906004_B,185,XAUUSD,Buy,2015-05-28 16:00:00,2015-05-28 20:00:00,1189.0,1188.44,1,-56,47427,Exit After X Bars,,None,None,None,None
670_240906004_B,185,XAUUSD,Buy,2015-06-01 16:00:00,2015-06-01 20:00:00,1193.85,1191.04,1,-281,47146,Exit After X Bars,,None,None,None,None
675_240906004_B,185,XAUUSD,Buy,2015-06-09 04:00:00,2015-06-09 08:00:00,1176.58,1177.58,1,100,47246,Exit After X Bars,,None,None,None,None
678_240906004_B,185,XAUUSD,Buy,2015-06-15 16:00:00,2015-06-15 20:00:00,1183.48,1188.24,1,476,47722,Exit After X Bars,,None,None,None,None
680_240906004_B,185,XAUUSD,Buy,2015-06-17 20:00:00,2015-06-18 00:00:00,1184.74,1184.86,1,12,47734,Exit After X Bars,,None,None,None,None
685_240906004_B,185,XAUUSD,Buy,2015-06-29 00:00:00,2015-06-29 04:00:00,1184.23,1185.47,1,123.9,47857.9,Exit After X Bars,,None,None,None,None
689_240906004_B,185,XAUUSD,Buy,2015-07-03 12:00:00,2015-07-03 16:00:00,1169.34,1169.48,1,14,47871.9,Exit After X Bars,,None,None,None,None
690_240906004_B,185,XAUUSD,Buy,2015-07-06 16:00:00,2015-07-06 20:00:00,1169.85,1172.13,1,228,48099.9,Exit After X Bars,,None,None,None,None
694_240906004_B,185,XAUUSD,Buy,2015-07-14 16:00:00,2015-07-14 20:00:00,1159.43,1155.13,1,-430,47669.9,Exit After X Bars,,None,None,None,None
701_240906004_B,185,XAUUSD,Buy,2015-07-23 16:00:00,2015-07-23 20:00:00,1096.41,1095.26,1,-115,47554.9,Exit After X Bars,,None,None,None,None
703_240906004_B,185,XAUUSD,Buy,2015-07-27 16:00:00,2015-07-27 20:00:00,1101.52,1097.31,1,-421,47133.9,Exit After X Bars,,None,None,None,None
705_240906004_B,185,XAUUSD,Buy,2015-07-31 16:00:00,2015-07-31 20:00:00,1095.34,1094.21,1,-113,47020.9,Exit After X Bars,,None,None,None,None
708_240906004_B,185,XAUUSD,Buy,2015-08-06 16:00:00,2015-08-06 20:00:00,1092.56,1092.34,1,-22,46998.9,Exit After X Bars,,None,None,None,None
709_240906004_B,185,XAUUSD,Buy,2015-08-07 16:00:00,2015-08-07 20:00:00,1093.96,1094.27,1,31,47029.9,Exit After X Bars,,None,None,None,None
714_240906004_B,185,XAUUSD,Buy,2015-08-28 12:00:00,2015-08-28 16:00:00,1129.28,1129.06,1,-22,47007.9,Exit After X Bars,,None,None,None,None
719_240906004_B,185,XAUUSD,Buy,2015-09-08 12:00:00,2015-09-08 16:00:00,1123.2,1122.09,1,-111,46896.9,Exit After X Bars,,None,None,None,None
723_240906004_B,185,XAUUSD,Buy,2015-09-14 12:00:00,2015-09-14 16:00:00,1108.42,1105.19,1,-323,46573.9,Exit After X Bars,,None,None,None,None
724_240906004_B,185,XAUUSD,Buy,2015-09-16 12:00:00,2015-09-16 16:00:00,1110.4,1114.03,1,363,46936.9,Exit After X Bars,,None,None,None,None
726_240906004_B,185,XAUUSD,Buy,2015-09-24 04:00:00,2015-09-24 08:00:00,1135.04,1134.21,1,-83,46853.9,Exit After X Bars,,None,None,None,None
731_240906004_B,185,XAUUSD,Buy,2015-10-02 12:00:00,2015-10-02 16:00:00,1119.09,1131.89,1,1280,48133.9,Exit After X Bars,,None,None,None,None
732_240906004_B,185,XAUUSD,Buy,2015-10-09 08:00:00,2015-10-09 12:00:00,1153.61,1153.75,1,14,48147.9,Exit After X Bars,,None,None,None,None
733_240906004_B,185,XAUUSD,Buy,2015-10-14 00:00:00,2015-10-14 04:00:00,1168.98,1168.66,1,-32,48115.9,Exit After X Bars,,None,None,None,None
736_240906004_B,185,XAUUSD,Buy,2015-10-20 16:00:00,2015-10-20 20:00:00,1178.12,1176.93,1,-119,47996.9,Exit After X Bars,,None,None,None,None
738_240906004_B,185,XAUUSD,Buy,2015-10-23 12:00:00,2015-10-23 16:00:00,1177.81,1177.01,1,-80,47916.9,Exit After X Bars,,None,None,None,None
740_240906004_B,185,XAUUSD,Buy,2015-10-28 08:00:00,2015-10-28 12:00:00,1169.63,1172.1,1,247,48163.9,Exit After X Bars,,None,None,None,None
756_240906004_B,185,XAUUSD,Buy,2015-11-19 16:00:00,2015-11-19 20:00:00,1078.29,1080.32,1,203,48366.9,Exit After X Bars,,None,None,None,None
758_240906004_B,185,XAUUSD,Buy,2015-11-24 12:00:00,2015-11-24 16:00:00,1075.09,1077.21,1,212,48578.9,Exit After X Bars,,None,None,None,None
762_240906004_B,185,XAUUSD,Buy,2015-11-30 20:00:00,2015-12-01 00:00:00,1066.9,1064.8,1,-210,48368.9,Exit After X Bars,,None,None,None,None
764_240906004_B,185,XAUUSD,Buy,2015-12-04 12:00:00,2015-12-04 16:00:00,1067.73,1068.32,1,59,48427.9,Exit After X Bars,,None,None,None,None
766_240906004_B,185,XAUUSD,Buy,2015-12-09 12:00:00,2015-12-09 16:00:00,1079.14,1082.33,1,319,48746.9,Exit After X Bars,,None,None,None,None
768_240906004_B,185,XAUUSD,Buy,2015-12-11 16:00:00,2015-12-11 20:00:00,1075.56,1075.16,1,-40,48706.9,Exit After X Bars,,None,None,None,None
771_240906004_B,185,XAUUSD,Buy,2015-12-16 12:00:00,2015-12-16 16:00:00,1068.66,1072.87,1,421,49127.9,Exit After X Bars,,None,None,None,None
773_240906004_B,185,XAUUSD,Buy,2015-12-18 16:00:00,2015-12-18 20:00:00,1068.26,1065.61,1,-265,48862.9,Exit After X Bars,,None,None,None,None
775_240906004_B,185,XAUUSD,Buy,2015-12-24 16:00:00,2015-12-24 20:00:00,1074.3,1076.64,1,234,49096.9,Exit After X Bars,,None,None,None,None
777_240906004_B,185,XAUUSD,Buy,2015-12-29 12:00:00,2015-12-29 16:00:00,1072.68,1070.22,1,-246,48850.9,Exit After X Bars,,None,None,None,None
780_240906004_B,185,XAUUSD,Buy,2016-01-11 12:00:00,2016-01-11 16:00:00,1105.53,1100.89,1,-464,48386.9,Exit After X Bars,,None,None,None,None
782_240906004_B,185,XAUUSD,Buy,2016-01-13 20:00:00,2016-01-14 00:00:00,1095.43,1093.36,1,-207,48179.9,Exit After X Bars,,None,None,None,None
784_240906004_B,185,XAUUSD,Buy,2016-01-15 12:00:00,2016-01-15 16:00:00,1093.08,1093.84,1,76,48255.9,Exit After X Bars,,None,None,None,None
785_240906004_B,185,XAUUSD,Buy,2016-01-20 04:00:00,2016-01-20 08:00:00,1092.11,1091.18,1,-93,48162.9,Exit After X Bars,,None,None,None,None
786_240906004_B,185,XAUUSD,Buy,2016-01-22 16:00:00,2016-01-22 20:00:00,1102.67,1097.71,1,-496,47666.9,Exit After X Bars,,None,None,None,None
789_240906004_B,185,XAUUSD,Buy,2016-02-11 00:00:00,2016-02-11 04:00:00,1198.84,1207.95,1,911,48577.9,Exit After X Bars,,None,None,None,None
791_240906004_B,185,XAUUSD,Buy,2016-02-16 12:00:00,2016-02-16 16:00:00,1213.98,1214.62,1,64,48641.9,Exit After X Bars,,None,None,None,None
792_240906004_B,185,XAUUSD,Buy,2016-02-18 16:00:00,2016-02-18 20:00:00,1216.88,1227.06,1,1018,49659.9,Exit After X Bars,,None,None,None,None
795_240906004_B,185,XAUUSD,Buy,2016-02-29 20:00:00,2016-03-01 00:00:00,1238.08,1237.53,1,-55,49604.9,Exit After X Bars,,None,None,None,None
797_240906004_B,185,XAUUSD,Buy,2016-03-03 16:00:00,2016-03-03 20:00:00,1247.84,1256.9,1,906,50510.9,Exit After X Bars,,None,None,None,None
799_240906004_B,185,XAUUSD,Buy,2016-03-10 16:00:00,2016-03-10 20:00:00,1260.29,1272.46,1,1217,51727.9,Exit After X Bars,,None,None,None,None
802_240906004_B,185,XAUUSD,Buy,2016-03-16 20:00:00,2016-03-17 00:00:00,1238.02,1260.82,1,2280,54007.9,Exit After X Bars,,None,None,None,None
804_240906004_B,185,XAUUSD,Buy,2016-03-22 08:00:00,2016-03-22 12:00:00,1258.58,1252.25,1,-633,53374.9,Exit After X Bars,,None,None,None,None
807_240906004_B,185,XAUUSD,Buy,2016-03-29 16:00:00,2016-03-29 20:00:00,1223.71,1235.67,1,1196,54570.9,Exit After X Bars,,None,None,None,None
809_240906004_B,185,XAUUSD,Buy,2016-04-05 08:00:00,2016-04-05 12:00:00,1233.91,1232.66,1,-125,54445.9,Exit After X Bars,,None,None,None,None
810_240906004_B,185,XAUUSD,Buy,2016-04-07 12:00:00,2016-04-07 16:00:00,1236.73,1239.3,1,257,54702.9,Exit After X Bars,,None,None,None,None
816_240906004_B,185,XAUUSD,Buy,2016-04-26 16:00:00,2016-04-26 20:00:00,1242.22,1240.55,1,-167,54535.9,Exit After X Bars,,None,None,None,None
819_240906004_B,185,XAUUSD,Buy,2016-05-06 12:00:00,2016-05-06 16:00:00,1289.71,1291.99,1,228,54763.9,Exit After X Bars,,None,None,None,None
826_240906004_B,185,XAUUSD,Buy,2016-05-20 16:00:00,2016-05-20 20:00:00,1259.08,1250.82,1,-826,53937.9,Exit After X Bars,,None,None,None,None
830_240906004_B,185,XAUUSD,Buy,2016-05-26 12:00:00,2016-05-26 16:00:00,1227.21,1229.33,1,212,54149.9,Exit After X Bars,,None,None,None,None
833_240906004_B,185,XAUUSD,Buy,2016-05-31 12:00:00,2016-05-31 16:00:00,1212.63,1210.14,1,-249,53900.9,Exit After X Bars,,None,None,None,None
836_240906004_B,185,XAUUSD,Buy,2016-06-03 12:00:00,2016-06-03 16:00:00,1217.6,1236.96,1,1936,55836.9,Exit After X Bars,,None,None,None,None
837_240906004_B,185,XAUUSD,Buy,2016-06-08 04:00:00,2016-06-08 08:00:00,1247.43,1248.54,1,111,55947.9,Exit After X Bars,,None,None,None,None
842_240906004_B,185,XAUUSD,Buy,2016-06-24 00:00:00,2016-06-24 04:00:00,1269.33,1271.53,1,220,56167.9,Exit After X Bars,,None,None,None,None
843_240906004_B,185,XAUUSD,Buy,2016-07-01 08:00:00,2016-07-01 12:00:00,1333.23,1334.47,1,124,56291.9,Exit After X Bars,,None,None,None,None
844_240906004_B,185,XAUUSD,Buy,2016-07-08 16:00:00,2016-07-08 20:00:00,1367.79,1355.82,1,-1197,55094.9,Exit After X Bars,,None,None,None,None
849_240906004_B,185,XAUUSD,Buy,2016-07-15 20:00:00,2016-07-18 00:00:00,1336.69,1332.62,1,-407,54687.9,End Of Friday,,None,None,None,None
852_240906004_B,185,XAUUSD,Buy,2016-07-21 16:00:00,2016-07-21 20:00:00,1327.27,1330.09,1,282,54969.9,Exit After X Bars,,None,None,None,None
854_240906004_B,185,XAUUSD,Buy,2016-07-27 16:00:00,2016-07-27 20:00:00,1326.67,1327.14,1,47,55016.9,Exit After X Bars,,None,None,None,None
855_240906004_B,185,XAUUSD,Buy,2016-07-29 12:00:00,2016-07-29 16:00:00,1345.52,1345.52,1,0,55016.9,Exit After X Bars,,None,None,None,None
860_240906004_B,185,XAUUSD,Buy,2016-08-09 16:00:00,2016-08-09 20:00:00,1338.07,1339.93,1,186,55202.9,Exit After X Bars,,None,None,None,None
861_240906004_B,185,XAUUSD,Buy,2016-08-12 12:00:00,2016-08-12 16:00:00,1353.26,1355.01,1,175,55377.9,Exit After X Bars,,None,None,None,None
862_240906004_B,185,XAUUSD,Buy,2016-08-16 12:00:00,2016-08-16 16:00:00,1356.33,1349.02,1,-731,54646.9,Exit After X Bars,,None,None,None,None
865_240906004_B,185,XAUUSD,Buy,2016-08-23 12:00:00,2016-08-23 16:00:00,1340.02,1343.74,1,372,55018.9,Exit After X Bars,,None,None,None,None
868_240906004_B,185,XAUUSD,Buy,2016-08-26 12:00:00,2016-08-26 16:00:00,1326.89,1331.14,1,425,55443.9,Exit After X Bars,,None,None,None,None
872_240906004_B,185,XAUUSD,Buy,2016-09-01 16:00:00,2016-09-01 20:00:00,1314.83,1313.54,1,-129,55314.9,Exit After X Bars,,None,None,None,None
878_240906004_B,185,XAUUSD,Buy,2016-09-15 12:00:00,2016-09-15 16:00:00,1325.93,1320.64,1,-529,54785.9,Exit After X Bars,,None,None,None,None
880_240906004_B,185,XAUUSD,Buy,2016-09-19 12:00:00,2016-09-19 16:00:00,1316.12,1313.45,1,-267,54518.9,Exit After X Bars,,None,None,None,None
881_240906004_B,185,XAUUSD,Buy,2016-09-26 16:00:00,2016-09-26 20:00:00,1340.58,1340.09,1,-49,54469.9,Exit After X Bars,,None,None,None,None
884_240906004_B,185,XAUUSD,Buy,2016-09-30 08:00:00,2016-09-30 12:00:00,1326.91,1326.0,1,-91,54378.9,Exit After X Bars,,None,None,None,None
891_240906004_B,185,XAUUSD,Buy,2016-10-13 04:00:00,2016-10-13 08:00:00,1259.56,1259.34,1,-22,54356.9,Exit After X Bars,,None,None,None,None
893_240906004_B,185,XAUUSD,Buy,2016-10-18 04:00:00,2016-10-18 08:00:00,1259.35,1258.1,1,-125,54231.9,Exit After X Bars,,None,None,None,None
895_240906004_B,185,XAUUSD,Buy,2016-10-24 12:00:00,2016-10-24 16:00:00,1267.99,1271.24,1,325,54556.9,Exit After X Bars,,None,None,None,None
898_240906004_B,185,XAUUSD,Buy,2016-10-28 16:00:00,2016-10-28 20:00:00,1272.77,1269.81,1,-296,54260.9,Exit After X Bars,,None,None,None,None
900_240906004_B,185,XAUUSD,Buy,2016-11-08 16:00:00,2016-11-08 20:00:00,1288.93,1276.86,1,-1207,53053.9,Exit After X Bars,,None,None,None,None
901_240906004_B,185,XAUUSD,Buy,2016-11-10 08:00:00,2016-11-10 12:00:00,1290.57,1283.68,1,-689,52364.9,Exit After X Bars,,None,None,None,None
904_240906004_B,185,XAUUSD,Buy,2016-11-16 00:00:00,2016-11-16 04:00:00,1231.3,1231.18,1,-12,52352.9,Exit After X Bars,,None,None,None,None
907_240906004_B,185,XAUUSD,Buy,2016-11-21 12:00:00,2016-11-21 16:00:00,1216.04,1214.42,1,-162,52190.9,Exit After X Bars,,None,None,None,None
910_240906004_B,185,XAUUSD,Buy,2016-11-25 12:00:00,2016-11-25 16:00:00,1189.6,1187.54,1,-206,51984.9,Exit After X Bars,,None,None,None,None
914_240906004_B,185,XAUUSD,Buy,2016-12-02 16:00:00,2016-12-02 20:00:00,1177.87,1175.36,1,-251,51733.9,Exit After X Bars,,None,None,None,None
916_240906004_B,185,XAUUSD,Buy,2016-12-07 12:00:00,2016-12-07 16:00:00,1175.91,1176.33,1,42,51775.9,Exit After X Bars,,None,None,None,None
922_240906004_B,185,XAUUSD,Buy,2016-12-16 16:00:00,2016-12-16 20:00:00,1137.43,1137.32,1,-11,51764.9,Exit After X Bars,,None,None,None,None
924_240906004_B,185,XAUUSD,Buy,2016-12-21 12:00:00,2016-12-21 16:00:00,1134.98,1135.94,1,96,51860.9,Exit After X Bars,,None,None,None,None
926_240906004_B,185,XAUUSD,Buy,2016-12-23 16:00:00,2016-12-23 20:00:00,1134.02,1132.46,1,-156,51704.9,Exit After X Bars,,None,None,None,None
927_240906004_B,185,XAUUSD,Buy,2017-01-03 16:00:00,2017-01-03 20:00:00,1161.13,1162.01,1,88,51792.9,Exit After X Bars,,None,None,None,None
929_240906004_B,185,XAUUSD,Buy,2017-01-20 20:00:00,2017-01-23 00:00:00,1207.98,1209.46,1,148,51940.9,End Of Friday,,None,None,None,None
933_240906004_B,185,XAUUSD,Buy,2017-01-30 12:00:00,2017-01-30 16:00:00,1191.55,1193.3,1,175,52115.9,Exit After X Bars,,None,None,None,None
938_240906004_B,185,XAUUSD,Buy,2017-02-16 00:00:00,2017-02-16 04:00:00,1234.46,1236.16,1,170,52285.9,Exit After X Bars,,None,None,None,None
939_240906004_B,185,XAUUSD,Buy,2017-02-22 12:00:00,2017-02-22 16:00:00,1238.93,1238.65,1,-28,52257.9,Exit After X Bars,,None,None,None,None
949_240906004_B,185,XAUUSD,Buy,2017-03-15 20:00:00,2017-03-16 00:00:00,1207.56,1219.04,1,1148,53405.9,Exit After X Bars,,None,None,None,None
954_240906004_B,185,XAUUSD,Buy,2017-04-03 16:00:00,2017-04-03 20:00:00,1250.53,1252.34,1,181,53586.9,Exit After X Bars,,None,None,None,None
956_240906004_B,185,XAUUSD,Buy,2017-04-07 04:00:00,2017-04-07 08:00:00,1258.8,1263.51,1,471,54057.9,Exit After X Bars,,None,None,None,None
957_240906004_B,185,XAUUSD,Buy,2017-04-11 16:00:00,2017-04-11 20:00:00,1270.52,1271.2,1,68,54125.9,Exit After X Bars,,None,None,None,None
961_240906004_B,185,XAUUSD,Buy,2017-04-21 12:00:00,2017-04-21 16:00:00,1283.37,1282.38,1,-99,54026.9,Exit After X Bars,,None,None,None,None
971_240906004_B,185,XAUUSD,Buy,2017-05-08 12:00:00,2017-05-08 16:00:00,1235.54,1230.3,1,-524,53502.9,Exit After X Bars,,None,None,None,None
974_240906004_B,185,XAUUSD,Buy,2017-05-11 16:00:00,2017-05-11 20:00:00,1225.59,1224.91,1,-68,53434.9,Exit After X Bars,,None,None,None,None
978_240906004_B,185,XAUUSD,Buy,2017-05-26 08:00:00,2017-05-26 12:00:00,1258.9,1263.49,1,459,53893.9,Exit After X Bars,,None,None,None,None
980_240906004_B,185,XAUUSD,Buy,2017-05-31 12:00:00,2017-05-31 16:00:00,1265.33,1266.08,1,75,53968.9,Exit After X Bars,,None,None,None,None
982_240906004_B,185,XAUUSD,Buy,2017-06-02 12:00:00,2017-06-02 16:00:00,1268.82,1273.68,1,486,54454.9,Exit After X Bars,,None,None,None,None
986_240906004_B,185,XAUUSD,Buy,2017-06-14 12:00:00,2017-06-14 16:00:00,1270.34,1276.32,1,598,55052.9,Exit After X Bars,,None,None,None,None
991_240906004_B,185,XAUUSD,Buy,2017-06-22 00:00:00,2017-06-22 04:00:00,1248.07,1250.85,1,278,55330.9,Exit After X Bars,,None,None,None,None
997_240906004_B,185,XAUUSD,Buy,2017-07-06 00:00:00,2017-07-06 04:00:00,1227.38,1227.31,1,-7,55323.9,Exit After X Bars,,None,None,None,None
998_240906004_B,185,XAUUSD,Buy,2017-07-07 12:00:00,2017-07-07 16:00:00,1227.35,1221.02,1,-633,54690.9,Exit After X Bars,,None,None,None,None
1000_240906004_B,185,XAUUSD,Buy,2017-07-11 16:00:00,2017-07-11 20:00:00,1215.98,1215.74,1,-24,54666.9,Exit After X Bars,,None,None,None,None
1001_240906004_B,185,XAUUSD,Buy,2017-07-20 16:00:00,2017-07-20 20:00:00,1243.96,1246.2,1,224,54890.9,Exit After X Bars,,None,None,None,None
1003_240906004_B,185,XAUUSD,Buy,2017-07-26 20:00:00,2017-07-27 00:00:00,1255.12,1260.47,1,535,55425.9,Exit After X Bars,,None,None,None,None
1008_240906004_B,185,XAUUSD,Buy,2017-08-08 20:00:00,2017-08-09 00:00:00,1259.86,1260.4,1,54,55479.9,Exit After X Bars,,None,None,None,None
1011_240906004_B,185,XAUUSD,Buy,2017-08-16 20:00:00,2017-08-17 00:00:00,1275.39,1283.5,1,811,56290.9,Exit After X Bars,,None,None,None,None
1013_240906004_B,185,XAUUSD,Buy,2017-08-23 12:00:00,2017-08-23 16:00:00,1290.96,1289.25,1,-171,56119.9,Exit After X Bars,,None,None,None,None
1014_240906004_B,185,XAUUSD,Buy,2017-08-25 16:00:00,2017-08-25 20:00:00,1291.4,1292.64,1,124,56243.9,Exit After X Bars,,None,None,None,None
1016_240906004_B,185,XAUUSD,Buy,2017-08-31 16:00:00,2017-08-31 20:00:00,1313.62,1316.85,1,323,56566.9,Exit After X Bars,,None,None,None,None
1017_240906004_B,185,XAUUSD,Buy,2017-09-07 12:00:00,2017-09-07 16:00:00,1344.3,1343.87,1,-43,56523.9,Exit After X Bars,,None,None,None,None
1020_240906004_B,185,XAUUSD,Buy,2017-09-13 12:00:00,2017-09-13 16:00:00,1334.5,1331.65,1,-285,56238.9,Exit After X Bars,,None,None,None,None
1026_240906004_B,185,XAUUSD,Buy,2017-09-22 16:00:00,2017-09-22 20:00:00,1297.62,1294.74,1,-288,55950.9,Exit After X Bars,,None,None,None,None
1027_240906004_B,185,XAUUSD,Buy,2017-09-25 16:00:00,2017-09-25 20:00:00,1298.44,1310.15,1,1171,57121.9,Exit After X Bars,,None,None,None,None
1033_240906004_B,185,XAUUSD,Buy,2017-10-04 08:00:00,2017-10-04 12:00:00,1277.19,1275.54,1,-165,56956.9,Exit After X Bars,,None,None,None,None
1041_240906004_B,185,XAUUSD,Buy,2017-10-26 08:00:00,2017-10-26 12:00:00,1281.28,1277.93,1,-335,56621.9,Exit After X Bars,,None,None,None,None
1043_240906004_B,185,XAUUSD,Buy,2017-10-30 16:00:00,2017-10-30 20:00:00,1273.96,1278.05,1,409,57030.9,Exit After X Bars,,None,None,None,None
1044_240906004_B,185,XAUUSD,Buy,2017-11-01 12:00:00,2017-11-01 16:00:00,1278.76,1275.13,1,-363,56667.9,Exit After X Bars,,None,None,None,None
1046_240906004_B,185,XAUUSD,Buy,2017-11-06 16:00:00,2017-11-06 20:00:00,1280.13,1280.84,1,71,56738.9,Exit After X Bars,,None,None,None,None
1049_240906004_B,185,XAUUSD,Buy,2017-11-14 16:00:00,2017-11-14 20:00:00,1279.72,1281.0,1,128,56866.9,Exit After X Bars,,None,None,None,None
1051_240906004_B,185,XAUUSD,Buy,2017-11-17 16:00:00,2017-11-17 20:00:00,1289.44,1293.4,1,396,57262.9,Exit After X Bars,,None,None,None,None
1054_240906004_B,185,XAUUSD,Buy,2017-11-22 12:00:00,2017-11-22 16:00:00,1284.7,1285.34,1,64,57326.9,Exit After X Bars,,None,None,None,None
1058_240906004_B,185,XAUUSD,Buy,2017-12-01 16:00:00,2017-12-01 20:00:00,1283.26,1283.66,1,40,57366.9,Exit After X Bars,,None,None,None,None
1066_240906004_B,185,XAUUSD,Buy,2017-12-13 12:00:00,2017-12-13 16:00:00,1244.95,1244.63,1,-32,57334.9,Exit After X Bars,,None,None,None,None
1068_240906004_B,185,XAUUSD,Buy,2018-01-10 12:00:00,2018-01-10 16:00:00,1315.9,1319.7,1,380,57714.9,Exit After X Bars,,None,None,None,None
1069_240906004_B,185,XAUUSD,Buy,2018-01-17 00:00:00,2018-01-17 04:00:00,1343.64,1343.65,1,1,57715.9,Exit After X Bars,,None,None,None,None
1073_240906004_B,185,XAUUSD,Buy,2018-01-30 16:00:00,2018-01-30 20:00:00,1348.68,1338.57,1,-1011,56704.9,Exit After X Bars,,None,None,None,None
1074_240906004_B,185,XAUUSD,Buy,2018-02-01 20:00:00,2018-02-02 00:00:00,1348.87,1348.64,1,-23,56681.9,Exit After X Bars,,None,None,None,None
1087_240906004_B,185,XAUUSD,Buy,2018-03-02 12:00:00,2018-03-02 16:00:00,1322.51,1325.0,1,249,56930.9,Exit After X Bars,,None,None,None,None
1091_240906004_B,185,XAUUSD,Buy,2018-03-13 00:00:00,2018-03-13 04:00:00,1325.11,1324.25,1,-86,56844.9,Exit After X Bars,,None,None,None,None
1095_240906004_B,185,XAUUSD,Buy,2018-03-21 16:00:00,2018-03-21 20:00:00,1319.58,1323.92,1,434,57278.9,Exit After X Bars,,None,None,None,None
1100_240906004_B,185,XAUUSD,Buy,2018-04-06 16:00:00,2018-04-06 20:00:00,1332.22,1331.36,1,-86,57192.9,Exit After X Bars,,None,None,None,None
1103_240906004_B,185,XAUUSD,Buy,2018-04-18 12:00:00,2018-04-18 16:00:00,1350.43,1353.13,1,270,57462.9,Exit After X Bars,,None,None,None,None
1106_240906004_B,185,XAUUSD,Buy,2018-04-24 16:00:00,2018-04-24 20:00:00,1329.42,1331.84,1,242,57704.9,Exit After X Bars,,None,None,None,None
1108_240906004_B,185,XAUUSD,Buy,2018-04-26 12:00:00,2018-04-26 16:00:00,1325.68,1324.72,1,-96,57608.9,Exit After X Bars,,None,None,None,None
1112_240906004_B,185,XAUUSD,Buy,2018-05-02 12:00:00,2018-05-02 16:00:00,1310.22,1308.94,1,-128,57480.9,Exit After X Bars,,None,None,None,None
1114_240906004_B,185,XAUUSD,Buy,2018-05-08 20:00:00,2018-05-09 00:00:00,1317.0,1314.58,1,-242,57238.9,Exit After X Bars,,None,None,None,None
1115_240906004_B,185,XAUUSD,Buy,2018-05-10 12:00:00,2018-05-10 16:00:00,1317.75,1322.01,1,426,57664.9,Exit After X Bars,,None,None,None,None
1120_240906004_B,185,XAUUSD,Buy,2018-05-18 16:00:00,2018-05-18 20:00:00,1291.73,1292.53,1,80,57744.9,Exit After X Bars,,None,None,None,None
1121_240906004_B,185,XAUUSD,Buy,2018-05-22 08:00:00,2018-05-22 12:00:00,1294.14,1293.72,1,-42,57702.9,Exit After X Bars,,None,None,None,None
1122_240906004_B,185,XAUUSD,Buy,2018-05-24 08:00:00,2018-05-24 12:00:00,1296.1,1296.93,1,83,57785.9,Exit After X Bars,,None,None,None,None
1124_240906004_B,185,XAUUSD,Buy,2018-05-29 16:00:00,2018-05-29 20:00:00,1301.25,1302.01,1,76,57861.9,Exit After X Bars,,None,None,None,None
1127_240906004_B,185,XAUUSD,Buy,2018-06-05 16:00:00,2018-06-05 20:00:00,1298.01,1298.38,1,37,57898.9,Exit After X Bars,,None,None,None,None
1128_240906004_B,185,XAUUSD,Buy,2018-06-11 16:00:00,2018-06-11 20:00:00,1300.53,1300.19,1,-34,57864.9,Exit After X Bars,,None,None,None,None
1130_240906004_B,185,XAUUSD,Buy,2018-06-13 20:00:00,2018-06-14 00:00:00,1299.69,1299.25,1,-44,57820.9,Exit After X Bars,,None,None,None,None
1136_240906004_B,185,XAUUSD,Buy,2018-06-22 12:00:00,2018-06-22 16:00:00,1270.06,1268.64,1,-142,57678.9,Exit After X Bars,,None,None,None,None
1141_240906004_B,185,XAUUSD,Buy,2018-06-29 16:00:00,2018-06-29 20:00:00,1254.22,1255.26,1,104,57782.9,Exit After X Bars,,None,None,None,None
1143_240906004_B,185,XAUUSD,Buy,2018-07-03 16:00:00,2018-07-03 20:00:00,1250.74,1252.72,1,198,57980.9,Exit After X Bars,,None,None,None,None
1148_240906004_B,185,XAUUSD,Buy,2018-07-17 08:00:00,2018-07-17 12:00:00,1243.66,1244.67,1,101,58081.9,Exit After X Bars,,None,None,None,None
1150_240906004_B,185,XAUUSD,Buy,2018-07-19 20:00:00,2018-07-20 00:00:00,1228.46,1223.01,1,-545,57536.9,Exit After X Bars,,None,None,None,None
1151_240906004_B,185,XAUUSD,Buy,2018-07-20 12:00:00,2018-07-20 16:00:00,1228.98,1229.95,1,97,57633.9,Exit After X Bars,,None,None,None,None
1153_240906004_B,185,XAUUSD,Buy,2018-07-25 12:00:00,2018-07-25 16:00:00,1232.57,1232.4,1,-17,57616.9,Exit After X Bars,,None,None,None,None
1157_240906004_B,185,XAUUSD,Buy,2018-07-31 16:00:00,2018-07-31 20:00:00,1225.02,1225.98,1,96,57712.9,Exit After X Bars,,None,None,None,None
1160_240906004_B,185,XAUUSD,Buy,2018-08-03 16:00:00,2018-08-03 20:00:00,1218.29,1215.78,1,-251,57461.9,Exit After X Bars,,None,None,None,None
1162_240906004_B,185,XAUUSD,Buy,2018-08-09 08:00:00,2018-08-09 12:00:00,1216.1,1212.92,1,-318,57143.9,Exit After X Bars,,None,None,None,None
1168_240906004_B,185,XAUUSD,Buy,2018-08-17 20:00:00,2018-08-20 00:00:00,1181.68,1183.33,1,165,57308.9,End Of Friday,,None,None,None,None
1170_240906004_B,185,XAUUSD,Buy,2018-08-24 12:00:00,2018-08-24 16:00:00,1192.85,1193.8,1,95,57403.9,Exit After X Bars,,None,None,None,None
1172_240906004_B,185,XAUUSD,Buy,2018-08-31 08:00:00,2018-08-31 12:00:00,1207.79,1206.3,1,-149,57254.9,Exit After X Bars,,None,None,None,None
1175_240906004_B,185,XAUUSD,Buy,2018-09-05 16:00:00,2018-09-05 20:00:00,1196.55,1195.41,1,-114,57140.9,Exit After X Bars,,None,None,None,None
1178_240906004_B,185,XAUUSD,Buy,2018-09-11 20:00:00,2018-09-12 00:00:00,1198.43,1198.01,1,-42,57098.9,Exit After X Bars,,None,None,None,None
1181_240906004_B,185,XAUUSD,Buy,2018-09-19 12:00:00,2018-09-19 16:00:00,1204.77,1205.23,1,46,57144.9,Exit After X Bars,,None,None,None,None
1188_240906004_B,185,XAUUSD,Buy,2018-10-02 08:00:00,2018-10-02 12:00:00,1193.83,1193.13,1,-70,57074.9,Exit After X Bars,,None,None,None,None
1193_240906004_B,185,XAUUSD,Buy,2018-10-10 20:00:00,2018-10-11 00:00:00,1190.57,1194.76,1,419,57493.9,Exit After X Bars,,None,None,None,None
1195_240906004_B,185,XAUUSD,Buy,2018-10-18 16:00:00,2018-10-18 20:00:00,1229.43,1227.71,1,-172,57321.9,Exit After X Bars,,None,None,None,None
1196_240906004_B,185,XAUUSD,Buy,2018-10-23 08:00:00,2018-10-23 12:00:00,1230.73,1235.63,1,490,57811.9,Exit After X Bars,,None,None,None,None
1198_240906004_B,185,XAUUSD,Buy,2018-10-26 08:00:00,2018-10-26 12:00:00,1236.59,1237.36,1,77,57888.9,Exit After X Bars,,None,None,None,None
1201_240906004_B,185,XAUUSD,Buy,2018-11-01 08:00:00,2018-11-01 12:00:00,1226.48,1225.73,1,-75,57813.9,Exit After X Bars,,None,None,None,None
1203_240906004_B,185,XAUUSD,Buy,2018-11-07 08:00:00,2018-11-07 12:00:00,1233.18,1233.49,1,31,57844.9,Exit After X Bars,,None,None,None,None
1208_240906004_B,185,XAUUSD,Buy,2018-11-14 16:00:00,2018-11-14 20:00:00,1204.33,1208.29,1,396,58240.9,Exit After X Bars,,None,None,None,None
1210_240906004_B,185,XAUUSD,Buy,2018-11-26 16:00:00,2018-11-26 20:00:00,1225.29,1222.39,1,-290,57950.9,Exit After X Bars,,None,None,None,None
1212_240906004_B,185,XAUUSD,Buy,2018-11-28 16:00:00,2018-11-28 20:00:00,1225.18,1221.12,1,-406,57544.9,Exit After X Bars,,None,None,None,None
1218_240906004_B,185,XAUUSD,Buy,2018-12-17 12:00:00,2018-12-17 16:00:00,1240.3,1241.54,1,124,57668.9,Exit After X Bars,,None,None,None,None
1222_240906004_B,185,XAUUSD,Buy,2019-01-09 16:00:00,2019-01-09 20:00:00,1287.0,1289.85,1,285,57953.9,Exit After X Bars,,None,None,None,None
1227_240906004_B,185,XAUUSD,Buy,2019-01-23 16:00:00,2019-01-23 20:00:00,1285.61,1284.65,1,-96,57857.9,Exit After X Bars,,None,None,None,None
1228_240906004_B,185,XAUUSD,Buy,2019-01-25 12:00:00,2019-01-25 16:00:00,1285.77,1288.55,1,278,58135.9,Exit After X Bars,,None,None,None,None
1231_240906004_B,185,XAUUSD,Buy,2019-02-05 12:00:00,2019-02-05 16:00:00,1315.17,1314.58,1,-59,58076.9,Exit After X Bars,,None,None,None,None
1233_240906004_B,185,XAUUSD,Buy,2019-02-08 12:00:00,2019-02-08 16:00:00,1311.86,1314.73,1,287,58363.9,Exit After X Bars,,None,None,None,None
1234_240906004_B,185,XAUUSD,Buy,2019-02-13 16:00:00,2019-02-13 20:00:00,1315.55,1311.68,1,-387,57976.9,Exit After X Bars,,None,None,None,None
1235_240906004_B,185,XAUUSD,Buy,2019-02-15 12:00:00,2019-02-15 16:00:00,1318.07,1317.47,1,-60,57916.9,Exit After X Bars,,None,None,None,None
1244_240906004_B,185,XAUUSD,Buy,2019-03-06 08:00:00,2019-03-06 12:00:00,1289.68,1285.95,1,-373,57543.9,Exit After X Bars,,None,None,None,None
1245_240906004_B,185,XAUUSD,Buy,2019-03-08 04:00:00,2019-03-08 08:00:00,1288.46,1290.66,1,220,57763.9,Exit After X Bars,,None,None,None,None
1246_240906004_B,185,XAUUSD,Buy,2019-03-12 20:00:00,2019-03-13 00:00:00,1300.68,1301.22,1,54,57817.9,Exit After X Bars,,None,None,None,None
1248_240906004_B,185,XAUUSD,Buy,2019-03-20 20:00:00,2019-03-21 00:00:00,1310.82,1312.96,1,214,58031.9,Exit After X Bars,,None,None,None,None
1250_240906004_B,185,XAUUSD,Buy,2019-03-27 12:00:00,2019-03-27 16:00:00,1318.76,1315.07,1,-369,57662.9,Exit After X Bars,,None,None,None,None
1265_240906004_B,185,XAUUSD,Buy,2019-04-24 12:00:00,2019-04-24 16:00:00,1273.91,1270.9,1,-301,57361.9,Exit After X Bars,,None,None,None,None
1267_240906004_B,185,XAUUSD,Buy,2019-04-30 16:00:00,2019-04-30 20:00:00,1284.38,1283.46,1,-92,57269.9,Exit After X Bars,,None,None,None,None
1268_240906004_B,185,XAUUSD,Buy,2019-05-01 20:00:00,2019-05-02 00:00:00,1286.11,1276.65,1,-946,56323.9,Exit After X Bars,,None,None,None,None
1270_240906004_B,185,XAUUSD,Buy,2019-05-03 12:00:00,2019-05-03 16:00:00,1272.95,1275.84,1,289,56612.9,Exit After X Bars,,None,None,None,None
1273_240906004_B,185,XAUUSD,Buy,2019-05-13 12:00:00,2019-05-13 16:00:00,1289.33,1291.42,1,209,56821.9,Exit After X Bars,,None,None,None,None
1278_240906004_B,185,XAUUSD,Buy,2019-05-22 12:00:00,2019-05-22 16:00:00,1276.26,1275.58,1,-68,56753.9,Exit After X Bars,,None,None,None,None
1281_240906004_B,185,XAUUSD,Buy,2019-05-30 16:00:00,2019-05-30 20:00:00,1285.45,1287.07,1,162,56915.9,Exit After X Bars,,None,None,None,None
1283_240906004_B,185,XAUUSD,Buy,2019-06-12 04:00:00,2019-06-12 08:00:00,1330.03,1332.3,1,227,57142.9,Exit After X Bars,,None,None,None,None
1284_240906004_B,185,XAUUSD,Buy,2019-06-19 20:00:00,2019-06-20 00:00:00,1355.59,1360.32,1,473,57615.9,Exit After X Bars,,None,None,None,None
1286_240906004_B,185,XAUUSD,Buy,2019-06-28 00:00:00,2019-06-28 04:00:00,1415.15,1414.25,1,-90,57525.9,Exit After X Bars,,None,None,None,None
1288_240906004_B,185,XAUUSD,Buy,2019-07-02 16:00:00,2019-07-02 20:00:00,1396.24,1404.96,1,872,58397.9,Exit After X Bars,,None,None,None,None
1292_240906004_B,185,XAUUSD,Buy,2019-07-10 12:00:00,2019-07-10 16:00:00,1400.01,1410.09,1,1008,59405.9,Exit After X Bars,,None,None,None,None
1294_240906004_B,185,XAUUSD,Buy,2019-07-15 20:00:00,2019-07-16 00:00:00,1416.8,1414.49,1,-231,59174.9,Exit After X Bars,,None,None,None,None
1296_240906004_B,185,XAUUSD,Buy,2019-07-17 16:00:00,2019-07-17 20:00:00,1416.22,1422.27,1,605,59779.9,Exit After X Bars,,None,None,None,None
1299_240906004_B,185,XAUUSD,Buy,2019-07-23 16:00:00,2019-07-23 20:00:00,1429.03,1419.41,1,-962,58817.9,Exit After X Bars,,None,None,None,None
1302_240906004_B,185,XAUUSD,Buy,2019-07-29 20:00:00,2019-07-30 00:00:00,1424.76,1426.49,1,173,58990.9,Exit After X Bars,,None,None,None,None
1304_240906004_B,185,XAUUSD,Buy,2019-08-01 20:00:00,2019-08-02 00:00:00,1434.25,1444.8,1,1055,60045.9,Exit After X Bars,,None,None,None,None
1309_240906004_B,185,XAUUSD,Buy,2019-08-20 12:00:00,2019-08-20 16:00:00,1503.32,1504.12,1,80,60125.9,Exit After X Bars,,None,None,None,None
1312_240906004_B,185,XAUUSD,Buy,2019-08-23 12:00:00,2019-08-23 16:00:00,1504.51,1502.29,1,-222,59903.9,Exit After X Bars,,None,None,None,None
1315_240906004_B,185,XAUUSD,Buy,2019-09-03 08:00:00,2019-09-03 12:00:00,1532.74,1532.2,1,-54,59849.9,Exit After X Bars,,None,None,None,None
1320_240906004_B,185,XAUUSD,Buy,2019-09-12 08:00:00,2019-09-12 12:00:00,1500.93,1504.38,1,345,60194.9,Exit After X Bars,,None,None,None,None
1322_240906004_B,185,XAUUSD,Buy,2019-09-17 16:00:00,2019-09-17 20:00:00,1506.18,1505.75,1,-43,60151.9,Exit After X Bars,,None,None,None,None
1323_240906004_B,185,XAUUSD,Buy,2019-09-20 20:00:00,2019-09-23 00:00:00,1511.54,1513.99,1,245,60396.9,End Of Friday,,None,None,None,None
1328_240906004_B,185,XAUUSD,Buy,2019-10-02 12:00:00,2019-10-02 16:00:00,1488.3,1492.34,1,404,60800.9,Exit After X Bars,,None,None,None,None
1331_240906004_B,185,XAUUSD,Buy,2019-10-08 12:00:00,2019-10-08 16:00:00,1504.05,1503.57,1,-48,60752.9,Exit After X Bars,,None,None,None,None
1338_240906004_B,185,XAUUSD,Buy,2019-10-23 16:00:00,2019-10-23 20:00:00,1495.2,1492.28,1,-292,60460.9,Exit After X Bars,,None,None,None,None
1341_240906004_B,185,XAUUSD,Buy,2019-10-30 12:00:00,2019-10-30 16:00:00,1494.48,1492.42,1,-206,60254.9,Exit After X Bars,,None,None,None,None
1347_240906004_B,185,XAUUSD,Buy,2019-11-13 12:00:00,2019-11-13 16:00:00,1466.35,1461.75,1,-460,59794.9,Exit After X Bars,,None,None,None,None
1349_240906004_B,185,XAUUSD,Buy,2019-11-18 16:00:00,2019-11-18 20:00:00,1469.1,1471.97,1,287,60081.9,Exit After X Bars,,None,None,None,None
1350_240906004_B,185,XAUUSD,Buy,2019-11-20 04:00:00,2019-11-20 08:00:00,1475.31,1475.31,1,0,60081.9,Exit After X Bars,,None,None,None,None
1354_240906004_B,185,XAUUSD,Buy,2019-11-26 16:00:00,2019-11-26 20:00:00,1460.7,1460.05,1,-65,60016.9,Exit After X Bars,,None,None,None,None
1357_240906004_B,185,XAUUSD,Buy,2019-11-29 16:00:00,2019-11-29 20:00:00,1457.56,1463.89,1,633,60649.9,Exit After X Bars,,None,None,None,None
1358_240906004_B,185,XAUUSD,Buy,2019-12-03 08:00:00,2019-12-03 12:00:00,1466.52,1466.06,1,-46,60603.9,Exit After X Bars,,None,None,None,None
1361_240906004_B,185,XAUUSD,Buy,2019-12-10 12:00:00,2019-12-10 16:00:00,1465.31,1466.97,1,166,60769.9,Exit After X Bars,,None,None,None,None
1365_240906004_B,185,XAUUSD,Buy,2019-12-19 16:00:00,2019-12-19 20:00:00,1479.2,1479.76,1,56,60825.9,Exit After X Bars,,None,None,None,None
1368_240906004_B,185,XAUUSD,Buy,2020-01-10 12:00:00,2020-01-10 16:00:00,1556.45,1548.64,1,-781,60044.9,Exit After X Bars,,None,None,None,None
1370_240906004_B,185,XAUUSD,Buy,2020-01-15 16:00:00,2020-01-15 20:00:00,1556.02,1553.85,1,-217,59827.9,Exit After X Bars,,None,None,None,None
1372_240906004_B,185,XAUUSD,Buy,2020-01-23 00:00:00,2020-01-23 04:00:00,1559.93,1559.89,1,-4,59823.9,Exit After X Bars,,None,None,None,None
1374_240906004_B,185,XAUUSD,Buy,2020-01-30 04:00:00,2020-01-30 08:00:00,1580.65,1578.08,1,-257,59566.9,Exit After X Bars,,None,None,None,None
1377_240906004_B,185,XAUUSD,Buy,2020-02-07 16:00:00,2020-02-07 20:00:00,1571.51,1568.99,1,-252,59314.9,Exit After X Bars,,None,None,None,None
1379_240906004_B,185,XAUUSD,Buy,2020-02-13 04:00:00,2020-02-13 08:00:00,1573.97,1574.09,1,12,59326.9,Exit After X Bars,,None,None,None,None
1381_240906004_B,185,XAUUSD,Buy,2020-02-27 16:00:00,2020-02-27 20:00:00,1658.34,1640.75,1,-1759,57567.9,Exit After X Bars,,None,None,None,None
1384_240906004_B,185,XAUUSD,Buy,2020-03-03 16:00:00,2020-03-03 20:00:00,1610.93,1645.16,1,3423,60990.9,Exit After X Bars,,None,None,None,None
1386_240906004_B,185,XAUUSD,Buy,2020-03-11 12:00:00,2020-03-11 16:00:00,1667.43,1665.52,1,-191,60799.9,Exit After X Bars,,None,None,None,None
1390_240906004_B,185,XAUUSD,Buy,2020-03-17 16:00:00,2020-03-17 20:00:00,1540.77,1527.22,1,-1355,59444.9,Exit After X Bars,,None,None,None,None
1395_240906004_B,185,XAUUSD,Buy,2020-04-02 12:00:00,2020-04-02 16:00:00,1596.77,1601.04,1,427,59871.9,Exit After X Bars,,None,None,None,None
1398_240906004_B,185,XAUUSD,Buy,2020-04-20 16:00:00,2020-04-20 20:00:00,1701.57,1693.91,1,-766,59105.9,Exit After X Bars,,None,None,None,None
1399_240906004_B,185,XAUUSD,Buy,2020-04-22 12:00:00,2020-04-22 16:00:00,1702.1,1705.99,1,389,59494.9,Exit After X Bars,,None,None,None,None
1402_240906004_B,185,XAUUSD,Buy,2020-04-29 20:00:00,2020-04-30 00:00:00,1714.55,1711.6,1,-295,59199.9,Exit After X Bars,,None,None,None,None
1406_240906004_B,185,XAUUSD,Buy,2020-05-07 16:00:00,2020-05-07 20:00:00,1704.83,1715.17,1,1034,60233.9,Exit After X Bars,,None,None,None,None
1408_240906004_B,185,XAUUSD,Buy,2020-05-12 16:00:00,2020-05-12 20:00:00,1708.16,1702.46,1,-570,59663.9,Exit After X Bars,,None,None,None,None
1415_240906004_B,185,XAUUSD,Buy,2020-05-29 12:00:00,2020-05-29 16:00:00,1729.12,1730.55,1,143,59806.9,Exit After X Bars,,None,None,None,None
1420_240906004_B,185,XAUUSD,Buy,2020-06-09 12:00:00,2020-06-09 16:00:00,1711.56,1716.31,1,475,60281.9,Exit After X Bars,,None,None,None,None
1422_240906004_B,185,XAUUSD,Buy,2020-06-18 08:00:00,2020-06-18 12:00:00,1731.98,1732.86,1,88,60369.9,Exit After X Bars,,None,None,None,None
1423_240906004_B,185,XAUUSD,Buy,2020-06-26 16:00:00,2020-06-26 20:00:00,1766.39,1767.46,1,107,60476.9,Exit After X Bars,,None,None,None,None
1429_240906004_B,185,XAUUSD,Buy,2020-07-17 16:00:00,2020-07-17 20:00:00,1808.7,1807.75,1,-95,60381.9,Exit After X Bars,,None,None,None,None
1430_240906004_B,185,XAUUSD,Buy,2020-07-31 08:00:00,2020-07-31 12:00:00,1980.74,1976.84,1,-390,59991.9,Exit After X Bars,,None,None,None,None
1435_240906004_B,185,XAUUSD,Buy,2020-08-13 16:00:00,2020-08-13 20:00:00,1949.11,1953.66,1,455,60446.9,Exit After X Bars,,None,None,None,None
1441_240906004_B,185,XAUUSD,Buy,2020-08-26 16:00:00,2020-08-26 20:00:00,1931.88,1943.23,1,1135,61581.9,Exit After X Bars,,None,None,None,None
1442_240906004_B,185,XAUUSD,Buy,2020-08-28 08:00:00,2020-08-28 12:00:00,1954.9,1955.77,1,87,61668.9,Exit After X Bars,,None,None,None,None
1445_240906004_B,185,XAUUSD,Buy,2020-09-04 12:00:00,2020-09-04 16:00:00,1945.73,1927.17,1,-1856,59812.9,Exit After X Bars,,None,None,None,None
1447_240906004_B,185,XAUUSD,Buy,2020-09-08 16:00:00,2020-09-08 20:00:00,1932.55,1938.77,1,622,60434.9,Exit After X Bars,,None,None,None,None
1450_240906004_B,185,XAUUSD,Buy,2020-09-18 16:00:00,2020-09-18 20:00:00,1951.78,1958.73,1,695,61129.9,Exit After X Bars,,None,None,None,None
1456_240906004_B,185,XAUUSD,Buy,2020-09-28 16:00:00,2020-09-28 20:00:00,1872.53,1874.47,1,194,61323.9,Exit After X Bars,,None,None,None,None
1459_240906004_B,185,XAUUSD,Buy,2020-10-08 20:00:00,2020-10-09 00:00:00,1891.73,1893.54,1,181,61504.9,Exit After X Bars,,None,None,None,None
1462_240906004_B,185,XAUUSD,Buy,2020-10-16 12:00:00,2020-10-16 16:00:00,1912.82,1906.71,1,-611,60893.9,Exit After X Bars,,None,None,None,None
1463_240906004_B,185,XAUUSD,Buy,2020-10-21 04:00:00,2020-10-21 08:00:00,1918.33,1918.98,1,65,60958.9,Exit After X Bars,,None,None,None,None
1467_240906004_B,185,XAUUSD,Buy,2020-10-27 16:00:00,2020-10-27 20:00:00,1908.45,1909.17,1,72,61030.9,Exit After X Bars,,None,None,None,None
1470_240906004_B,185,XAUUSD,Buy,2020-10-30 12:00:00,2020-10-30 16:00:00,1881.72,1887.35,1,563,61593.9,Exit After X Bars,,None,None,None,None
1471_240906004_B,185,XAUUSD,Buy,2020-11-05 08:00:00,2020-11-05 12:00:00,1916.21,1917.0,1,79,61672.9,Exit After X Bars,,None,None,None,None
1475_240906004_B,185,XAUUSD,Buy,2020-11-12 16:00:00,2020-11-12 20:00:00,1881.8,1877.3,1,-450,61222.9,Exit After X Bars,,None,None,None,None
1478_240906004_B,185,XAUUSD,Buy,2020-11-20 12:00:00,2020-11-20 16:00:00,1867.58,1867.3,1,-28,61194.9,Exit After X Bars,,None,None,None,None
1484_240906004_B,185,XAUUSD,Buy,2020-12-01 12:00:00,2020-12-01 16:00:00,1809.64,1812.76,1,312,61506.9,Exit After X Bars,,None,None,None,None
1485_240906004_B,185,XAUUSD,Buy,2020-12-07 16:00:00,2020-12-07 20:00:00,1848.06,1865.34,1,1728,63234.9,Exit After X Bars,,None,None,None,None
1489_240906004_B,185,XAUUSD,Buy,2020-12-15 12:00:00,2020-12-15 16:00:00,1847.62,1852.64,1,502,63736.9,Exit After X Bars,,None,None,None,None
1492_240906004_B,185,XAUUSD,Buy,2020-12-24 20:00:00,2020-12-28 00:00:00,1881.37,1882.92,1,155,63891.9,End Of Friday,,None,None,None,None
1493_240906004_B,185,XAUUSD,Buy,2020-12-30 16:00:00,2020-12-30 20:00:00,1886.26,1888.73,1,247,64138.9,Exit After X Bars,,None,None,None,None
1498_240906004_B,185,XAUUSD,Buy,2021-01-12 20:00:00,2021-01-13 00:00:00,1852.37,1854.33,1,196,64334.9,Exit After X Bars,,None,None,None,None
1501_240906004_B,185,XAUUSD,Buy,2021-01-20 08:00:00,2021-01-20 12:00:00,1855.76,1854.51,1,-125,64209.9,Exit After X Bars,,None,None,None,None
1503_240906004_B,185,XAUUSD,Buy,2021-01-25 12:00:00,2021-01-25 16:00:00,1859.01,1864.87,1,586,64795.9,Exit After X Bars,,None,None,None,None
1506_240906004_B,185,XAUUSD,Buy,2021-01-28 12:00:00,2021-01-28 16:00:00,1850.48,1856.92,1,644,65439.9,Exit After X Bars,,None,None,None,None
1517_240906004_B,185,XAUUSD,Buy,2021-02-19 16:00:00,2021-02-19 20:00:00,1789.44,1783.0,1,-644,64795.9,Exit After X Bars,,None,None,None,None
1526_240906004_B,185,XAUUSD,Buy,2021-03-09 12:00:00,2021-03-09 16:00:00,1707.63,1713.35,1,572,65367.9,Exit After X Bars,,None,None,None,None
1528_240906004_B,185,XAUUSD,Buy,2021-03-17 20:00:00,2021-03-18 00:00:00,1741.13,1744.8,1,367,65734.9,Exit After X Bars,,None,None,None,None
1533_240906004_B,185,XAUUSD,Buy,2021-03-25 16:00:00,2021-03-25 20:00:00,1738.31,1728.18,1,-1013,64721.9,Exit After X Bars,,None,None,None,None
1537_240906004_B,185,XAUUSD,Buy,2021-03-31 16:00:00,2021-03-31 20:00:00,1700.81,1711.84,1,1103,65824.9,Exit After X Bars,,None,None,None,None
1540_240906004_B,185,XAUUSD,Buy,2021-04-13 16:00:00,2021-04-13 20:00:00,1744.92,1742.5,1,-242,65582.9,Exit After X Bars,,None,None,None,None
1541_240906004_B,185,XAUUSD,Buy,2021-04-15 12:00:00,2021-04-15 16:00:00,1748.91,1746.8,1,-211,65371.9,Exit After X Bars,,None,None,None,None
1542_240906004_B,185,XAUUSD,Buy,2021-04-21 16:00:00,2021-04-21 20:00:00,1789.95,1790.73,1,78,65449.9,Exit After X Bars,,None,None,None,None
1544_240906004_B,185,XAUUSD,Buy,2021-04-23 12:00:00,2021-04-23 16:00:00,1790.6,1793.44,1,284,65733.9,Exit After X Bars,,None,None,None,None
1547_240906004_B,185,XAUUSD,Buy,2021-04-29 00:00:00,2021-04-29 04:00:00,1785.44,1784.61,1,-83,65650.9,Exit After X Bars,,None,None,None,None
1550_240906004_B,185,XAUUSD,Buy,2021-05-06 16:00:00,2021-05-06 20:00:00,1798.87,1815.7,1,1683,67333.9,Exit After X Bars,,None,None,None,None
1553_240906004_B,185,XAUUSD,Buy,2021-05-14 20:00:00,2021-05-17 00:00:00,1843.57,1844.53,1,96,67429.9,End Of Friday,,None,None,None,None
1555_240906004_B,185,XAUUSD,Buy,2021-05-28 16:00:00,2021-05-28 20:00:00,1898.71,1899.75,1,104,67533.9,Exit After X Bars,,None,None,None,None
1559_240906004_B,185,XAUUSD,Buy,2021-06-07 20:00:00,2021-06-08 00:00:00,1896.09,1897.97,1,188,67721.9,Exit After X Bars,,None,None,None,None
1561_240906004_B,185,XAUUSD,Buy,2021-06-10 20:00:00,2021-06-11 00:00:00,1898.91,1897.78,1,-113,67608.9,Exit After X Bars,,None,None,None,None
1569_240906004_B,185,XAUUSD,Buy,2021-06-23 16:00:00,2021-06-23 20:00:00,1787.61,1783.21,1,-440,67168.9,Exit After X Bars,,None,None,None,None
1573_240906004_B,185,XAUUSD,Buy,2021-07-01 04:00:00,2021-07-01 08:00:00,1775.8,1774.39,1,-141,67027.9,Exit After X Bars,,None,None,None,None
1574_240906004_B,185,XAUUSD,Buy,2021-07-09 16:00:00,2021-07-09 20:00:00,1809.64,1810.33,1,69,67096.9,Exit After X Bars,,None,None,None,None
1575_240906004_B,185,XAUUSD,Buy,2021-07-13 16:00:00,2021-07-13 20:00:00,1808.41,1811.44,1,303,67399.9,Exit After X Bars,,None,None,None,None
1578_240906004_B,185,XAUUSD,Buy,2021-07-20 12:00:00,2021-07-20 16:00:00,1815.44,1822.68,1,724,68123.9,Exit After X Bars,,None,None,None,None
1580_240906004_B,185,XAUUSD,Buy,2021-07-23 08:00:00,2021-07-23 12:00:00,1808.83,1804.31,1,-452,67671.9,Exit After X Bars,,None,None,None,None
1582_240906004_B,185,XAUUSD,Buy,2021-07-29 00:00:00,2021-07-29 04:00:00,1809.8,1809.44,1,-36,67635.9,Exit After X Bars,,None,None,None,None
1585_240906004_B,185,XAUUSD,Buy,2021-08-04 12:00:00,2021-08-04 16:00:00,1819.41,1827.06,1,765,68400.9,Exit After X Bars,,None,None,None,None
1590_240906004_B,185,XAUUSD,Buy,2021-08-11 12:00:00,2021-08-11 16:00:00,1733.61,1744.61,1,1100,69500.9,Exit After X Bars,,None,None,None,None
1595_240906004_B,185,XAUUSD,Buy,2021-08-26 16:00:00,2021-08-26 20:00:00,1797.65,1792.11,1,-554,68946.9,Exit After X Bars,,None,None,None,None
1597_240906004_B,185,XAUUSD,Buy,2021-09-01 12:00:00,2021-09-01 16:00:00,1816.94,1819.32,1,238,69184.9,Exit After X Bars,,None,None,None,None
1598_240906004_B,185,XAUUSD,Buy,2021-09-03 12:00:00,2021-09-03 16:00:00,1819.89,1823.4,1,351,69535.9,Exit After X Bars,,None,None,None,None
1601_240906004_B,185,XAUUSD,Buy,2021-09-10 08:00:00,2021-09-10 12:00:00,1802.06,1801.59,1,-47,69488.9,Exit After X Bars,,None,None,None,None
1603_240906004_B,185,XAUUSD,Buy,2021-09-14 12:00:00,2021-09-14 16:00:00,1798.25,1797.16,1,-109,69379.9,Exit After X Bars,,None,None,None,None
1607_240906004_B,185,XAUUSD,Buy,2021-09-21 12:00:00,2021-09-21 16:00:00,1767.4,1771.79,1,439,69818.9,Exit After X Bars,,None,None,None,None
1610_240906004_B,185,XAUUSD,Buy,2021-09-27 16:00:00,2021-09-27 20:00:00,1757.54,1752.14,1,-540,69278.9,Exit After X Bars,,None,None,None,None
1612_240906004_B,185,XAUUSD,Buy,2021-09-29 12:00:00,2021-09-29 16:00:00,1743.74,1738.32,1,-542,68736.9,Exit After X Bars,,None,None,None,None
1613_240906004_B,185,XAUUSD,Buy,2021-09-30 16:00:00,2021-09-30 20:00:00,1745.4,1758.15,1,1275,70011.9,Exit After X Bars,,None,None,None,None
1615_240906004_B,185,XAUUSD,Buy,2021-10-06 16:00:00,2021-10-06 20:00:00,1762.92,1762.34,1,-58,69953.9,Exit After X Bars,,None,None,None,None
1617_240906004_B,185,XAUUSD,Buy,2021-10-08 12:00:00,2021-10-08 16:00:00,1764.61,1775.77,1,1116,71069.9,Exit After X Bars,,None,None,None,None
1618_240906004_B,185,XAUUSD,Buy,2021-10-13 16:00:00,2021-10-13 20:00:00,1781.22,1792.5,1,1128,72197.9,Exit After X Bars,,None,None,None,None
1621_240906004_B,185,XAUUSD,Buy,2021-10-20 04:00:00,2021-10-20 08:00:00,1771.1,1774.1,1,300,72497.9,Exit After X Bars,,None,None,None,None
1623_240906004_B,185,XAUUSD,Buy,2021-10-28 12:00:00,2021-10-28 16:00:00,1804.5,1798.98,1,-552,71945.9,Exit After X Bars,,None,None,None,None
1627_240906004_B,185,XAUUSD,Buy,2021-11-04 12:00:00,2021-11-04 16:00:00,1785.54,1792.52,1,698,72643.9,Exit After X Bars,,None,None,None,None
1635_240906004_B,185,XAUUSD,Buy,2021-11-26 00:00:00,2021-11-26 04:00:00,1793.1,1792.39,1,-71,72572.9,Exit After X Bars,,None,None,None,None
1640_240906004_B,185,XAUUSD,Buy,2021-12-03 16:00:00,2021-12-03 20:00:00,1781.12,1780.42,1,-70,72502.9,Exit After X Bars,,None,None,None,None
1641_240906004_B,185,XAUUSD,Buy,2021-12-07 16:00:00,2021-12-07 20:00:00,1784.86,1783.02,1,-184,72318.9,Exit After X Bars,,None,None,None,None
1643_240906004_B,185,XAUUSD,Buy,2021-12-10 12:00:00,2021-12-10 16:00:00,1784.0,1784.07,1,7,72325.9,Exit After X Bars,,None,None,None,None
1645_240906004_B,185,XAUUSD,Buy,2021-12-16 08:00:00,2021-12-16 12:00:00,1785.57,1785.43,1,-14,72311.9,Exit After X Bars,,None,None,None,None
1647_240906004_B,185,XAUUSD,Buy,2021-12-21 12:00:00,2021-12-21 16:00:00,1800.07,1797.87,1,-220,72091.9,Exit After X Bars,,None,None,None,None
1648_240906004_B,185,XAUUSD,Buy,2021-12-22 20:00:00,2021-12-23 00:00:00,1800.43,1803.8,1,337,72428.9,Exit After X Bars,,None,None,None,None
1650_240906004_B,185,XAUUSD,Buy,2021-12-30 16:00:00,2021-12-30 20:00:00,1805.64,1813.42,1,778,73206.9,Exit After X Bars,,None,None,None,None
1652_240906004_B,185,XAUUSD,Buy,2022-01-05 12:00:00,2022-01-05 16:00:00,1827.4,1825.4,1,-200,73006.9,Exit After X Bars,,None,None,None,None
1655_240906004_B,185,XAUUSD,Buy,2022-01-10 16:00:00,2022-01-10 20:00:00,1798.51,1799.26,1,75,73081.9,Exit After X Bars,,None,None,None,None
1657_240906004_B,185,XAUUSD,Buy,2022-01-19 12:00:00,2022-01-19 16:00:00,1822.26,1823.91,1,165,73246.9,Exit After X Bars,,None,None,None,None
1659_240906004_B,185,XAUUSD,Buy,2022-01-24 20:00:00,2022-01-25 00:00:00,1843.09,1842.67,1,-42,73204.9,Exit After X Bars,,None,None,None,None
1663_240906004_B,185,XAUUSD,Buy,2022-01-31 12:00:00,2022-01-31 16:00:00,1792.85,1797.59,1,474,73678.9,Exit After X Bars,,None,None,None,None
1664_240906004_B,185,XAUUSD,Buy,2022-02-04 16:00:00,2022-02-04 20:00:00,1807.55,1806.29,1,-126,73552.9,Exit After X Bars,,None,None,None,None
1665_240906004_B,185,XAUUSD,Buy,2022-02-11 20:00:00,2022-02-14 00:00:00,1841.82,1859.23,1,1741,75293.9,End Of Friday,,None,None,None,None
1666_240906004_B,185,XAUUSD,Buy,2022-02-17 04:00:00,2022-02-17 08:00:00,1874.0,1874.93,1,93,75386.9,Exit After X Bars,,None,None,None,None
1667_240906004_B,185,XAUUSD,Buy,2022-02-23 16:00:00,2022-02-23 20:00:00,1907.01,1908.22,1,121,75507.9,Exit After X Bars,,None,None,None,None
1669_240906004_B,185,XAUUSD,Buy,2022-02-28 12:00:00,2022-02-28 16:00:00,1913.78,1917.14,1,336,75843.9,Exit After X Bars,,None,None,None,None
1675_240906004_B,185,XAUUSD,Buy,2022-03-17 04:00:00,2022-03-17 08:00:00,1934.78,1935.8,1,102,75945.9,Exit After X Bars,,None,None,None,None
1677_240906004_B,185,XAUUSD,Buy,2022-03-21 20:00:00,2022-03-22 00:00:00,1940.68,1935.43,1,-525,75420.9,Exit After X Bars,,None,None,None,None
1678_240906004_B,185,XAUUSD,Buy,2022-03-23 20:00:00,2022-03-24 00:00:00,1941.14,1942.89,1,175,75595.9,Exit After X Bars,,None,None,None,None
1681_240906004_B,185,XAUUSD,Buy,2022-03-30 12:00:00,2022-03-30 16:00:00,1921.3,1927.08,1,578,76173.9,Exit After X Bars,,None,None,None,None
1683_240906004_B,185,XAUUSD,Buy,2022-04-07 16:00:00,2022-04-07 20:00:00,1936.87,1934.09,1,-278,75895.9,Exit After X Bars,,None,None,None,None
1691_240906004_B,185,XAUUSD,Buy,2022-04-29 08:00:00,2022-04-29 12:00:00,1906.87,1913.84,1,697,76592.9,Exit After X Bars,,None,None,None,None
1694_240906004_B,185,XAUUSD,Buy,2022-05-04 20:00:00,2022-05-05 00:00:00,1877.96,1881.3,1,334,76926.9,Exit After X Bars,,None,None,None,None
1701_240906004_B,185,XAUUSD,Buy,2022-05-16 20:00:00,2022-05-17 00:00:00,1824.5,1824.7,1,20,76946.9,Exit After X Bars,,None,None,None,None
1702_240906004_B,185,XAUUSD,Buy,2022-05-19 12:00:00,2022-05-19 16:00:00,1835.97,1838.19,1,222,77168.9,Exit After X Bars,,None,None,None,None
1704_240906004_B,185,XAUUSD,Buy,2022-05-27 08:00:00,2022-05-27 12:00:00,1859.27,1856.65,1,-262,76906.9,Exit After X Bars,,None,None,None,None
1706_240906004_B,185,XAUUSD,Buy,2022-06-02 12:00:00,2022-06-02 16:00:00,1855.3,1856.51,1,121,77027.9,Exit After X Bars,,None,None,None,None
1709_240906004_B,185,XAUUSD,Buy,2022-06-08 16:00:00,2022-06-08 20:00:00,1857.74,1855.32,1,-242,76785.9,Exit After X Bars,,None,None,None,None
1710_240906004_B,185,XAUUSD,Buy,2022-06-10 16:00:00,2022-06-10 20:00:00,1852.52,1871.61,1,1909,78694.9,Exit After X Bars,,None,None,None,None
1713_240906004_B,185,XAUUSD,Buy,2022-06-15 12:00:00,2022-06-15 16:00:00,1825.68,1831.58,1,590,79284.9,Exit After X Bars,,None,None,None,None
1716_240906004_B,185,XAUUSD,Buy,2022-06-22 12:00:00,2022-06-22 16:00:00,1843.51,1844.59,1,108,79392.9,Exit After X Bars,,None,None,None,None
1721_240906004_B,185,XAUUSD,Buy,2022-06-29 12:00:00,2022-06-29 16:00:00,1827.74,1831.18,1,344,79736.9,Exit After X Bars,,None,None,None,None
1724_240906004_B,185,XAUUSD,Buy,2022-07-05 04:00:00,2022-07-05 08:00:00,1811.69,1811.34,1,-35,79701.9,Exit After X Bars,,None,None,None,None
1727_240906004_B,185,XAUUSD,Buy,2022-07-08 16:00:00,2022-07-08 20:00:00,1748.98,1742.24,1,-674,79027.9,Exit After X Bars,,None,None,None,None
1730_240906004_B,185,XAUUSD,Buy,2022-07-13 16:00:00,2022-07-13 20:00:00,1739.27,1737.85,1,-142,78885.9,Exit After X Bars,,None,None,None,None
1734_240906004_B,185,XAUUSD,Buy,2022-07-21 16:00:00,2022-07-21 20:00:00,1714.39,1711.62,1,-277,78608.9,Exit After X Bars,,None,None,None,None
1736_240906004_B,185,XAUUSD,Buy,2022-07-27 20:00:00,2022-07-28 00:00:00,1724.32,1734.05,1,973,79581.9,Exit After X Bars,,None,None,None,None
1737_240906004_B,185,XAUUSD,Buy,2022-08-04 12:00:00,2022-08-04 16:00:00,1787.9,1780.64,1,-726,78855.9,Exit After X Bars,,None,None,None,None
1739_240906004_B,185,XAUUSD,Buy,2022-08-08 16:00:00,2022-08-08 20:00:00,1789.1,1787.56,1,-154,78701.9,Exit After X Bars,,None,None,None,None
1741_240906004_B,185,XAUUSD,Buy,2022-08-12 20:00:00,2022-08-15 00:00:00,1799.13,1802.31,1,318,79019.9,End Of Friday,,None,None,None,None
1748_240906004_B,185,XAUUSD,Buy,2022-08-23 16:00:00,2022-08-23 20:00:00,1739.91,1749.64,1,973,79992.9,Exit After X Bars,,None,None,None,None
1754_240906004_B,185,XAUUSD,Buy,2022-09-02 12:00:00,2022-09-02 16:00:00,1708.58,1708.73,1,15,80007.9,Exit After X Bars,,None,None,None,None
1756_240906004_B,185,XAUUSD,Buy,2022-09-07 16:00:00,2022-09-07 20:00:00,1714.92,1714.98,1,6,80013.9,Exit After X Bars,,None,None,None,None
1757_240906004_B,185,XAUUSD,Buy,2022-09-09 04:00:00,2022-09-09 08:00:00,1719.3,1721.24,1,194,80207.9,Exit After X Bars,,None,None,None,None
1764_240906004_B,185,XAUUSD,Buy,2022-09-21 20:00:00,2022-09-22 00:00:00,1670.15,1673.04,1,289,80496.9,Exit After X Bars,,None,None,None,None
1768_240906004_B,185,XAUUSD,Buy,2022-09-28 16:00:00,2022-09-28 20:00:00,1642.31,1659.16,1,1685,82181.9,Exit After X Bars,,None,None,None,None
1776_240906004_B,185,XAUUSD,Buy,2022-10-17 12:00:00,2022-10-17 16:00:00,1663.83,1666.48,1,265,82446.9,Exit After X Bars,,None,None,None,None
1779_240906004_B,185,XAUUSD,Buy,2022-10-20 16:00:00,2022-10-20 20:00:00,1641.99,1636.03,1,-596,81850.9,Exit After X Bars,,None,None,None,None
1780_240906004_B,185,XAUUSD,Buy,2022-10-21 16:00:00,2022-10-21 20:00:00,1645.41,1651.3,1,589,82439.9,Exit After X Bars,,None,None,None,None
1781_240906004_B,185,XAUUSD,Buy,2022-10-25 16:00:00,2022-10-25 20:00:00,1654.28,1653.14,1,-114,82325.9,Exit After X Bars,,None,None,None,None
1783_240906004_B,185,XAUUSD,Buy,2022-11-01 12:00:00,2022-11-01 16:00:00,1652.91,1653.8,1,89,82414.9,Exit After X Bars,,None,None,None,None
1784_240906004_B,185,XAUUSD,Buy,2022-11-04 16:00:00,2022-11-04 20:00:00,1669.24,1673.16,1,392,82806.9,Exit After X Bars,,None,None,None,None
1788_240906004_B,185,XAUUSD,Buy,2022-11-22 12:00:00,2022-11-22 16:00:00,1746.81,1743.52,1,-329,82477.9,Exit After X Bars,,None,None,None,None
1789_240906004_B,185,XAUUSD,Buy,2022-11-23 20:00:00,2022-11-24 00:00:00,1749.57,1749.33,1,-24,82453.9,Exit After X Bars,,None,None,None,None
1791_240906004_B,185,XAUUSD,Buy,2022-11-29 08:00:00,2022-11-29 12:00:00,1756.17,1753.91,1,-226,82227.9,Exit After X Bars,,None,None,None,None
1794_240906004_B,185,XAUUSD,Buy,2022-12-07 16:00:00,2022-12-07 20:00:00,1780.71,1782.96,1,225,82452.9,Exit After X Bars,,None,None,None,None
1796_240906004_B,185,XAUUSD,Buy,2022-12-13 12:00:00,2022-12-13 16:00:00,1795.31,1810.86,1,1555,84007.9,Exit After X Bars,,None,None,None,None
1798_240906004_B,185,XAUUSD,Buy,2022-12-16 12:00:00,2022-12-16 16:00:00,1785.88,1785.4,1,-48,83959.9,Exit After X Bars,,None,None,None,None
1803_240906004_B,185,XAUUSD,Buy,2023-01-06 12:00:00,2023-01-06 16:00:00,1851.03,1851.63,1,60,84019.9,Exit After X Bars,,None,None,None,None
1804_240906004_B,185,XAUUSD,Buy,2023-01-18 12:00:00,2023-01-18 16:00:00,1919.17,1921.2,1,203,84222.9,Exit After X Bars,,None,None,None,None
1805_240906004_B,185,XAUUSD,Buy,2023-01-23 20:00:00,2023-01-24 00:00:00,1931.17,1930.6,1,-57,84165.9,Exit After X Bars,,None,None,None,None
1806_240906004_B,185,XAUUSD,Buy,2023-01-25 16:00:00,2023-01-25 20:00:00,1939.26,1937.2,1,-206,83959.9,Exit After X Bars,,None,None,None,None
1810_240906004_B,185,XAUUSD,Buy,2023-01-31 20:00:00,2023-02-01 00:00:00,1930.6,1927.54,1,-306,83653.9,Exit After X Bars,,None,None,None,None
1814_240906004_B,185,XAUUSD,Buy,2023-02-07 16:00:00,2023-02-07 20:00:00,1875.63,1880.47,1,484,84137.9,Exit After X Bars,,None,None,None,None
1817_240906004_B,185,XAUUSD,Buy,2023-02-14 12:00:00,2023-02-14 16:00:00,1868.4,1862.46,1,-594,83543.9,Exit After X Bars,,None,None,None,None
1819_240906004_B,185,XAUUSD,Buy,2023-02-16 16:00:00,2023-02-16 20:00:00,1842.13,1842.34,1,21,83564.9,Exit After X Bars,,None,None,None,None
1822_240906004_B,185,XAUUSD,Buy,2023-02-22 12:00:00,2023-02-22 16:00:00,1843.72,1838.54,1,-518,83046.9,Exit After X Bars,,None,None,None,None
1826_240906004_B,185,XAUUSD,Buy,2023-02-28 16:00:00,2023-02-28 20:00:00,1820.04,1829.15,1,911,83957.9,Exit After X Bars,,None,None,None,None
1829_240906004_B,185,XAUUSD,Buy,2023-03-09 12:00:00,2023-03-09 16:00:00,1824.17,1825.06,1,89,84046.9,Exit After X Bars,,None,None,None,None
1830_240906004_B,185,XAUUSD,Buy,2023-03-15 12:00:00,2023-03-15 16:00:00,1911.83,1927.72,1,1589,85635.9,Exit After X Bars,,None,None,None,None
1832_240906004_B,185,XAUUSD,Buy,2023-03-22 20:00:00,2023-03-23 00:00:00,1969.69,1969.71,1,2,85637.9,Exit After X Bars,,None,None,None,None
1834_240906004_B,185,XAUUSD,Buy,2023-03-28 16:00:00,2023-03-28 20:00:00,1968.56,1968.94,1,38,85675.9,Exit After X Bars,,None,None,None,None
1835_240906004_B,185,XAUUSD,Buy,2023-03-30 12:00:00,2023-03-30 16:00:00,1975.12,1970.18,1,-494,85181.9,Exit After X Bars,,None,None,None,None
1836_240906004_B,185,XAUUSD,Buy,2023-04-03 16:00:00,2023-04-03 20:00:00,1987.47,1986.82,1,-65,85116.9,Exit After X Bars,,None,None,None,None
1839_240906004_B,185,XAUUSD,Buy,2023-04-11 16:00:00,2023-04-11 20:00:00,2002.86,2006.04,1,318,85434.9,Exit After X Bars,,None,None,None,None
1843_240906004_B,185,XAUUSD,Buy,2023-04-20 16:00:00,2023-04-20 20:00:00,2011.73,2005.64,1,-609,84825.9,Exit After X Bars,,None,None,None,None
1845_240906004_B,185,XAUUSD,Buy,2023-04-25 00:00:00,2023-04-25 04:00:00,1997.84,1996.92,1,-92,84733.9,Exit After X Bars,,None,None,None,None
1849_240906004_B,185,XAUUSD,Buy,2023-05-01 12:00:00,2023-05-01 16:00:00,1994.9,2004.07,1,917,85650.9,Exit After X Bars,,None,None,None,None
1850_240906004_B,185,XAUUSD,Buy,2023-05-02 16:00:00,2023-05-02 20:00:00,2005.84,2015.04,1,920,86570.9,Exit After X Bars,,None,None,None,None
1853_240906004_B,185,XAUUSD,Buy,2023-05-09 12:00:00,2023-05-09 16:00:00,2029.32,2026.93,1,-239,86331.9,Exit After X Bars,,None,None,None,None
1860_240906004_B,185,XAUUSD,Buy,2023-05-19 16:00:00,2023-05-19 20:00:00,1978.81,1978.26,1,-55,86276.9,Exit After X Bars,,None,None,None,None
1861_240906004_B,185,XAUUSD,Buy,2023-05-24 12:00:00,2023-05-24 16:00:00,1982.48,1979.84,1,-264,86012.9,Exit After X Bars,,None,None,None,None
1864_240906004_B,185,XAUUSD,Buy,2023-05-30 12:00:00,2023-05-30 16:00:00,1954.07,1956.33,1,226,86238.9,Exit After X Bars,,None,None,None,None
1865_240906004_B,185,XAUUSD,Buy,2023-06-01 16:00:00,2023-06-01 20:00:00,1974.61,1978.31,1,370,86608.9,Exit After X Bars,,None,None,None,None
1868_240906004_B,185,XAUUSD,Buy,2023-06-06 12:00:00,2023-06-06 16:00:00,1963.94,1961.75,1,-219,86389.9,Exit After X Bars,,None,None,None,None
1870_240906004_B,185,XAUUSD,Buy,2023-06-08 16:00:00,2023-06-08 20:00:00,1970.07,1966.18,1,-389,86000.9,Exit After X Bars,,None,None,None,None
1874_240906004_B,185,XAUUSD,Buy,2023-06-16 04:00:00,2023-06-16 08:00:00,1960.2,1955.39,1,-481,85519.9,Exit After X Bars,,None,None,None,None
1879_240906004_B,185,XAUUSD,Buy,2023-06-23 16:00:00,2023-06-23 20:00:00,1930.86,1918.59,1,-1227,84292.9,Exit After X Bars,,None,None,None,None
1883_240906004_B,185,XAUUSD,Buy,2023-06-30 12:00:00,2023-06-30 16:00:00,1912.98,1910.94,1,-204,84088.9,Exit After X Bars,,None,None,None,None
1886_240906004_B,185,XAUUSD,Buy,2023-07-07 12:00:00,2023-07-07 16:00:00,1927.5,1918.66,1,-884,83204.9,Exit After X Bars,,None,None,None,None
1887_240906004_B,185,XAUUSD,Buy,2023-07-11 08:00:00,2023-07-11 12:00:00,1934.74,1936.49,1,175,83379.9,Exit After X Bars,,None,None,None,None
1888_240906004_B,185,XAUUSD,Buy,2023-07-18 08:00:00,2023-07-18 12:00:00,1962.57,1961.65,1,-92,83287.9,Exit After X Bars,,None,None,None,None
1892_240906004_B,185,XAUUSD,Buy,2023-07-26 08:00:00,2023-07-26 12:00:00,1967.71,1972.0,1,429,83716.9,Exit After X Bars,,None,None,None,None
1895_240906004_B,185,XAUUSD,Buy,2023-07-31 12:00:00,2023-07-31 16:00:00,1963.37,1965.36,1,199,83915.9,Exit After X Bars,,None,None,None,None
1899_240906004_B,185,XAUUSD,Buy,2023-08-04 12:00:00,2023-08-04 16:00:00,1938.64,1938.92,1,28,83943.9,Exit After X Bars,,None,None,None,None
1903_240906004_B,185,XAUUSD,Buy,2023-08-10 12:00:00,2023-08-10 16:00:00,1928.23,1926.09,1,-214,83729.9,Exit After X Bars,,None,None,None,None
1910_240906004_B,185,XAUUSD,Buy,2023-08-21 12:00:00,2023-08-21 16:00:00,1896.66,1897.12,1,46,83775.9,Exit After X Bars,,None,None,None,None
1912_240906004_B,185,XAUUSD,Buy,2023-08-28 16:00:00,2023-08-28 20:00:00,1922.26,1920.52,1,-174,83601.9,Exit After X Bars,,None,None,None,None
1918_240906004_B,185,XAUUSD,Buy,2023-09-08 16:00:00,2023-09-08 20:00:00,1924.38,1919.53,1,-485,83116.9,Exit After X Bars,,None,None,None,None
1921_240906004_B,185,XAUUSD,Buy,2023-09-15 04:00:00,2023-09-15 08:00:00,1915.64,1916.0,1,36,83152.9,Exit After X Bars,,None,None,None,None
1922_240906004_B,185,XAUUSD,Buy,2023-09-20 16:00:00,2023-09-20 20:00:00,1937.27,1946.6,1,933,84085.9,Exit After X Bars,,None,None,None,None
1924_240906004_B,185,XAUUSD,Buy,2023-09-22 16:00:00,2023-09-22 20:00:00,1926.0,1925.23,1,-77,84008.9,Exit After X Bars,,None,None,None,None
1929_240906004_B,185,XAUUSD,Buy,2023-09-29 16:00:00,2023-09-29 20:00:00,1879.47,1853.54,1,-2593,81415.9,Exit After X Bars,,None,None,None,None
1934_240906004_B,185,XAUUSD,Buy,2023-10-06 16:00:00,2023-10-06 20:00:00,1823.81,1829.1,1,529,81944.9,Exit After X Bars,,None,None,None,None
1936_240906004_B,185,XAUUSD,Buy,2023-10-25 16:00:00,2023-10-25 20:00:00,1977.44,1978.15,1,71,82015.9,Exit After X Bars,,None,None,None,None
1939_240906004_B,185,XAUUSD,Buy,2023-11-03 12:00:00,2023-11-03 16:00:00,1991.88,2000.05,1,817,82832.9,Exit After X Bars,,None,None,None,None
1946_240906004_B,185,XAUUSD,Buy,2023-11-14 12:00:00,2023-11-14 16:00:00,1949.1,1954.21,1,511,83343.9,Exit After X Bars,,None,None,None,None
1947_240906004_B,185,XAUUSD,Buy,2023-11-21 04:00:00,2023-11-21 08:00:00,1993.32,1991.69,1,-163,83180.9,Exit After X Bars,,None,None,None,None
1948_240906004_B,185,XAUUSD,Buy,2023-11-24 16:00:00,2023-11-27 00:00:00,2003.25,2001.0,1,-225,82955.9,End Of Friday,,None,None,None,None
1949_240906004_B,185,XAUUSD,Buy,2023-12-01 08:00:00,2023-12-01 12:00:00,2049.42,2046.33,1,-309,82646.9,Exit After X Bars,,None,None,None,None
1952_240906004_B,185,XAUUSD,Buy,2023-12-06 12:00:00,2023-12-06 16:00:00,2030.75,2030.17,1,-58,82588.9,Exit After X Bars,,None,None,None,None
1956_240906004_B,185,XAUUSD,Buy,2023-12-13 20:00:00,2023-12-14 00:00:00,1996.6,2025.95,1,2935,85523.9,Exit After X Bars,,None,None,None,None
1958_240906004_B,185,XAUUSD,Buy,2023-12-19 16:00:00,2023-12-19 20:00:00,2033.59,2040.32,1,673,86196.9,Exit After X Bars,,None,None,None,None
1960_240906004_B,185,XAUUSD,Buy,2024-01-02 16:00:00,2024-01-02 20:00:00,2068.75,2062.65,1,-610,85586.9,Exit After X Bars,,None,None,None,None
1963_240906004_B,185,XAUUSD,Buy,2024-01-05 16:00:00,2024-01-05 20:00:00,2050.75,2041.84,1,-891,84695.9,Exit After X Bars,,None,None,None,None
1965_240906004_B,185,XAUUSD,Buy,2024-01-09 12:00:00,2024-01-09 16:00:00,2036.76,2038.49,1,173,84868.9,Exit After X Bars,,None,None,None,None
1966_240906004_B,185,XAUUSD,Buy,2024-01-11 12:00:00,2024-01-11 16:00:00,2041.88,2029.37,1,-1251,83617.9,Exit After X Bars,,None,None,None,None
1969_240906004_B,185,XAUUSD,Buy,2024-01-19 08:00:00,2024-01-19 12:00:00,2028.89,2029.64,1,75,83692.9,Exit After X Bars,,None,None,None,None
1976_240906004_B,185,XAUUSD,Buy,2024-02-06 12:00:00,2024-02-06 16:00:00,2028.5,2029.07,1,57,83749.9,Exit After X Bars,,None,None,None,None
1983_240906004_B,185,XAUUSD,Buy,2024-02-23 16:00:00,2024-02-23 20:00:00,2031.13,2037.91,1,678,84427.9,Exit After X Bars,,None,None,None,None
1984_240906004_B,185,XAUUSD,Buy,2024-02-29 12:00:00,2024-02-29 16:00:00,2038.97,2047.56,1,859,85286.9,Exit After X Bars,,None,None,None,None
1991_240906004_B,185,XAUUSD,Buy,2024-03-20 16:00:00,2024-03-20 20:00:00,2159.55,2157.61,1,-194,85092.9,Exit After X Bars,,None,None,None,None
1993_240906004_B,185,XAUUSD,Buy,2024-03-25 16:00:00,2024-03-25 20:00:00,2180.02,2175.72,1,-430,84662.9,Exit After X Bars,,None,None,None,None
1995_240906004_B,185,XAUUSD,Buy,2024-04-11 20:00:00,2024-04-12 00:00:00,2354.69,2371.5,1,1681,86343.9,Exit After X Bars,,None,None,None,None
1999_240906004_B,185,XAUUSD,Buy,2024-04-24 16:00:00,2024-04-24 20:00:00,2332.03,2324.97,1,-706,85637.9,Exit After X Bars,,None,None,None,None
2001_240906004_B,185,XAUUSD,Buy,2024-05-01 20:00:00,2024-05-02 00:00:00,2317.87,2319.3,1,143,85780.9,Exit After X Bars,,None,None,None,None
2005_240906004_B,185,XAUUSD,Buy,2024-05-09 12:00:00,2024-05-09 16:00:00,2320.93,2326.59,1,566,86346.9,Exit After X Bars,,None,None,None,None
2007_240906004_B,185,XAUUSD,Buy,2024-05-14 12:00:00,2024-05-14 16:00:00,2349.66,2348.16,1,-150,86196.9,Exit After X Bars,,None,None,None,None
2011_240906004_B,185,XAUUSD,Buy,2024-05-27 12:00:00,2024-05-27 16:00:00,2347.3,2347.06,1,-24,86172.9,Exit After X Bars,,None,None,None,None
2013_240906004_B,185,XAUUSD,Buy,2024-05-30 16:00:00,2024-05-30 20:00:00,2347.09,2347.76,1,67,86239.9,Exit After X Bars,,None,None,None,None
2014_240906004_B,185,XAUUSD,Buy,2024-05-31 12:00:00,2024-05-31 16:00:00,2351.67,2354.55,1,288,86527.9,Exit After X Bars,,None,None,None,None
2017_240906004_B,185,XAUUSD,Buy,2024-06-05 12:00:00,2024-06-05 16:00:00,2337.9,2342.02,1,412,86939.9,Exit After X Bars,,None,None,None,None
2020_240906004_B,185,XAUUSD,Buy,2024-06-11 12:00:00,2024-06-11 16:00:00,2313.64,2317.84,1,420,87359.9,Exit After X Bars,,None,None,None,None
2022_240906004_B,185,XAUUSD,Buy,2024-06-18 16:00:00,2024-06-18 20:00:00,2327.48,2330.19,1,271,87630.9,Exit After X Bars,,None,None,None,None
2025_240906004_B,185,XAUUSD,Buy,2024-06-25 12:00:00,2024-06-25 16:00:00,2334.58,2324.05,1,-1053,86577.9,Exit After X Bars,,None,None,None,None
2027_240906004_B,185,XAUUSD,Buy,2024-06-27 12:00:00,2024-06-27 16:00:00,2318.27,2322.74,1,447,87024.9,Exit After X Bars,,None,None,None,None
2028_240906004_B,185,XAUUSD,Buy,2024-07-03 08:00:00,2024-07-03 12:00:00,2338.38,2344.55,1,617,87641.9,Exit After X Bars,,None,None,None,None
2030_240906004_B,185,XAUUSD,Buy,2024-07-10 12:00:00,2024-07-10 16:00:00,2379.39,2377.69,1,-170,87471.9,Exit After X Bars,,None,None,None,None
2034_240906004_B,185,XAUUSD,Buy,2024-07-23 12:00:00,2024-07-23 16:00:00,2408.24,2405.27,1,-297,87174.9,Exit After X Bars,,None,None,None,None
2036_240906004_B,185,XAUUSD,Buy,2024-07-26 16:00:00,2024-07-26 20:00:00,2382.46,2389.07,1,661,87835.9,Exit After X Bars,,None,None,None,None
2040_240906004_B,185,XAUUSD,Buy,2024-08-08 16:00:00,2024-08-08 20:00:00,2416.18,2417.99,1,181,88016.9,Exit After X Bars,,None,None,None,None
2042_240906004_B,185,XAUUSD,Buy,2024-08-16 12:00:00,2024-08-16 16:00:00,2479.7,2491.56,1,1186,89202.9,Exit After X Bars,,None,None,None,None
2044_240906004_B,185,XAUUSD,Buy,2024-08-23 16:00:00,2024-08-23 20:00:00,2508.98,2510.2,1,122,89324.9,Exit After X Bars,,None,None,None,None
2046_240906004_B,185,XAUUSD,Buy,2024-08-29 16:00:00,2024-08-29 20:00:00,2515.14,2525.14,1,1000,90324.9,Exit After X Bars,,None,None,None,None
