orderId,strategyRunId,symbol,orderType,openTime,closeTime,openPrice,closePrice,size,profit,balance,closeType,comment,sl,tp,swap,commission
12_240906001_B,182,XAUUSD,Buy,2011-02-03 16:00:00,2011-02-03 20:00:00,1343.78,1353.88,1,1010,11010,Exit After X Bars,,None,None,None,None
13_240906001_B,182,XAUUSD,Buy,2011-02-11 12:00:00,2011-02-11 16:00:00,1367.57,1365.53,1,-204,10806,Exit After X Bars,,None,None,None,None
14_240906001_B,182,XAUUSD,Buy,2011-02-15 08:00:00,2011-02-15 12:00:00,1369.11,1371.67,1,256,11062,Exit After X Bars,,None,None,None,None
16_240906001_B,182,XAUUSD,Buy,2011-02-23 16:00:00,2011-02-23 20:00:00,1408.13,1415.25,1,712,11774,Exit After X Bars,,None,None,None,None
19_240906001_B,182,XAUUSD,Buy,2011-02-28 12:00:00,2011-02-28 16:00:00,1413.04,1411.62,1,-142,11632,Exit After X Bars,,None,None,None,None
20_240906001_B,182,XAUUSD,Buy,2011-03-01 12:00:00,2011-03-01 16:00:00,1417.09,1419.47,1,238,11870,Exit After X Bars,,None,None,None,None
29_240906001_B,182,XAUUSD,Buy,2011-03-18 00:00:00,2011-03-18 04:00:00,1408.86,1406.99,1,-187,11683,Exit After X Bars,,None,None,None,None
33_240906001_B,182,XAUUSD,Buy,2011-03-30 12:00:00,2011-03-30 16:00:00,1423.85,1428.01,1,416,12099,Exit After X Bars,,None,None,None,None
36_240906001_B,182,XAUUSD,Buy,2011-04-14 16:00:00,2011-04-14 20:00:00,1462.73,1471.83,1,910,13009,Exit After X Bars,,None,None,None,None
37_240906001_B,182,XAUUSD,Buy,2011-04-19 16:00:00,2011-04-19 20:00:00,1498.91,1496.49,1,-242,12767,Exit After X Bars,,None,None,None,None
40_240906001_B,182,XAUUSD,Buy,2011-04-27 16:00:00,2011-04-27 20:00:00,1510.9,1512.16,1,126,12893,Exit After X Bars,,None,None,None,None
49_240906001_B,182,XAUUSD,Buy,2011-05-18 16:00:00,2011-05-18 20:00:00,1498.36,1495.8,1,-256,12637,Exit After X Bars,,None,None,None,None
50_240906001_B,182,XAUUSD,Buy,2011-05-20 08:00:00,2011-05-20 12:00:00,1501.46,1502.02,1,56,12693,Exit After X Bars,,None,None,None,None
52_240906001_B,182,XAUUSD,Buy,2011-05-27 16:00:00,2011-05-27 20:00:00,1532.3,1537.36,1,506,13199,Exit After X Bars,,None,None,None,None
54_240906001_B,182,XAUUSD,Buy,2011-06-01 16:00:00,2011-06-01 20:00:00,1541.36,1545.4,1,404,13603,Exit After X Bars,,None,None,None,None
56_240906001_B,182,XAUUSD,Buy,2011-06-03 16:00:00,2011-06-03 20:00:00,1544.85,1541.86,1,-299,13304,Exit After X Bars,,None,None,None,None
59_240906001_B,182,XAUUSD,Buy,2011-06-09 16:00:00,2011-06-09 20:00:00,1543.77,1544.6,1,83,13387,Exit After X Bars,,None,None,None,None
62_240906001_B,182,XAUUSD,Buy,2011-06-15 16:00:00,2011-06-15 20:00:00,1533.73,1524.58,1,-915,12472,Exit After X Bars,,None,None,None,None
66_240906001_B,182,XAUUSD,Buy,2011-06-29 08:00:00,2011-06-29 12:00:00,1506.47,1508.24,1,177,12649,Exit After X Bars,,None,None,None,None
68_240906001_B,182,XAUUSD,Buy,2011-07-05 12:00:00,2011-07-05 16:00:00,1503.22,1508.19,1,497,13146,Exit After X Bars,,None,None,None,None
69_240906001_B,182,XAUUSD,Buy,2011-07-12 20:00:00,2011-07-13 00:00:00,1558.73,1567.58,1,885,14031,Exit After X Bars,,None,None,None,None
73_240906001_B,182,XAUUSD,Buy,2011-07-22 16:00:00,2011-07-22 20:00:00,1605.37,1600.72,1,-465,13566,Exit After X Bars,,None,None,None,None
74_240906001_B,182,XAUUSD,Buy,2011-07-27 00:00:00,2011-07-27 04:00:00,1622.21,1622.23,1,2,13568,Exit After X Bars,,None,None,None,None
76_240906001_B,182,XAUUSD,Buy,2011-07-29 12:00:00,2011-07-29 16:00:00,1620.74,1623.19,1,245,13813,Exit After X Bars,,None,None,None,None
78_240906001_B,182,XAUUSD,Buy,2011-08-02 12:00:00,2011-08-02 16:00:00,1632.63,1637.39,1,476,14289,Exit After X Bars,,None,None,None,None
81_240906001_B,182,XAUUSD,Buy,2011-08-16 08:00:00,2011-08-16 12:00:00,1771.47,1778.08,1,661,14950,Exit After X Bars,,None,None,None,None
82_240906001_B,182,XAUUSD,Buy,2011-08-18 12:00:00,2011-08-18 16:00:00,1796.09,1816.92,1,2083,17033,Exit After X Bars,,None,None,None,None
86_240906001_B,182,XAUUSD,Buy,2011-08-26 16:00:00,2011-08-26 20:00:00,1779.56,1786.25,1,669,17702,Exit After X Bars,,None,None,None,None
87_240906001_B,182,XAUUSD,Buy,2011-08-30 12:00:00,2011-08-30 16:00:00,1827.31,1825.21,1,-210,17492,Exit After X Bars,,None,None,None,None
88_240906001_B,182,XAUUSD,Buy,2011-09-02 08:00:00,2011-09-02 12:00:00,1842.25,1849.95,1,770,18262,Exit After X Bars,,None,None,None,None
91_240906001_B,182,XAUUSD,Buy,2011-09-09 08:00:00,2011-09-09 12:00:00,1883.93,1883.07,1,-86,18176,Exit After X Bars,,None,None,None,None
103_240906001_B,182,XAUUSD,Buy,2011-10-12 12:00:00,2011-10-12 16:00:00,1688.06,1685.84,1,-222,17954,Exit After X Bars,,None,None,None,None
109_240906001_B,182,XAUUSD,Buy,2011-10-21 12:00:00,2011-10-21 16:00:00,1633.89,1642.71,1,882,18836,Exit After X Bars,,None,None,None,None
114_240906001_B,182,XAUUSD,Buy,2011-11-11 16:00:00,2011-11-11 20:00:00,1778.89,1786.78,1,789,19625,Exit After X Bars,,None,None,None,None
125_240906001_B,182,XAUUSD,Buy,2011-12-07 12:00:00,2011-12-07 16:00:00,1734.0,1733.37,1,-63,19562,Exit After X Bars,,None,None,None,None
131_240906001_B,182,XAUUSD,Buy,2011-12-16 12:00:00,2011-12-16 16:00:00,1596.75,1592.17,1,-458,19104,Exit After X Bars,,None,None,None,None
136_240906001_B,182,XAUUSD,Buy,2012-01-10 12:00:00,2012-01-10 16:00:00,1625.72,1636.35,1,1063,20167,Exit After X Bars,,None,None,None,None
138_240906001_B,182,XAUUSD,Buy,2012-01-17 00:00:00,2012-01-17 04:00:00,1650.21,1652.94,1,273,20440,Exit After X Bars,,None,None,None,None
142_240906001_B,182,XAUUSD,Buy,2012-01-25 16:00:00,2012-01-25 20:00:00,1678.61,1689.7,1,1109,21549,Exit After X Bars,,None,None,None,None
143_240906001_B,182,XAUUSD,Buy,2012-01-31 08:00:00,2012-01-31 12:00:00,1742.47,1742.51,1,4,21553,Exit After X Bars,,None,None,None,None
144_240906001_B,182,XAUUSD,Buy,2012-02-01 12:00:00,2012-02-01 16:00:00,1748.73,1744.87,1,-386,21167,Exit After X Bars,,None,None,None,None
145_240906001_B,182,XAUUSD,Buy,2012-02-02 16:00:00,2012-02-02 20:00:00,1753.21,1755.07,1,186,21353,Exit After X Bars,,None,None,None,None
147_240906001_B,182,XAUUSD,Buy,2012-02-07 16:00:00,2012-02-07 20:00:00,1739.33,1746.27,1,694,22047,Exit After X Bars,,None,None,None,None
151_240906001_B,182,XAUUSD,Buy,2012-02-15 16:00:00,2012-02-15 20:00:00,1734.32,1727.41,1,-691,21356,Exit After X Bars,,None,None,None,None
154_240906001_B,182,XAUUSD,Buy,2012-02-28 12:00:00,2012-02-28 16:00:00,1780.06,1780.06,1,0,21356,Exit After X Bars,,None,None,None,None
159_240906001_B,182,XAUUSD,Buy,2012-03-09 16:00:00,2012-03-09 20:00:00,1707.04,1711.65,1,461,21817,Exit After X Bars,,None,None,None,None
164_240906001_B,182,XAUUSD,Buy,2012-03-23 16:00:00,2012-03-23 20:00:00,1663.68,1662.57,1,-111,21706,Exit After X Bars,,None,None,None,None
167_240906001_B,182,XAUUSD,Buy,2012-03-30 12:00:00,2012-03-30 16:00:00,1664.54,1665.58,1,104,21810,Exit After X Bars,,None,None,None,None
170_240906001_B,182,XAUUSD,Buy,2012-04-06 12:00:00,2012-04-06 16:00:00,1634.2,1641.71,1,751,22561,Exit After X Bars,,None,None,None,None
176_240906001_B,182,XAUUSD,Buy,2012-04-24 16:00:00,2012-04-24 20:00:00,1647.54,1641.28,1,-626,21935,Exit After X Bars,,None,None,None,None
188_240906001_B,182,XAUUSD,Buy,2012-05-17 16:00:00,2012-05-17 20:00:00,1565.44,1576.13,1,1069,23004,Exit After X Bars,,None,None,None,None
191_240906001_B,182,XAUUSD,Buy,2012-05-24 12:00:00,2012-05-24 16:00:00,1565.65,1575.66,1,1001,24005,Exit After X Bars,,None,None,None,None
194_240906001_B,182,XAUUSD,Buy,2012-06-01 12:00:00,2012-06-01 16:00:00,1574.87,1581.44,1,657,24662,Exit After X Bars,,None,None,None,None
197_240906001_B,182,XAUUSD,Buy,2012-06-11 20:00:00,2012-06-12 00:00:00,1596.83,1596.16,1,-67,24595,Exit After X Bars,,None,None,None,None
198_240906001_B,182,XAUUSD,Buy,2012-06-12 16:00:00,2012-06-12 20:00:00,1605.75,1611.94,1,619,25214,Exit After X Bars,,None,None,None,None
203_240906001_B,182,XAUUSD,Buy,2012-06-25 16:00:00,2012-06-25 20:00:00,1575.18,1583.29,1,811,26025,Exit After X Bars,,None,None,None,None
206_240906001_B,182,XAUUSD,Buy,2012-06-29 12:00:00,2012-06-29 16:00:00,1579.72,1597.36,1,1764,27789,Exit After X Bars,,None,None,None,None
209_240906001_B,182,XAUUSD,Buy,2012-07-10 12:00:00,2012-07-10 16:00:00,1593.6,1600.83,1,723,28512,Exit After X Bars,,None,None,None,None
212_240906001_B,182,XAUUSD,Buy,2012-07-13 12:00:00,2012-07-13 16:00:00,1578.47,1582.39,1,392,28904,Exit After X Bars,,None,None,None,None
214_240906001_B,182,XAUUSD,Buy,2012-07-19 12:00:00,2012-07-19 16:00:00,1586.9,1584.15,1,-275,28629,Exit After X Bars,,None,None,None,None
216_240906001_B,182,XAUUSD,Buy,2012-07-24 16:00:00,2012-07-24 20:00:00,1582.09,1575.79,1,-630,27999,Exit After X Bars,,None,None,None,None
221_240906001_B,182,XAUUSD,Buy,2012-08-10 16:00:00,2012-08-10 20:00:00,1619.23,1621.52,1,229,28228,Exit After X Bars,,None,None,None,None
224_240906001_B,182,XAUUSD,Buy,2012-08-16 12:00:00,2012-08-16 16:00:00,1607.39,1607.65,1,26,28254,Exit After X Bars,,None,None,None,None
229_240906001_B,182,XAUUSD,Buy,2012-08-31 16:00:00,2012-08-31 20:00:00,1664.71,1681.56,1,1685,29939,Exit After X Bars,,None,None,None,None
230_240906001_B,182,XAUUSD,Buy,2012-09-06 08:00:00,2012-09-06 12:00:00,1700.05,1709.11,1,906,30845,Exit After X Bars,,None,None,None,None
231_240906001_B,182,XAUUSD,Buy,2012-09-07 12:00:00,2012-09-07 16:00:00,1715.13,1724.79,1,966,31811,Exit After X Bars,,None,None,None,None
232_240906001_B,182,XAUUSD,Buy,2012-09-12 08:00:00,2012-09-12 12:00:00,1741.0,1742.76,1,176,31987,Exit After X Bars,,None,None,None,None
233_240906001_B,182,XAUUSD,Buy,2012-09-13 16:00:00,2012-09-13 20:00:00,1747.71,1752.67,1,496,32483,Exit After X Bars,,None,None,None,None
235_240906001_B,182,XAUUSD,Buy,2012-09-19 08:00:00,2012-09-19 12:00:00,1778.02,1774.05,1,-397,32086,Exit After X Bars,,None,None,None,None
236_240906001_B,182,XAUUSD,Buy,2012-09-21 12:00:00,2012-09-21 16:00:00,1780.06,1786.55,1,649,32735,Exit After X Bars,,None,None,None,None
238_240906001_B,182,XAUUSD,Buy,2012-09-25 12:00:00,2012-09-25 16:00:00,1768.24,1771.76,1,352,33087,Exit After X Bars,,None,None,None,None
240_240906001_B,182,XAUUSD,Buy,2012-09-27 12:00:00,2012-09-27 16:00:00,1766.48,1764.21,1,-227,32860,Exit After X Bars,,None,None,None,None
241_240906001_B,182,XAUUSD,Buy,2012-10-01 12:00:00,2012-10-01 16:00:00,1784.65,1784.74,1,9,32869,Exit After X Bars,,None,None,None,None
242_240906001_B,182,XAUUSD,Buy,2012-10-04 08:00:00,2012-10-04 12:00:00,1784.83,1785.03,1,20,32889,Exit After X Bars,,None,None,None,None
246_240906001_B,182,XAUUSD,Buy,2012-10-11 12:00:00,2012-10-11 16:00:00,1768.97,1767.0,1,-197,32692,Exit After X Bars,,None,None,None,None
248_240906001_B,182,XAUUSD,Buy,2012-10-17 00:00:00,2012-10-17 04:00:00,1749.76,1750.45,1,69,32761,Exit After X Bars,,None,None,None,None
261_240906001_B,182,XAUUSD,Buy,2012-11-23 08:00:00,2012-11-23 12:00:00,1733.12,1734.0,1,88,32849,Exit After X Bars,,None,None,None,None
264_240906001_B,182,XAUUSD,Buy,2012-11-30 12:00:00,2012-11-30 16:00:00,1729.14,1723.27,1,-587,32262,Exit After X Bars,,None,None,None,None
271_240906001_B,182,XAUUSD,Buy,2012-12-18 04:00:00,2012-12-18 08:00:00,1702.65,1702.44,1,-21,32241,Exit After X Bars,,None,None,None,None
277_240906001_B,182,XAUUSD,Buy,2013-01-09 08:00:00,2013-01-09 12:00:00,1663.76,1662.59,1,-117,32124,Exit After X Bars,,None,None,None,None
278_240906001_B,182,XAUUSD,Buy,2013-01-10 12:00:00,2013-01-10 16:00:00,1666.8,1669.25,1,245,32369,Exit After X Bars,,None,None,None,None
279_240906001_B,182,XAUUSD,Buy,2013-01-15 08:00:00,2013-01-15 12:00:00,1678.16,1681.15,1,299,32668,Exit After X Bars,,None,None,None,None
284_240906001_B,182,XAUUSD,Buy,2013-01-29 12:00:00,2013-01-29 16:00:00,1663.36,1663.16,1,-20,32648,Exit After X Bars,,None,None,None,None
285_240906001_B,182,XAUUSD,Buy,2013-02-01 16:00:00,2013-02-01 20:00:00,1681.59,1671.47,1,-1012,31636,Exit After X Bars,,None,None,None,None
286_240906001_B,182,XAUUSD,Buy,2013-02-05 12:00:00,2013-02-05 16:00:00,1683.71,1682.95,1,-76,31560,Exit After X Bars,,None,None,None,None
304_240906001_B,182,XAUUSD,Buy,2013-03-21 12:00:00,2013-03-21 16:00:00,1615.36,1615.14,1,-22,31538,Exit After X Bars,,None,None,None,None
307_240906001_B,182,XAUUSD,Buy,2013-03-27 16:00:00,2013-03-27 20:00:00,1605.21,1605.55,1,34,31572,Exit After X Bars,,None,None,None,None
311_240906001_B,182,XAUUSD,Buy,2013-04-05 12:00:00,2013-04-05 16:00:00,1557.66,1568.42,1,1076,32648,Exit After X Bars,,None,None,None,None
316_240906001_B,182,XAUUSD,Buy,2013-04-18 12:00:00,2013-04-18 16:00:00,1398.68,1394.75,1,-393,32255,Exit After X Bars,,None,None,None,None
319_240906001_B,182,XAUUSD,Buy,2013-05-03 08:00:00,2013-05-03 12:00:00,1477.95,1476.7,1,-125,32130,Exit After X Bars,,None,None,None,None
322_240906001_B,182,XAUUSD,Buy,2013-05-08 20:00:00,2013-05-09 00:00:00,1470.62,1473.79,1,317,32447,Exit After X Bars,,None,None,None,None
329_240906001_B,182,XAUUSD,Buy,2013-05-20 20:00:00,2013-05-21 00:00:00,1398.23,1393.85,1,-438,32009,Exit After X Bars,,None,None,None,None
331_240906001_B,182,XAUUSD,Buy,2013-05-30 08:00:00,2013-05-30 12:00:00,1399.54,1406.81,1,727,32736,Exit After X Bars,,None,None,None,None
335_240906001_B,182,XAUUSD,Buy,2013-06-06 16:00:00,2013-06-06 20:00:00,1411.44,1416.45,1,501,33237,Exit After X Bars,,None,None,None,None
338_240906001_B,182,XAUUSD,Buy,2013-06-12 16:00:00,2013-06-12 20:00:00,1387.55,1390.86,1,331,33568,Exit After X Bars,,None,None,None,None
348_240906001_B,182,XAUUSD,Buy,2013-07-09 04:00:00,2013-07-09 08:00:00,1251.05,1254.4,1,335,33903,Exit After X Bars,,None,None,None,None
350_240906001_B,182,XAUUSD,Buy,2013-07-16 16:00:00,2013-07-16 20:00:00,1295.05,1291.46,1,-359,33544,Exit After X Bars,,None,None,None,None
353_240906001_B,182,XAUUSD,Buy,2013-07-19 12:00:00,2013-07-19 16:00:00,1289.1,1291.65,1,255,33799,Exit After X Bars,,None,None,None,None
362_240906001_B,182,XAUUSD,Buy,2013-08-08 16:00:00,2013-08-08 20:00:00,1308.04,1310.27,1,223,34022,Exit After X Bars,,None,None,None,None
363_240906001_B,182,XAUUSD,Buy,2013-08-15 00:00:00,2013-08-15 04:00:00,1342.27,1341.41,1,-86,33936,Exit After X Bars,,None,None,None,None
365_240906001_B,182,XAUUSD,Buy,2013-08-21 20:00:00,2013-08-22 00:00:00,1378.54,1366.09,1,-1245,32691,Exit After X Bars,,None,None,None,None
366_240906001_B,182,XAUUSD,Buy,2013-08-22 16:00:00,2013-08-22 20:00:00,1381.5,1371.75,1,-975,31716,Exit After X Bars,,None,None,None,None
370_240906001_B,182,XAUUSD,Buy,2013-09-03 12:00:00,2013-09-03 16:00:00,1399.27,1398.01,1,-126,31590,Exit After X Bars,,None,None,None,None
378_240906001_B,182,XAUUSD,Buy,2013-09-18 20:00:00,2013-09-19 00:00:00,1327.58,1362.63,1,3505,35095,Exit After X Bars,,None,None,None,None
380_240906001_B,182,XAUUSD,Buy,2013-09-25 16:00:00,2013-09-25 20:00:00,1333.21,1337.14,1,393,35488,Exit After X Bars,,None,None,None,None
381_240906001_B,182,XAUUSD,Buy,2013-09-27 12:00:00,2013-09-27 16:00:00,1340.29,1335.57,1,-472,35016,Exit After X Bars,,None,None,None,None
388_240906001_B,182,XAUUSD,Buy,2013-10-17 08:00:00,2013-10-17 12:00:00,1291.48,1305.41,1,1393,36409,Exit After X Bars,,None,None,None,None
395_240906001_B,182,XAUUSD,Buy,2013-11-06 12:00:00,2013-11-06 16:00:00,1320.57,1316.76,1,-381,36028,Exit After X Bars,,None,None,None,None
399_240906001_B,182,XAUUSD,Buy,2013-11-14 00:00:00,2013-11-14 04:00:00,1286.39,1282.24,1,-415,35613,Exit After X Bars,,None,None,None,None
404_240906001_B,182,XAUUSD,Buy,2013-11-25 20:00:00,2013-11-26 00:00:00,1250.34,1251.21,1,87,35700,Exit After X Bars,,None,None,None,None
407_240906001_B,182,XAUUSD,Buy,2013-12-04 12:00:00,2013-12-04 16:00:00,1226.92,1225.9,1,-102,35598,Exit After X Bars,,None,None,None,None
410_240906001_B,182,XAUUSD,Buy,2013-12-16 16:00:00,2013-12-16 20:00:00,1239.32,1246.12,1,680,36278,Exit After X Bars,,None,None,None,None
416_240906001_B,182,XAUUSD,Buy,2013-12-26 04:00:00,2013-12-26 08:00:00,1206.66,1204.19,1,-247,36031,Exit After X Bars,,None,None,None,None
418_240906001_B,182,XAUUSD,Buy,2013-12-31 16:00:00,2013-12-31 20:00:00,1212.01,1204.8,1,-721,35310,Exit After X Bars,,None,None,None,None
420_240906001_B,182,XAUUSD,Buy,2014-01-10 04:00:00,2014-01-10 08:00:00,1232.6,1236.55,1,395,35705,Exit After X Bars,,None,None,None,None
422_240906001_B,182,XAUUSD,Buy,2014-01-16 16:00:00,2014-01-16 20:00:00,1243.15,1241.14,1,-201,35504,Exit After X Bars,,None,None,None,None
423_240906001_B,182,XAUUSD,Buy,2014-01-17 12:00:00,2014-01-17 16:00:00,1245.69,1248.12,1,243,35747,Exit After X Bars,,None,None,None,None
427_240906001_B,182,XAUUSD,Buy,2014-01-29 12:00:00,2014-01-29 16:00:00,1263.06,1266.85,1,379,36126,Exit After X Bars,,None,None,None,None
430_240906001_B,182,XAUUSD,Buy,2014-02-03 16:00:00,2014-02-03 20:00:00,1255.63,1259.36,1,373,36499,Exit After X Bars,,None,None,None,None
431_240906001_B,182,XAUUSD,Buy,2014-02-13 16:00:00,2014-02-13 20:00:00,1296.94,1298.57,1,163,36662,Exit After X Bars,,None,None,None,None
434_240906001_B,182,XAUUSD,Buy,2014-02-20 20:00:00,2014-02-21 00:00:00,1323.47,1322.82,1,-65,36597,Exit After X Bars,,None,None,None,None
435_240906001_B,182,XAUUSD,Buy,2014-02-21 20:00:00,2014-02-24 00:00:00,1325.86,1325.35,1,-51,36546,End Of Friday,,None,None,None,None
440_240906001_B,182,XAUUSD,Buy,2014-03-06 16:00:00,2014-03-06 20:00:00,1342.5,1348.87,1,637,37183,Exit After X Bars,,None,None,None,None
450_240906001_B,182,XAUUSD,Buy,2014-04-04 12:00:00,2014-04-04 16:00:00,1298.78,1299.0,1,22,37205,Exit After X Bars,,None,None,None,None
451_240906001_B,182,XAUUSD,Buy,2014-04-14 00:00:00,2014-04-14 04:00:00,1327.49,1325.81,1,-168.2,37036.8,Exit After X Bars,,None,None,None,None
458_240906001_B,182,XAUUSD,Buy,2014-04-24 16:00:00,2014-04-24 20:00:00,1289.35,1289.87,1,52,37088.8,Exit After X Bars,,None,None,None,None
462_240906001_B,182,XAUUSD,Buy,2014-05-02 16:00:00,2014-05-02 20:00:00,1291.68,1298.41,1,673,37761.8,Exit After X Bars,,None,None,None,None
465_240906001_B,182,XAUUSD,Buy,2014-05-12 12:00:00,2014-05-12 16:00:00,1296.75,1300.66,1,391,38152.8,Exit After X Bars,,None,None,None,None
468_240906001_B,182,XAUUSD,Buy,2014-05-22 12:00:00,2014-05-22 16:00:00,1296.71,1300.41,1,370,38522.8,Exit After X Bars,,None,None,None,None
476_240906001_B,182,XAUUSD,Buy,2014-06-05 12:00:00,2014-06-05 16:00:00,1251.53,1254.85,1,332,38854.8,Exit After X Bars,,None,None,None,None
478_240906001_B,182,XAUUSD,Buy,2014-06-18 12:00:00,2014-06-18 16:00:00,1273.65,1271.69,1,-196,38658.8,Exit After X Bars,,None,None,None,None
481_240906001_B,182,XAUUSD,Buy,2014-06-27 16:00:00,2014-06-27 20:00:00,1319.66,1318.3,1,-136,38522.8,Exit After X Bars,,None,None,None,None
482_240906001_B,182,XAUUSD,Buy,2014-06-30 20:00:00,2014-07-01 00:00:00,1322.65,1327.15,1,450,38972.8,Exit After X Bars,,None,None,None,None
487_240906001_B,182,XAUUSD,Buy,2014-07-08 12:00:00,2014-07-08 16:00:00,1320.27,1321.99,1,172,39144.8,Exit After X Bars,,None,None,None,None
488_240906001_B,182,XAUUSD,Buy,2014-07-09 12:00:00,2014-07-09 16:00:00,1325.09,1325.7,1,61,39205.8,Exit After X Bars,,None,None,None,None
492_240906001_B,182,XAUUSD,Buy,2014-07-17 12:00:00,2014-07-17 16:00:00,1304.31,1305.77,1,146,39351.8,Exit After X Bars,,None,None,None,None
496_240906001_B,182,XAUUSD,Buy,2014-07-25 20:00:00,2014-07-28 00:00:00,1305.32,1307.57,1,225,39576.8,End Of Friday,,None,None,None,None
501_240906001_B,182,XAUUSD,Buy,2014-08-12 12:00:00,2014-08-12 16:00:00,1311.68,1314.85,1,317,39893.8,Exit After X Bars,,None,None,None,None
503_240906001_B,182,XAUUSD,Buy,2014-08-14 12:00:00,2014-08-14 16:00:00,1315.3,1314.57,1,-73,39820.8,Exit After X Bars,,None,None,None,None
510_240906001_B,182,XAUUSD,Buy,2014-08-26 04:00:00,2014-08-26 08:00:00,1283.39,1282.24,1,-115,39705.8,Exit After X Bars,,None,None,None,None
513_240906001_B,182,XAUUSD,Buy,2014-09-04 12:00:00,2014-09-04 16:00:00,1271.8,1268.54,1,-326,39379.8,Exit After X Bars,,None,None,None,None
518_240906001_B,182,XAUUSD,Buy,2014-09-16 08:00:00,2014-09-16 12:00:00,1240.7,1239.76,1,-94,39285.8,Exit After X Bars,,None,None,None,None
521_240906001_B,182,XAUUSD,Buy,2014-09-23 12:00:00,2014-09-23 16:00:00,1229.14,1225.72,1,-342,38943.8,Exit After X Bars,,None,None,None,None
522_240906001_B,182,XAUUSD,Buy,2014-09-26 04:00:00,2014-09-26 08:00:00,1226.78,1222.61,1,-417,38526.8,Exit After X Bars,,None,None,None,None
523_240906001_B,182,XAUUSD,Buy,2014-10-02 04:00:00,2014-10-02 08:00:00,1220.69,1219.5,1,-119,38407.8,Exit After X Bars,,None,None,None,None
525_240906001_B,182,XAUUSD,Buy,2014-10-08 08:00:00,2014-10-08 12:00:00,1215.24,1218.23,1,299,38706.8,Exit After X Bars,,None,None,None,None
526_240906001_B,182,XAUUSD,Buy,2014-10-15 16:00:00,2014-10-15 20:00:00,1239.22,1243.93,1,471,39177.8,Exit After X Bars,,None,None,None,None
528_240906001_B,182,XAUUSD,Buy,2014-10-20 12:00:00,2014-10-20 16:00:00,1242.77,1244.79,1,202,39379.8,Exit After X Bars,,None,None,None,None
533_240906001_B,182,XAUUSD,Buy,2014-10-28 12:00:00,2014-10-28 16:00:00,1232.85,1232.63,1,-22,39357.8,Exit After X Bars,,None,None,None,None
538_240906001_B,182,XAUUSD,Buy,2014-11-04 12:00:00,2014-11-04 16:00:00,1174.79,1169.24,1,-555,38802.8,Exit After X Bars,,None,None,None,None
541_240906001_B,182,XAUUSD,Buy,2014-11-07 12:00:00,2014-11-07 16:00:00,1150.26,1148.58,1,-168,38634.8,Exit After X Bars,,None,None,None,None
542_240906001_B,182,XAUUSD,Buy,2014-11-14 16:00:00,2014-11-14 20:00:00,1169.28,1188.32,1,1904,40538.8,Exit After X Bars,,None,None,None,None
543_240906001_B,182,XAUUSD,Buy,2014-11-21 12:00:00,2014-11-21 16:00:00,1203.73,1202.94,1,-79,40459.8,Exit After X Bars,,None,None,None,None
549_240906001_B,182,XAUUSD,Buy,2014-12-01 16:00:00,2014-12-01 20:00:00,1191.67,1215.34,1,2367,42826.8,Exit After X Bars,,None,None,None,None
551_240906001_B,182,XAUUSD,Buy,2014-12-09 12:00:00,2014-12-09 16:00:00,1209.0,1217.28,1,828,43654.8,Exit After X Bars,,None,None,None,None
555_240906001_B,182,XAUUSD,Buy,2014-12-16 12:00:00,2014-12-16 16:00:00,1221.91,1211.4,1,-1051,42603.8,Exit After X Bars,,None,None,None,None
557_240906001_B,182,XAUUSD,Buy,2014-12-18 12:00:00,2014-12-18 16:00:00,1204.11,1202.87,1,-124,42479.8,Exit After X Bars,,None,None,None,None
559_240906001_B,182,XAUUSD,Buy,2014-12-26 04:00:00,2014-12-26 08:00:00,1185.39,1184.79,1,-60,42419.8,Exit After X Bars,,None,None,None,None
562_240906001_B,182,XAUUSD,Buy,2015-01-09 12:00:00,2015-01-09 16:00:00,1217.4,1214.26,1,-314,42105.8,Exit After X Bars,,None,None,None,None
564_240906001_B,182,XAUUSD,Buy,2015-01-15 12:00:00,2015-01-15 16:00:00,1245.36,1254.5,1,914,43019.8,Exit After X Bars,,None,None,None,None
565_240906001_B,182,XAUUSD,Buy,2015-01-22 16:00:00,2015-01-22 20:00:00,1306.12,1300.98,1,-514,42505.8,Exit After X Bars,,None,None,None,None
581_240906001_B,182,XAUUSD,Buy,2015-02-25 08:00:00,2015-02-25 12:00:00,1211.7,1208.09,1,-361,42144.8,Exit After X Bars,,None,None,None,None
589_240906001_B,182,XAUUSD,Buy,2015-03-18 20:00:00,2015-03-19 00:00:00,1160.51,1166.79,1,628,42772.8,Exit After X Bars,,None,None,None,None
593_240906001_B,182,XAUUSD,Buy,2015-04-01 12:00:00,2015-04-01 16:00:00,1191.5,1193.54,1,204,42976.8,Exit After X Bars,,None,None,None,None
597_240906001_B,182,XAUUSD,Buy,2015-04-10 12:00:00,2015-04-10 16:00:00,1203.09,1204.96,1,187,43163.8,Exit After X Bars,,None,None,None,None
600_240906001_B,182,XAUUSD,Buy,2015-04-15 20:00:00,2015-04-16 00:00:00,1201.85,1202.18,1,33,43196.8,Exit After X Bars,,None,None,None,None
604_240906001_B,182,XAUUSD,Buy,2015-04-27 16:00:00,2015-04-27 20:00:00,1196.56,1206.76,1,1020,44216.8,Exit After X Bars,,None,None,None,None
607_240906001_B,182,XAUUSD,Buy,2015-05-04 12:00:00,2015-05-04 16:00:00,1185.66,1186.28,1,62,44278.8,Exit After X Bars,,None,None,None,None
609_240906001_B,182,XAUUSD,Buy,2015-05-08 12:00:00,2015-05-08 16:00:00,1191.48,1189.59,1,-189,44089.8,Exit After X Bars,,None,None,None,None
611_240906001_B,182,XAUUSD,Buy,2015-05-12 12:00:00,2015-05-12 16:00:00,1192.02,1195.14,1,312,44401.8,Exit After X Bars,,None,None,None,None
614_240906001_B,182,XAUUSD,Buy,2015-05-22 08:00:00,2015-05-22 12:00:00,1213.83,1212.43,1,-140,44261.8,Exit After X Bars,,None,None,None,None
619_240906001_B,182,XAUUSD,Buy,2015-05-29 12:00:00,2015-05-29 16:00:00,1192.53,1189.8,1,-273,43988.8,Exit After X Bars,,None,None,None,None
620_240906001_B,182,XAUUSD,Buy,2015-06-02 16:00:00,2015-06-02 20:00:00,1195.15,1193.41,1,-174,43814.8,Exit After X Bars,,None,None,None,None
623_240906001_B,182,XAUUSD,Buy,2015-06-09 08:00:00,2015-06-09 12:00:00,1179.72,1180.13,1,41,43855.8,Exit After X Bars,,None,None,None,None
625_240906001_B,182,XAUUSD,Buy,2015-06-17 20:00:00,2015-06-18 00:00:00,1188.28,1184.86,1,-342,43513.8,Exit After X Bars,,None,None,None,None
630_240906001_B,182,XAUUSD,Buy,2015-06-29 00:00:00,2015-06-29 04:00:00,1184.23,1185.47,1,123.9,43637.7,Exit After X Bars,,None,None,None,None
633_240906001_B,182,XAUUSD,Buy,2015-07-06 00:00:00,2015-07-06 04:00:00,1173.6,1172.01,1,-158.9,43478.8,Exit After X Bars,,None,None,None,None
645_240906001_B,182,XAUUSD,Buy,2015-07-31 16:00:00,2015-07-31 20:00:00,1098.72,1094.21,1,-451,43027.8,Exit After X Bars,,None,None,None,None
648_240906001_B,182,XAUUSD,Buy,2015-08-06 16:00:00,2015-08-06 20:00:00,1092.99,1092.34,1,-65,42962.8,Exit After X Bars,,None,None,None,None
650_240906001_B,182,XAUUSD,Buy,2015-08-17 12:00:00,2015-08-17 16:00:00,1121.39,1120.73,1,-66,42896.8,Exit After X Bars,,None,None,None,None
651_240906001_B,182,XAUUSD,Buy,2015-08-19 08:00:00,2015-08-19 12:00:00,1123.15,1122.46,1,-69,42827.8,Exit After X Bars,,None,None,None,None
656_240906001_B,182,XAUUSD,Buy,2015-08-28 16:00:00,2015-08-28 20:00:00,1129.77,1135.19,1,542,43369.8,Exit After X Bars,,None,None,None,None
657_240906001_B,182,XAUUSD,Buy,2015-09-01 04:00:00,2015-09-01 08:00:00,1141.62,1142.28,1,66,43435.8,Exit After X Bars,,None,None,None,None
662_240906001_B,182,XAUUSD,Buy,2015-09-08 16:00:00,2015-09-08 20:00:00,1125.42,1123.54,1,-188,43247.8,Exit After X Bars,,None,None,None,None
665_240906001_B,182,XAUUSD,Buy,2015-09-16 12:00:00,2015-09-16 16:00:00,1113.52,1114.03,1,51,43298.8,Exit After X Bars,,None,None,None,None
666_240906001_B,182,XAUUSD,Buy,2015-09-24 08:00:00,2015-09-24 12:00:00,1137.06,1135.35,1,-171,43127.8,Exit After X Bars,,None,None,None,None
672_240906001_B,182,XAUUSD,Buy,2015-10-02 12:00:00,2015-10-02 16:00:00,1119.55,1131.89,1,1234,44361.8,Exit After X Bars,,None,None,None,None
673_240906001_B,182,XAUUSD,Buy,2015-10-09 08:00:00,2015-10-09 12:00:00,1154.2,1153.75,1,-45,44316.8,Exit After X Bars,,None,None,None,None
674_240906001_B,182,XAUUSD,Buy,2015-10-14 04:00:00,2015-10-14 08:00:00,1170.66,1173.73,1,307,44623.8,Exit After X Bars,,None,None,None,None
677_240906001_B,182,XAUUSD,Buy,2015-10-20 16:00:00,2015-10-20 20:00:00,1178.68,1176.93,1,-175,44448.8,Exit After X Bars,,None,None,None,None
681_240906001_B,182,XAUUSD,Buy,2015-10-28 08:00:00,2015-10-28 12:00:00,1170.1,1172.1,1,200,44648.8,Exit After X Bars,,None,None,None,None
691_240906001_B,182,XAUUSD,Buy,2015-11-19 16:00:00,2015-11-19 20:00:00,1085.9,1080.32,1,-558,44090.8,Exit After X Bars,,None,None,None,None
693_240906001_B,182,XAUUSD,Buy,2015-11-24 12:00:00,2015-11-24 16:00:00,1075.81,1077.21,1,140,44230.8,Exit After X Bars,,None,None,None,None
696_240906001_B,182,XAUUSD,Buy,2015-12-01 04:00:00,2015-12-01 08:00:00,1071.91,1072.04,1,13,44243.8,Exit After X Bars,,None,None,None,None
697_240906001_B,182,XAUUSD,Buy,2015-12-04 16:00:00,2015-12-04 20:00:00,1071.79,1083.97,1,1218,45461.8,Exit After X Bars,,None,None,None,None
700_240906001_B,182,XAUUSD,Buy,2015-12-11 16:00:00,2015-12-11 20:00:00,1077.77,1075.16,1,-261,45200.8,Exit After X Bars,,None,None,None,None
703_240906001_B,182,XAUUSD,Buy,2015-12-16 12:00:00,2015-12-16 16:00:00,1069.49,1072.87,1,338,45538.8,Exit After X Bars,,None,None,None,None
705_240906001_B,182,XAUUSD,Buy,2015-12-18 16:00:00,2015-12-18 20:00:00,1070.16,1065.61,1,-455,45083.8,Exit After X Bars,,None,None,None,None
708_240906001_B,182,XAUUSD,Buy,2015-12-29 12:00:00,2015-12-29 16:00:00,1075.16,1070.22,1,-494,44589.8,Exit After X Bars,,None,None,None,None
716_240906001_B,182,XAUUSD,Buy,2016-01-15 12:00:00,2016-01-15 16:00:00,1095.8,1093.84,1,-196,44393.8,Exit After X Bars,,None,None,None,None
717_240906001_B,182,XAUUSD,Buy,2016-01-20 08:00:00,2016-01-20 12:00:00,1094.2,1093.24,1,-96,44297.8,Exit After X Bars,,None,None,None,None
721_240906001_B,182,XAUUSD,Buy,2016-02-08 12:00:00,2016-02-08 16:00:00,1176.27,1181.58,1,531,44828.8,Exit After X Bars,,None,None,None,None
723_240906001_B,182,XAUUSD,Buy,2016-02-11 00:00:00,2016-02-11 04:00:00,1199.89,1207.95,1,806,45634.8,Exit After X Bars,,None,None,None,None
728_240906001_B,182,XAUUSD,Buy,2016-02-18 16:00:00,2016-02-18 20:00:00,1214.71,1227.06,1,1235,46869.8,Exit After X Bars,,None,None,None,None
731_240906001_B,182,XAUUSD,Buy,2016-02-23 12:00:00,2016-02-23 16:00:00,1225.44,1217.96,1,-748,46121.8,Exit After X Bars,,None,None,None,None
733_240906001_B,182,XAUUSD,Buy,2016-03-01 00:00:00,2016-03-01 04:00:00,1242.65,1246.43,1,378,46499.8,Exit After X Bars,,None,None,None,None
734_240906001_B,182,XAUUSD,Buy,2016-03-03 16:00:00,2016-03-03 20:00:00,1249.94,1256.9,1,696,47195.8,Exit After X Bars,,None,None,None,None
737_240906001_B,182,XAUUSD,Buy,2016-03-10 16:00:00,2016-03-10 20:00:00,1261.44,1272.46,1,1102,48297.8,Exit After X Bars,,None,None,None,None
741_240906001_B,182,XAUUSD,Buy,2016-03-16 20:00:00,2016-03-17 00:00:00,1238.79,1260.82,1,2203,50500.8,Exit After X Bars,,None,None,None,None
743_240906001_B,182,XAUUSD,Buy,2016-03-22 16:00:00,2016-03-22 20:00:00,1255.88,1246.97,1,-891,49609.8,Exit After X Bars,,None,None,None,None
746_240906001_B,182,XAUUSD,Buy,2016-03-29 16:00:00,2016-03-29 20:00:00,1225.36,1235.67,1,1031,50640.8,Exit After X Bars,,None,None,None,None
751_240906001_B,182,XAUUSD,Buy,2016-04-19 08:00:00,2016-04-19 12:00:00,1237.35,1241.91,1,456,51096.8,Exit After X Bars,,None,None,None,None
752_240906001_B,182,XAUUSD,Buy,2016-04-21 12:00:00,2016-04-21 16:00:00,1258.67,1268.85,1,1018,52114.8,Exit After X Bars,,None,None,None,None
755_240906001_B,182,XAUUSD,Buy,2016-04-26 16:00:00,2016-04-26 20:00:00,1242.9,1240.55,1,-235,51879.8,Exit After X Bars,,None,None,None,None
758_240906001_B,182,XAUUSD,Buy,2016-05-06 12:00:00,2016-05-06 16:00:00,1287.07,1291.99,1,492,52371.8,Exit After X Bars,,None,None,None,None
761_240906001_B,182,XAUUSD,Buy,2016-05-12 16:00:00,2016-05-12 20:00:00,1280.5,1271.05,1,-945,51426.8,Exit After X Bars,,None,None,None,None
770_240906001_B,182,XAUUSD,Buy,2016-05-26 16:00:00,2016-05-26 20:00:00,1231.41,1220.22,1,-1119,50307.8,Exit After X Bars,,None,None,None,None
773_240906001_B,182,XAUUSD,Buy,2016-06-03 12:00:00,2016-06-03 16:00:00,1218.44,1236.96,1,1852,52159.8,Exit After X Bars,,None,None,None,None
774_240906001_B,182,XAUUSD,Buy,2016-06-14 16:00:00,2016-06-14 20:00:00,1287.95,1282.08,1,-587,51572.8,Exit After X Bars,,None,None,None,None
775_240906001_B,182,XAUUSD,Buy,2016-06-15 20:00:00,2016-06-16 00:00:00,1290.48,1291.66,1,118,51690.8,Exit After X Bars,,None,None,None,None
780_240906001_B,182,XAUUSD,Buy,2016-06-24 00:00:00,2016-06-24 04:00:00,1271.67,1271.53,1,-14,51676.8,Exit After X Bars,,None,None,None,None
782_240906001_B,182,XAUUSD,Buy,2016-07-01 04:00:00,2016-07-01 08:00:00,1328.55,1330.3,1,175,51851.8,Exit After X Bars,,None,None,None,None
783_240906001_B,182,XAUUSD,Buy,2016-07-06 00:00:00,2016-07-06 04:00:00,1360.26,1363.03,1,277,52128.8,Exit After X Bars,,None,None,None,None
791_240906001_B,182,XAUUSD,Buy,2016-07-20 04:00:00,2016-07-20 08:00:00,1336.15,1331.76,1,-439,51689.8,Exit After X Bars,,None,None,None,None
794_240906001_B,182,XAUUSD,Buy,2016-07-27 16:00:00,2016-07-27 20:00:00,1325.18,1327.14,1,196,51885.8,Exit After X Bars,,None,None,None,None
795_240906001_B,182,XAUUSD,Buy,2016-07-29 20:00:00,2016-08-01 00:00:00,1346.92,1349.34,1,242,52127.8,End Of Friday,,None,None,None,None
799_240906001_B,182,XAUUSD,Buy,2016-08-09 16:00:00,2016-08-09 20:00:00,1338.92,1339.93,1,101,52228.8,Exit After X Bars,,None,None,None,None
801_240906001_B,182,XAUUSD,Buy,2016-08-12 12:00:00,2016-08-12 16:00:00,1354.35,1355.01,1,66,52294.8,Exit After X Bars,,None,None,None,None
802_240906001_B,182,XAUUSD,Buy,2016-08-16 12:00:00,2016-08-16 16:00:00,1356.99,1349.02,1,-797,51497.8,Exit After X Bars,,None,None,None,None
806_240906001_B,182,XAUUSD,Buy,2016-08-23 12:00:00,2016-08-23 16:00:00,1340.65,1343.74,1,309,51806.8,Exit After X Bars,,None,None,None,None
809_240906001_B,182,XAUUSD,Buy,2016-08-26 12:00:00,2016-08-26 16:00:00,1327.47,1331.14,1,367,52173.8,Exit After X Bars,,None,None,None,None
812_240906001_B,182,XAUUSD,Buy,2016-09-02 12:00:00,2016-09-02 16:00:00,1317.16,1324.49,1,733,52906.8,Exit After X Bars,,None,None,None,None
817_240906001_B,182,XAUUSD,Buy,2016-09-15 12:00:00,2016-09-15 16:00:00,1326.3,1320.64,1,-566,52340.8,Exit After X Bars,,None,None,None,None
819_240906001_B,182,XAUUSD,Buy,2016-09-20 08:00:00,2016-09-20 12:00:00,1317.1,1315.75,1,-135,52205.8,Exit After X Bars,,None,None,None,None
820_240906001_B,182,XAUUSD,Buy,2016-09-26 16:00:00,2016-09-26 20:00:00,1341.84,1340.09,1,-175,52030.8,Exit After X Bars,,None,None,None,None
823_240906001_B,182,XAUUSD,Buy,2016-09-30 12:00:00,2016-09-30 16:00:00,1327.89,1327.32,1,-57,51973.8,Exit After X Bars,,None,None,None,None
830_240906001_B,182,XAUUSD,Buy,2016-10-25 08:00:00,2016-10-25 12:00:00,1268.55,1269.28,1,73,52046.8,Exit After X Bars,,None,None,None,None
832_240906001_B,182,XAUUSD,Buy,2016-10-28 16:00:00,2016-10-28 20:00:00,1273.3,1269.81,1,-349,51697.8,Exit After X Bars,,None,None,None,None
836_240906001_B,182,XAUUSD,Buy,2016-11-09 04:00:00,2016-11-09 08:00:00,1294.28,1324.81,1,3053,54750.8,Exit After X Bars,,None,None,None,None
853_240906001_B,182,XAUUSD,Buy,2017-01-04 08:00:00,2017-01-04 12:00:00,1164.99,1165.4,1,41,54791.8,Exit After X Bars,,None,None,None,None
854_240906001_B,182,XAUUSD,Buy,2017-01-09 16:00:00,2017-01-09 20:00:00,1183.52,1182.7,1,-82,54709.8,Exit After X Bars,,None,None,None,None
858_240906001_B,182,XAUUSD,Buy,2017-01-20 20:00:00,2017-01-23 00:00:00,1209.09,1209.46,1,37,54746.8,End Of Friday,,None,None,None,None
859_240906001_B,182,XAUUSD,Buy,2017-01-23 20:00:00,2017-01-24 00:00:00,1216.28,1217.98,1,170,54916.8,Exit After X Bars,,None,None,None,None
866_240906001_B,182,XAUUSD,Buy,2017-02-14 12:00:00,2017-02-14 16:00:00,1232.89,1232.82,1,-7,54909.8,Exit After X Bars,,None,None,None,None
867_240906001_B,182,XAUUSD,Buy,2017-02-16 00:00:00,2017-02-16 04:00:00,1235.48,1236.16,1,68,54977.8,Exit After X Bars,,None,None,None,None
869_240906001_B,182,XAUUSD,Buy,2017-02-22 12:00:00,2017-02-22 16:00:00,1239.83,1238.65,1,-118,54859.8,Exit After X Bars,,None,None,None,None
879_240906001_B,182,XAUUSD,Buy,2017-03-21 16:00:00,2017-03-21 20:00:00,1237.14,1244.11,1,697,55556.8,Exit After X Bars,,None,None,None,None
885_240906001_B,182,XAUUSD,Buy,2017-04-07 04:00:00,2017-04-07 08:00:00,1259.58,1263.51,1,393,55949.8,Exit After X Bars,,None,None,None,None
887_240906001_B,182,XAUUSD,Buy,2017-04-11 12:00:00,2017-04-11 16:00:00,1257.66,1260.48,1,282,56231.8,Exit After X Bars,,None,None,None,None
891_240906001_B,182,XAUUSD,Buy,2017-04-21 12:00:00,2017-04-21 16:00:00,1283.83,1282.38,1,-145,56086.8,Exit After X Bars,,None,None,None,None
905_240906001_B,182,XAUUSD,Buy,2017-05-26 08:00:00,2017-05-26 12:00:00,1259.37,1263.49,1,412,56498.8,Exit After X Bars,,None,None,None,None
907_240906001_B,182,XAUUSD,Buy,2017-05-31 20:00:00,2017-06-01 00:00:00,1270.86,1268.22,1,-264,56234.8,Exit After X Bars,,None,None,None,None
909_240906001_B,182,XAUUSD,Buy,2017-06-02 12:00:00,2017-06-02 16:00:00,1270.95,1273.68,1,273,56507.8,Exit After X Bars,,None,None,None,None
913_240906001_B,182,XAUUSD,Buy,2017-06-14 12:00:00,2017-06-14 16:00:00,1270.67,1276.32,1,565,57072.8,Exit After X Bars,,None,None,None,None
917_240906001_B,182,XAUUSD,Buy,2017-06-22 04:00:00,2017-06-22 08:00:00,1253.7,1252.68,1,-102,56970.8,Exit After X Bars,,None,None,None,None
924_240906001_B,182,XAUUSD,Buy,2017-07-06 00:00:00,2017-07-06 04:00:00,1228.18,1227.31,1,-87,56883.8,Exit After X Bars,,None,None,None,None
927_240906001_B,182,XAUUSD,Buy,2017-07-11 16:00:00,2017-07-11 20:00:00,1216.55,1215.74,1,-81,56802.8,Exit After X Bars,,None,None,None,None
928_240906001_B,182,XAUUSD,Buy,2017-07-20 16:00:00,2017-07-20 20:00:00,1244.59,1246.2,1,161,56963.8,Exit After X Bars,,None,None,None,None
930_240906001_B,182,XAUUSD,Buy,2017-07-26 20:00:00,2017-07-27 00:00:00,1258.74,1260.47,1,173,57136.8,Exit After X Bars,,None,None,None,None
931_240906001_B,182,XAUUSD,Buy,2017-07-28 12:00:00,2017-07-28 16:00:00,1265.72,1263.57,1,-215,56921.8,Exit After X Bars,,None,None,None,None
936_240906001_B,182,XAUUSD,Buy,2017-08-08 20:00:00,2017-08-09 00:00:00,1260.29,1260.4,1,11,56932.8,Exit After X Bars,,None,None,None,None
939_240906001_B,182,XAUUSD,Buy,2017-08-16 20:00:00,2017-08-17 00:00:00,1278.84,1283.5,1,466,57398.8,Exit After X Bars,,None,None,None,None
944_240906001_B,182,XAUUSD,Buy,2017-08-25 16:00:00,2017-08-25 20:00:00,1290.49,1292.64,1,215,57613.8,Exit After X Bars,,None,None,None,None
946_240906001_B,182,XAUUSD,Buy,2017-08-31 16:00:00,2017-08-31 20:00:00,1314.11,1316.85,1,274,57887.8,Exit After X Bars,,None,None,None,None
947_240906001_B,182,XAUUSD,Buy,2017-09-05 20:00:00,2017-09-06 00:00:00,1341.09,1339.38,1,-171,57716.8,Exit After X Bars,,None,None,None,None
948_240906001_B,182,XAUUSD,Buy,2017-09-07 12:00:00,2017-09-07 16:00:00,1342.5,1343.87,1,137,57853.8,Exit After X Bars,,None,None,None,None
958_240906001_B,182,XAUUSD,Buy,2017-09-25 16:00:00,2017-09-25 20:00:00,1300.41,1310.15,1,974,58827.8,Exit After X Bars,,None,None,None,None
962_240906001_B,182,XAUUSD,Buy,2017-10-04 08:00:00,2017-10-04 12:00:00,1277.81,1275.54,1,-227,58600.8,Exit After X Bars,,None,None,None,None
966_240906001_B,182,XAUUSD,Buy,2017-10-19 12:00:00,2017-10-19 16:00:00,1289.17,1284.63,1,-454,58146.8,Exit After X Bars,,None,None,None,None
972_240906001_B,182,XAUUSD,Buy,2017-11-01 12:00:00,2017-11-01 16:00:00,1278.71,1275.13,1,-358,57788.8,Exit After X Bars,,None,None,None,None
973_240906001_B,182,XAUUSD,Buy,2017-11-06 16:00:00,2017-11-06 20:00:00,1281.09,1280.84,1,-25,57763.8,Exit After X Bars,,None,None,None,None
975_240906001_B,182,XAUUSD,Buy,2017-11-14 16:00:00,2017-11-14 20:00:00,1280.04,1281.0,1,96,57859.8,Exit After X Bars,,None,None,None,None
976_240906001_B,182,XAUUSD,Buy,2017-11-17 16:00:00,2017-11-17 20:00:00,1289.86,1293.4,1,354,58213.8,Exit After X Bars,,None,None,None,None
978_240906001_B,182,XAUUSD,Buy,2017-11-22 12:00:00,2017-11-22 16:00:00,1285.09,1285.34,1,25,58238.8,Exit After X Bars,,None,None,None,None
979_240906001_B,182,XAUUSD,Buy,2017-11-27 12:00:00,2017-11-27 16:00:00,1293.72,1298.32,1,460,58698.8,Exit After X Bars,,None,None,None,None
982_240906001_B,182,XAUUSD,Buy,2017-12-01 16:00:00,2017-12-01 20:00:00,1285.34,1283.66,1,-168,58530.8,Exit After X Bars,,None,None,None,None
988_240906001_B,182,XAUUSD,Buy,2017-12-13 20:00:00,2017-12-14 00:00:00,1252.76,1255.03,1,227,58757.8,Exit After X Bars,,None,None,None,None
990_240906001_B,182,XAUUSD,Buy,2018-01-04 16:00:00,2018-01-04 20:00:00,1319.91,1319.68,1,-23,58734.8,Exit After X Bars,,None,None,None,None
994_240906001_B,182,XAUUSD,Buy,2018-01-10 12:00:00,2018-01-10 16:00:00,1320.97,1319.7,1,-127,58607.8,Exit After X Bars,,None,None,None,None
995_240906001_B,182,XAUUSD,Buy,2018-01-12 04:00:00,2018-01-12 08:00:00,1328.26,1328.26,1,0,58607.8,Exit After X Bars,,None,None,None,None
999_240906001_B,182,XAUUSD,Buy,2018-01-23 16:00:00,2018-01-23 20:00:00,1338.97,1337.65,1,-132,58475.8,Exit After X Bars,,None,None,None,None
1004_240906001_B,182,XAUUSD,Buy,2018-02-01 20:00:00,2018-02-02 00:00:00,1348.63,1348.64,1,1,58476.8,Exit After X Bars,,None,None,None,None
1015_240906001_B,182,XAUUSD,Buy,2018-03-02 12:00:00,2018-03-02 16:00:00,1323.58,1325.0,1,142,58618.8,Exit After X Bars,,None,None,None,None
1018_240906001_B,182,XAUUSD,Buy,2018-03-13 12:00:00,2018-03-13 16:00:00,1325.88,1324.64,1,-124,58494.8,Exit After X Bars,,None,None,None,None
1022_240906001_B,182,XAUUSD,Buy,2018-03-21 12:00:00,2018-03-21 16:00:00,1317.72,1318.67,1,95,58589.8,Exit After X Bars,,None,None,None,None
1025_240906001_B,182,XAUUSD,Buy,2018-04-04 12:00:00,2018-04-04 16:00:00,1342.42,1347.08,1,466,59055.8,Exit After X Bars,,None,None,None,None
1027_240906001_B,182,XAUUSD,Buy,2018-04-06 16:00:00,2018-04-06 20:00:00,1333.47,1331.36,1,-211,58844.8,Exit After X Bars,,None,None,None,None
1028_240906001_B,182,XAUUSD,Buy,2018-04-09 20:00:00,2018-04-10 00:00:00,1336.57,1336.09,1,-48,58796.8,Exit After X Bars,,None,None,None,None
1031_240906001_B,182,XAUUSD,Buy,2018-04-16 16:00:00,2018-04-16 20:00:00,1348.51,1347.92,1,-59,58737.8,Exit After X Bars,,None,None,None,None
1033_240906001_B,182,XAUUSD,Buy,2018-04-18 12:00:00,2018-04-18 16:00:00,1349.94,1353.13,1,319,59056.8,Exit After X Bars,,None,None,None,None
1042_240906001_B,182,XAUUSD,Buy,2018-05-03 12:00:00,2018-05-03 16:00:00,1315.87,1315.51,1,-36,59020.8,Exit After X Bars,,None,None,None,None
1044_240906001_B,182,XAUUSD,Buy,2018-05-10 12:00:00,2018-05-10 16:00:00,1318.4,1322.01,1,361,59381.8,Exit After X Bars,,None,None,None,None
1050_240906001_B,182,XAUUSD,Buy,2018-05-22 08:00:00,2018-05-22 12:00:00,1294.76,1293.72,1,-104,59277.8,Exit After X Bars,,None,None,None,None
1052_240906001_B,182,XAUUSD,Buy,2018-05-29 16:00:00,2018-05-29 20:00:00,1301.83,1302.01,1,18,59295.8,Exit After X Bars,,None,None,None,None
1056_240906001_B,182,XAUUSD,Buy,2018-06-05 16:00:00,2018-06-05 20:00:00,1298.38,1298.38,1,0,59295.8,Exit After X Bars,,None,None,None,None
1060_240906001_B,182,XAUUSD,Buy,2018-06-13 20:00:00,2018-06-14 00:00:00,1300.02,1299.25,1,-77,59218.8,Exit After X Bars,,None,None,None,None
1069_240906001_B,182,XAUUSD,Buy,2018-06-29 16:00:00,2018-06-29 20:00:00,1254.59,1255.26,1,67,59285.8,Exit After X Bars,,None,None,None,None
1071_240906001_B,182,XAUUSD,Buy,2018-07-03 16:00:00,2018-07-03 20:00:00,1252.61,1252.72,1,11,59296.8,Exit After X Bars,,None,None,None,None
1079_240906001_B,182,XAUUSD,Buy,2018-07-20 12:00:00,2018-07-20 16:00:00,1229.55,1229.95,1,40,59336.8,Exit After X Bars,,None,None,None,None
1082_240906001_B,182,XAUUSD,Buy,2018-07-31 16:00:00,2018-07-31 20:00:00,1227.7,1225.98,1,-172,59164.8,Exit After X Bars,,None,None,None,None
1092_240906001_B,182,XAUUSD,Buy,2018-08-24 16:00:00,2018-08-24 20:00:00,1194.41,1205.45,1,1104,60268.8,Exit After X Bars,,None,None,None,None
1094_240906001_B,182,XAUUSD,Buy,2018-08-31 08:00:00,2018-08-31 12:00:00,1208.34,1206.3,1,-204,60064.8,Exit After X Bars,,None,None,None,None
1097_240906001_B,182,XAUUSD,Buy,2018-09-06 08:00:00,2018-09-06 12:00:00,1202.3,1202.91,1,61,60125.8,Exit After X Bars,,None,None,None,None
1099_240906001_B,182,XAUUSD,Buy,2018-09-11 20:00:00,2018-09-12 00:00:00,1198.84,1198.01,1,-83,60042.8,Exit After X Bars,,None,None,None,None
1100_240906001_B,182,XAUUSD,Buy,2018-09-12 16:00:00,2018-09-12 20:00:00,1200.22,1203.97,1,375,60417.8,Exit After X Bars,,None,None,None,None
1103_240906001_B,182,XAUUSD,Buy,2018-09-19 12:00:00,2018-09-19 16:00:00,1203.96,1205.23,1,127,60544.8,Exit After X Bars,,None,None,None,None
1104_240906001_B,182,XAUUSD,Buy,2018-09-20 20:00:00,2018-09-21 00:00:00,1207.06,1207.18,1,12,60556.8,Exit After X Bars,,None,None,None,None
1110_240906001_B,182,XAUUSD,Buy,2018-10-02 08:00:00,2018-10-02 12:00:00,1194.71,1193.13,1,-158,60398.8,Exit After X Bars,,None,None,None,None
1115_240906001_B,182,XAUUSD,Buy,2018-10-10 20:00:00,2018-10-11 00:00:00,1192.16,1194.76,1,260,60658.8,Exit After X Bars,,None,None,None,None
1117_240906001_B,182,XAUUSD,Buy,2018-10-18 16:00:00,2018-10-18 20:00:00,1229.87,1227.71,1,-216,60442.8,Exit After X Bars,,None,None,None,None
1118_240906001_B,182,XAUUSD,Buy,2018-10-19 12:00:00,2018-10-19 16:00:00,1230.34,1228.2,1,-214,60228.8,Exit After X Bars,,None,None,None,None
1119_240906001_B,182,XAUUSD,Buy,2018-10-23 08:00:00,2018-10-23 12:00:00,1231.37,1235.63,1,426,60654.8,Exit After X Bars,,None,None,None,None
1122_240906001_B,182,XAUUSD,Buy,2018-10-26 16:00:00,2018-10-26 20:00:00,1239.59,1233.81,1,-578,60076.8,Exit After X Bars,,None,None,None,None
1132_240906001_B,182,XAUUSD,Buy,2018-11-14 16:00:00,2018-11-14 20:00:00,1205.62,1208.29,1,267,60343.8,Exit After X Bars,,None,None,None,None
1133_240906001_B,182,XAUUSD,Buy,2018-11-21 16:00:00,2018-11-21 20:00:00,1229.05,1227.55,1,-150,60193.8,Exit After X Bars,,None,None,None,None
1137_240906001_B,182,XAUUSD,Buy,2018-11-28 16:00:00,2018-11-28 20:00:00,1225.48,1221.12,1,-436,59757.8,Exit After X Bars,,None,None,None,None
1138_240906001_B,182,XAUUSD,Buy,2018-12-06 16:00:00,2018-12-06 20:00:00,1242.32,1239.55,1,-277,59480.8,Exit After X Bars,,None,None,None,None
1139_240906001_B,182,XAUUSD,Buy,2018-12-07 12:00:00,2018-12-07 16:00:00,1244.72,1243.92,1,-80,59400.8,Exit After X Bars,,None,None,None,None
1144_240906001_B,182,XAUUSD,Buy,2018-12-17 16:00:00,2018-12-17 20:00:00,1243.23,1246.71,1,348,59748.8,Exit After X Bars,,None,None,None,None
1145_240906001_B,182,XAUUSD,Buy,2018-12-20 16:00:00,2018-12-20 20:00:00,1258.49,1262.55,1,406,60154.8,Exit After X Bars,,None,None,None,None
1146_240906001_B,182,XAUUSD,Buy,2018-12-28 08:00:00,2018-12-28 12:00:00,1280.19,1276.69,1,-350,59804.8,Exit After X Bars,,None,None,None,None
1147_240906001_B,182,XAUUSD,Buy,2018-12-31 12:00:00,2018-12-31 16:00:00,1282.52,1279.93,1,-259,59545.8,Exit After X Bars,,None,None,None,None
1151_240906001_B,182,XAUUSD,Buy,2019-01-09 16:00:00,2019-01-09 20:00:00,1287.54,1289.85,1,231,59776.8,Exit After X Bars,,None,None,None,None
1155_240906001_B,182,XAUUSD,Buy,2019-01-17 04:00:00,2019-01-17 08:00:00,1295.1,1292.57,1,-253,59523.8,Exit After X Bars,,None,None,None,None
1158_240906001_B,182,XAUUSD,Buy,2019-01-22 16:00:00,2019-01-22 20:00:00,1283.85,1283.57,1,-28,59495.8,Exit After X Bars,,None,None,None,None
1160_240906001_B,182,XAUUSD,Buy,2019-01-25 12:00:00,2019-01-25 16:00:00,1284.87,1288.55,1,368,59863.8,Exit After X Bars,,None,None,None,None
1163_240906001_B,182,XAUUSD,Buy,2019-02-05 12:00:00,2019-02-05 16:00:00,1315.92,1314.58,1,-134,59729.8,Exit After X Bars,,None,None,None,None
1166_240906001_B,182,XAUUSD,Buy,2019-02-08 12:00:00,2019-02-08 16:00:00,1312.2,1314.73,1,253,59982.8,Exit After X Bars,,None,None,None,None
1168_240906001_B,182,XAUUSD,Buy,2019-02-12 12:00:00,2019-02-12 16:00:00,1314.45,1311.8,1,-265,59717.8,Exit After X Bars,,None,None,None,None
1169_240906001_B,182,XAUUSD,Buy,2019-02-15 12:00:00,2019-02-15 16:00:00,1318.78,1317.47,1,-131,59586.8,Exit After X Bars,,None,None,None,None
1179_240906001_B,182,XAUUSD,Buy,2019-03-08 04:00:00,2019-03-08 08:00:00,1290.59,1290.66,1,7,59593.8,Exit After X Bars,,None,None,None,None
1182_240906001_B,182,XAUUSD,Buy,2019-03-19 04:00:00,2019-03-19 08:00:00,1306.97,1307.65,1,68,59661.8,Exit After X Bars,,None,None,None,None
1183_240906001_B,182,XAUUSD,Buy,2019-03-20 20:00:00,2019-03-21 00:00:00,1311.32,1312.96,1,164,59825.8,Exit After X Bars,,None,None,None,None
1198_240906001_B,182,XAUUSD,Buy,2019-04-24 16:00:00,2019-04-24 20:00:00,1276.93,1275.69,1,-124,59701.8,Exit After X Bars,,None,None,None,None
1199_240906001_B,182,XAUUSD,Buy,2019-05-01 20:00:00,2019-05-02 00:00:00,1286.77,1276.65,1,-1012,58689.8,Exit After X Bars,,None,None,None,None
1201_240906001_B,182,XAUUSD,Buy,2019-05-03 16:00:00,2019-05-03 20:00:00,1277.32,1280.96,1,364,59053.8,Exit After X Bars,,None,None,None,None
1208_240906001_B,182,XAUUSD,Buy,2019-05-22 12:00:00,2019-05-22 16:00:00,1276.98,1275.58,1,-140,58913.8,Exit After X Bars,,None,None,None,None
1209_240906001_B,182,XAUUSD,Buy,2019-05-23 12:00:00,2019-05-23 16:00:00,1277.54,1282.7,1,516,59429.8,Exit After X Bars,,None,None,None,None
1212_240906001_B,182,XAUUSD,Buy,2019-05-30 16:00:00,2019-05-30 20:00:00,1285.73,1287.07,1,134,59563.8,Exit After X Bars,,None,None,None,None
1214_240906001_B,182,XAUUSD,Buy,2019-06-07 12:00:00,2019-06-07 16:00:00,1340.5,1341.0,1,50,59613.8,Exit After X Bars,,None,None,None,None
1216_240906001_B,182,XAUUSD,Buy,2019-06-12 08:00:00,2019-06-12 12:00:00,1335.83,1337.58,1,175,59788.8,Exit After X Bars,,None,None,None,None
1217_240906001_B,182,XAUUSD,Buy,2019-06-13 16:00:00,2019-06-13 20:00:00,1338.8,1339.35,1,55,59843.8,Exit After X Bars,,None,None,None,None
1219_240906001_B,182,XAUUSD,Buy,2019-06-19 20:00:00,2019-06-20 00:00:00,1355.07,1360.32,1,525,60368.8,Exit After X Bars,,None,None,None,None
1221_240906001_B,182,XAUUSD,Buy,2019-06-28 00:00:00,2019-06-28 04:00:00,1416.67,1414.25,1,-242,60126.8,Exit After X Bars,,None,None,None,None
1223_240906001_B,182,XAUUSD,Buy,2019-07-02 16:00:00,2019-07-02 20:00:00,1398.1,1404.96,1,686,60812.8,Exit After X Bars,,None,None,None,None
1228_240906001_B,182,XAUUSD,Buy,2019-07-10 12:00:00,2019-07-10 16:00:00,1401.26,1410.09,1,883,61695.8,Exit After X Bars,,None,None,None,None
1230_240906001_B,182,XAUUSD,Buy,2019-07-17 16:00:00,2019-07-17 20:00:00,1417.01,1422.27,1,526,62221.8,Exit After X Bars,,None,None,None,None
1234_240906001_B,182,XAUUSD,Buy,2019-07-25 12:00:00,2019-07-25 16:00:00,1430.27,1424.48,1,-579,61642.8,Exit After X Bars,,None,None,None,None
1236_240906001_B,182,XAUUSD,Buy,2019-07-29 20:00:00,2019-07-30 00:00:00,1425.4,1426.49,1,109,61751.8,Exit After X Bars,,None,None,None,None
1237_240906001_B,182,XAUUSD,Buy,2019-08-01 20:00:00,2019-08-02 00:00:00,1436.41,1444.8,1,839,62590.8,Exit After X Bars,,None,None,None,None
1239_240906001_B,182,XAUUSD,Buy,2019-08-12 20:00:00,2019-08-13 00:00:00,1509.3,1510.78,1,148,62738.8,Exit After X Bars,,None,None,None,None
1241_240906001_B,182,XAUUSD,Buy,2019-08-15 20:00:00,2019-08-16 00:00:00,1525.01,1523.39,1,-162,62576.8,Exit After X Bars,,None,None,None,None
1247_240906001_B,182,XAUUSD,Buy,2019-08-23 16:00:00,2019-08-23 20:00:00,1505.15,1526.85,1,2170,64746.8,Exit After X Bars,,None,None,None,None
1251_240906001_B,182,XAUUSD,Buy,2019-09-03 12:00:00,2019-09-03 16:00:00,1532.26,1532.38,1,12,64758.8,Exit After X Bars,,None,None,None,None
1256_240906001_B,182,XAUUSD,Buy,2019-09-12 08:00:00,2019-09-12 12:00:00,1501.77,1504.38,1,261,65019.8,Exit After X Bars,,None,None,None,None
1257_240906001_B,182,XAUUSD,Buy,2019-09-20 20:00:00,2019-09-23 00:00:00,1512.57,1513.99,1,142,65161.8,End Of Friday,,None,None,None,None
1261_240906001_B,182,XAUUSD,Buy,2019-10-02 16:00:00,2019-10-02 20:00:00,1498.12,1502.0,1,388,65549.8,Exit After X Bars,,None,None,None,None
1262_240906001_B,182,XAUUSD,Buy,2019-10-09 08:00:00,2019-10-09 12:00:00,1510.41,1505.26,1,-515,65034.8,Exit After X Bars,,None,None,None,None
1267_240906001_B,182,XAUUSD,Buy,2019-10-23 16:00:00,2019-10-23 20:00:00,1496.07,1492.28,1,-379,64655.8,Exit After X Bars,,None,None,None,None
1269_240906001_B,182,XAUUSD,Buy,2019-10-30 16:00:00,2019-10-30 20:00:00,1495.16,1494.04,1,-112,64543.8,Exit After X Bars,,None,None,None,None
1275_240906001_B,182,XAUUSD,Buy,2019-11-13 20:00:00,2019-11-14 00:00:00,1466.78,1463.28,1,-350,64193.8,Exit After X Bars,,None,None,None,None
1279_240906001_B,182,XAUUSD,Buy,2019-11-26 20:00:00,2019-11-27 00:00:00,1462.84,1461.1,1,-174,64019.8,Exit After X Bars,,None,None,None,None
1280_240906001_B,182,XAUUSD,Buy,2019-12-03 12:00:00,2019-12-03 16:00:00,1467.82,1474.23,1,641,64660.8,Exit After X Bars,,None,None,None,None
1284_240906001_B,182,XAUUSD,Buy,2019-12-10 12:00:00,2019-12-10 16:00:00,1465.63,1466.97,1,134,64794.8,Exit After X Bars,,None,None,None,None
1285_240906001_B,182,XAUUSD,Buy,2019-12-11 16:00:00,2019-12-11 20:00:00,1469.48,1470.33,1,85,64879.8,Exit After X Bars,,None,None,None,None
1288_240906001_B,182,XAUUSD,Buy,2019-12-19 16:00:00,2019-12-19 20:00:00,1479.6,1479.76,1,16,64895.8,Exit After X Bars,,None,None,None,None
1289_240906001_B,182,XAUUSD,Buy,2019-12-30 20:00:00,2019-12-31 00:00:00,1515.85,1514.57,1,-128,64767.8,Exit After X Bars,,None,None,None,None
1290_240906001_B,182,XAUUSD,Buy,2020-01-02 12:00:00,2020-01-02 16:00:00,1526.03,1528.01,1,198,64965.8,Exit After X Bars,,None,None,None,None
1291_240906001_B,182,XAUUSD,Buy,2020-01-08 00:00:00,2020-01-08 04:00:00,1581.29,1593.29,1,1200,66165.8,Exit After X Bars,,None,None,None,None
1293_240906001_B,182,XAUUSD,Buy,2020-01-10 20:00:00,2020-01-13 00:00:00,1562.04,1561.32,1,-72,66093.8,End Of Friday,,None,None,None,None
1296_240906001_B,182,XAUUSD,Buy,2020-01-17 12:00:00,2020-01-17 16:00:00,1559.27,1555.36,1,-391,65702.8,Exit After X Bars,,None,None,None,None
1299_240906001_B,182,XAUUSD,Buy,2020-01-23 16:00:00,2020-01-23 20:00:00,1564.68,1567.21,1,253,65955.8,Exit After X Bars,,None,None,None,None
1300_240906001_B,182,XAUUSD,Buy,2020-01-24 16:00:00,2020-01-24 20:00:00,1568.43,1571.61,1,318,66273.8,Exit After X Bars,,None,None,None,None
1301_240906001_B,182,XAUUSD,Buy,2020-01-30 16:00:00,2020-01-30 20:00:00,1583.52,1584.78,1,126,66399.8,Exit After X Bars,,None,None,None,None
1302_240906001_B,182,XAUUSD,Buy,2020-01-31 16:00:00,2020-01-31 20:00:00,1586.9,1583.5,1,-340,66059.8,Exit After X Bars,,None,None,None,None
1306_240906001_B,182,XAUUSD,Buy,2020-02-06 12:00:00,2020-02-06 16:00:00,1563.1,1563.76,1,66,66125.8,Exit After X Bars,,None,None,None,None
1308_240906001_B,182,XAUUSD,Buy,2020-02-13 04:00:00,2020-02-13 08:00:00,1574.56,1574.09,1,-47,66078.8,Exit After X Bars,,None,None,None,None
1311_240906001_B,182,XAUUSD,Buy,2020-02-27 16:00:00,2020-02-27 20:00:00,1657.28,1640.75,1,-1653,64425.8,Exit After X Bars,,None,None,None,None
1314_240906001_B,182,XAUUSD,Buy,2020-03-03 16:00:00,2020-03-03 20:00:00,1614.05,1645.16,1,3111,67536.8,Exit After X Bars,,None,None,None,None
1328_240906001_B,182,XAUUSD,Buy,2020-04-02 12:00:00,2020-04-02 16:00:00,1602.02,1601.04,1,-98,67438.8,Exit After X Bars,,None,None,None,None
1331_240906001_B,182,XAUUSD,Buy,2020-04-16 12:00:00,2020-04-16 16:00:00,1732.39,1724.86,1,-753,66685.8,Exit After X Bars,,None,None,None,None
1335_240906001_B,182,XAUUSD,Buy,2020-04-22 12:00:00,2020-04-22 16:00:00,1699.08,1705.99,1,691,67376.8,Exit After X Bars,,None,None,None,None
1338_240906001_B,182,XAUUSD,Buy,2020-04-29 20:00:00,2020-04-30 00:00:00,1715.69,1711.6,1,-409,66967.8,Exit After X Bars,,None,None,None,None
1340_240906001_B,182,XAUUSD,Buy,2020-05-07 16:00:00,2020-05-07 20:00:00,1710.57,1715.17,1,460,67427.8,Exit After X Bars,,None,None,None,None
1342_240906001_B,182,XAUUSD,Buy,2020-05-13 12:00:00,2020-05-13 16:00:00,1713.1,1712.08,1,-102,67325.8,Exit After X Bars,,None,None,None,None
1352_240906001_B,182,XAUUSD,Buy,2020-06-09 16:00:00,2020-06-09 20:00:00,1717.82,1715.22,1,-260,67065.8,Exit After X Bars,,None,None,None,None
1355_240906001_B,182,XAUUSD,Buy,2020-06-18 08:00:00,2020-06-18 12:00:00,1733.79,1732.86,1,-93,66972.8,Exit After X Bars,,None,None,None,None
1356_240906001_B,182,XAUUSD,Buy,2020-06-19 16:00:00,2020-06-19 20:00:00,1738.54,1741.5,1,296,67268.8,Exit After X Bars,,None,None,None,None
1358_240906001_B,182,XAUUSD,Buy,2020-06-26 20:00:00,2020-06-29 00:00:00,1769.65,1774.92,1,527,67795.8,End Of Friday,,None,None,None,None
1359_240906001_B,182,XAUUSD,Buy,2020-06-30 00:00:00,2020-06-30 04:00:00,1773.5,1769.21,1,-429,67366.8,Exit After X Bars,,None,None,None,None
1362_240906001_B,182,XAUUSD,Buy,2020-07-06 12:00:00,2020-07-06 16:00:00,1777.72,1783.07,1,535,67901.8,Exit After X Bars,,None,None,None,None
1364_240906001_B,182,XAUUSD,Buy,2020-07-13 16:00:00,2020-07-13 20:00:00,1811.3,1809.68,1,-162,67739.8,Exit After X Bars,,None,None,None,None
1365_240906001_B,182,XAUUSD,Buy,2020-07-15 08:00:00,2020-07-15 12:00:00,1814.36,1812.4,1,-196,67543.8,Exit After X Bars,,None,None,None,None
1370_240906001_B,182,XAUUSD,Buy,2020-07-31 08:00:00,2020-07-31 12:00:00,1982.19,1976.84,1,-535,67008.8,Exit After X Bars,,None,None,None,None
1372_240906001_B,182,XAUUSD,Buy,2020-08-04 16:00:00,2020-08-04 20:00:00,1978.88,1999.5,1,2062,69070.8,Exit After X Bars,,None,None,None,None
1376_240906001_B,182,XAUUSD,Buy,2020-08-13 16:00:00,2020-08-13 20:00:00,1953.62,1953.66,1,4,69074.8,Exit After X Bars,,None,None,None,None
1378_240906001_B,182,XAUUSD,Buy,2020-08-17 16:00:00,2020-08-17 20:00:00,1963.74,1987.4,1,2366,71440.8,Exit After X Bars,,None,None,None,None
1381_240906001_B,182,XAUUSD,Buy,2020-08-24 12:00:00,2020-08-24 16:00:00,1954.05,1949.0,1,-505,70935.8,Exit After X Bars,,None,None,None,None
1383_240906001_B,182,XAUUSD,Buy,2020-08-26 16:00:00,2020-08-26 20:00:00,1938.7,1943.23,1,453,71388.8,Exit After X Bars,,None,None,None,None
1388_240906001_B,182,XAUUSD,Buy,2020-09-09 16:00:00,2020-09-09 20:00:00,1942.59,1948.25,1,566,71954.8,Exit After X Bars,,None,None,None,None
1390_240906001_B,182,XAUUSD,Buy,2020-09-14 12:00:00,2020-09-14 16:00:00,1955.88,1955.95,1,7,71961.8,Exit After X Bars,,None,None,None,None
1391_240906001_B,182,XAUUSD,Buy,2020-09-16 16:00:00,2020-09-16 20:00:00,1972.86,1965.14,1,-772,71189.8,Exit After X Bars,,None,None,None,None
1398_240906001_B,182,XAUUSD,Buy,2020-09-28 16:00:00,2020-09-28 20:00:00,1876.46,1874.47,1,-199,70990.8,Exit After X Bars,,None,None,None,None
1400_240906001_B,182,XAUUSD,Buy,2020-10-06 12:00:00,2020-10-06 16:00:00,1918.88,1915.69,1,-319,70671.8,Exit After X Bars,,None,None,None,None
1402_240906001_B,182,XAUUSD,Buy,2020-10-08 12:00:00,2020-10-08 16:00:00,1898.73,1898.18,1,-55,70616.8,Exit After X Bars,,None,None,None,None
1406_240906001_B,182,XAUUSD,Buy,2020-10-19 12:00:00,2020-10-19 16:00:00,1914.68,1911.79,1,-289,70327.8,Exit After X Bars,,None,None,None,None
1407_240906001_B,182,XAUUSD,Buy,2020-10-21 04:00:00,2020-10-21 08:00:00,1918.95,1918.98,1,3,70330.8,Exit After X Bars,,None,None,None,None
1411_240906001_B,182,XAUUSD,Buy,2020-10-27 20:00:00,2020-10-28 00:00:00,1910.52,1907.76,1,-276,70054.8,Exit After X Bars,,None,None,None,None
1414_240906001_B,182,XAUUSD,Buy,2020-10-30 12:00:00,2020-10-30 16:00:00,1885.68,1887.35,1,167,70221.8,Exit After X Bars,,None,None,None,None
1415_240906001_B,182,XAUUSD,Buy,2020-11-05 08:00:00,2020-11-05 12:00:00,1918.89,1917.0,1,-189,70032.8,Exit After X Bars,,None,None,None,None
1418_240906001_B,182,XAUUSD,Buy,2020-11-13 12:00:00,2020-11-13 16:00:00,1886.13,1894.65,1,852,70884.8,Exit After X Bars,,None,None,None,None
1421_240906001_B,182,XAUUSD,Buy,2020-11-20 16:00:00,2020-11-20 20:00:00,1872.91,1872.19,1,-72,70812.8,Exit After X Bars,,None,None,None,None
1425_240906001_B,182,XAUUSD,Buy,2020-12-01 12:00:00,2020-12-01 16:00:00,1813.18,1812.76,1,-42,70770.8,Exit After X Bars,,None,None,None,None
1433_240906001_B,182,XAUUSD,Buy,2020-12-24 16:00:00,2020-12-24 20:00:00,1879.69,1879.57,1,-12,70758.8,Exit After X Bars,,None,None,None,None
1435_240906001_B,182,XAUUSD,Buy,2020-12-30 16:00:00,2020-12-30 20:00:00,1887.22,1888.73,1,151,70909.8,Exit After X Bars,,None,None,None,None
1439_240906001_B,182,XAUUSD,Buy,2021-01-13 00:00:00,2021-01-13 04:00:00,1857.96,1862.01,1,405,71314.8,Exit After X Bars,,None,None,None,None
1441_240906001_B,182,XAUUSD,Buy,2021-01-20 16:00:00,2021-01-20 20:00:00,1862.3,1863.09,1,79,71393.8,Exit After X Bars,,None,None,None,None
1443_240906001_B,182,XAUUSD,Buy,2021-01-25 12:00:00,2021-01-25 16:00:00,1866.6,1864.87,1,-173,71220.8,Exit After X Bars,,None,None,None,None
1446_240906001_B,182,XAUUSD,Buy,2021-01-28 12:00:00,2021-01-28 16:00:00,1855.27,1856.92,1,165,71385.8,Exit After X Bars,,None,None,None,None
1447_240906001_B,182,XAUUSD,Buy,2021-01-29 12:00:00,2021-01-29 16:00:00,1865.06,1871.93,1,687,72072.8,Exit After X Bars,,None,None,None,None
1465_240906001_B,182,XAUUSD,Buy,2021-03-09 16:00:00,2021-03-09 20:00:00,1715.3,1716.52,1,122,72194.8,Exit After X Bars,,None,None,None,None
1472_240906001_B,182,XAUUSD,Buy,2021-03-25 16:00:00,2021-03-25 20:00:00,1738.73,1728.18,1,-1055,71139.8,Exit After X Bars,,None,None,None,None
1476_240906001_B,182,XAUUSD,Buy,2021-03-31 20:00:00,2021-04-01 00:00:00,1715.05,1707.66,1,-739,70400.8,Exit After X Bars,,None,None,None,None
1479_240906001_B,182,XAUUSD,Buy,2021-04-13 16:00:00,2021-04-13 20:00:00,1745.73,1742.5,1,-323,70077.8,Exit After X Bars,,None,None,None,None
1480_240906001_B,182,XAUUSD,Buy,2021-04-15 12:00:00,2021-04-15 16:00:00,1750.07,1746.8,1,-327,69750.8,Exit After X Bars,,None,None,None,None
1482_240906001_B,182,XAUUSD,Buy,2021-04-21 12:00:00,2021-04-21 16:00:00,1781.07,1786.22,1,515,70265.8,Exit After X Bars,,None,None,None,None
1485_240906001_B,182,XAUUSD,Buy,2021-04-27 12:00:00,2021-04-27 16:00:00,1783.91,1782.93,1,-98,70167.8,Exit After X Bars,,None,None,None,None
1486_240906001_B,182,XAUUSD,Buy,2021-04-29 04:00:00,2021-04-29 08:00:00,1786.92,1785.05,1,-187,69980.8,Exit After X Bars,,None,None,None,None
1488_240906001_B,182,XAUUSD,Buy,2021-05-06 16:00:00,2021-05-06 20:00:00,1799.42,1815.7,1,1628,71608.8,Exit After X Bars,,None,None,None,None
1489_240906001_B,182,XAUUSD,Buy,2021-05-12 16:00:00,2021-05-12 20:00:00,1842.59,1820.23,1,-2236,69372.8,Exit After X Bars,,None,None,None,None
1492_240906001_B,182,XAUUSD,Buy,2021-05-21 12:00:00,2021-05-21 16:00:00,1884.69,1886.94,1,225,69597.8,Exit After X Bars,,None,None,None,None
1494_240906001_B,182,XAUUSD,Buy,2021-05-25 16:00:00,2021-05-25 20:00:00,1887.94,1895.23,1,729,70326.8,Exit After X Bars,,None,None,None,None
1496_240906001_B,182,XAUUSD,Buy,2021-05-28 20:00:00,2021-05-31 00:00:00,1903.95,1903.34,1,-61,70265.8,End Of Friday,,None,None,None,None
1500_240906001_B,182,XAUUSD,Buy,2021-06-07 20:00:00,2021-06-08 00:00:00,1897.47,1897.97,1,50,70315.8,Exit After X Bars,,None,None,None,None
1502_240906001_B,182,XAUUSD,Buy,2021-06-11 04:00:00,2021-06-11 08:00:00,1899.76,1900.08,1,32,70347.8,Exit After X Bars,,None,None,None,None
1510_240906001_B,182,XAUUSD,Buy,2021-07-01 12:00:00,2021-07-01 16:00:00,1779.22,1777.91,1,-131,70216.8,Exit After X Bars,,None,None,None,None
1512_240906001_B,182,XAUUSD,Buy,2021-07-13 12:00:00,2021-07-13 16:00:00,1814.07,1800.28,1,-1379,68837.8,Exit After X Bars,,None,None,None,None
1513_240906001_B,182,XAUUSD,Buy,2021-07-14 12:00:00,2021-07-14 16:00:00,1817.79,1828.48,1,1069,69906.8,Exit After X Bars,,None,None,None,None
1516_240906001_B,182,XAUUSD,Buy,2021-07-20 12:00:00,2021-07-20 16:00:00,1816.78,1822.68,1,590,70496.8,Exit After X Bars,,None,None,None,None
1522_240906001_B,182,XAUUSD,Buy,2021-07-28 20:00:00,2021-07-29 00:00:00,1805.65,1806.93,1,128,70624.8,Exit After X Bars,,None,None,None,None
1525_240906001_B,182,XAUUSD,Buy,2021-08-04 12:00:00,2021-08-04 16:00:00,1815.21,1827.06,1,1185,71809.8,Exit After X Bars,,None,None,None,None
1530_240906001_B,182,XAUUSD,Buy,2021-08-11 12:00:00,2021-08-11 16:00:00,1739.07,1744.61,1,554,72363.8,Exit After X Bars,,None,None,None,None
1533_240906001_B,182,XAUUSD,Buy,2021-08-23 12:00:00,2021-08-23 16:00:00,1789.31,1799.89,1,1058,73421.8,Exit After X Bars,,None,None,None,None
1535_240906001_B,182,XAUUSD,Buy,2021-08-26 16:00:00,2021-08-26 20:00:00,1798.07,1792.11,1,-596,72825.8,Exit After X Bars,,None,None,None,None
1536_240906001_B,182,XAUUSD,Buy,2021-09-01 12:00:00,2021-09-01 16:00:00,1819.67,1819.32,1,-35,72790.8,Exit After X Bars,,None,None,None,None
1538_240906001_B,182,XAUUSD,Buy,2021-09-03 12:00:00,2021-09-03 16:00:00,1817.45,1823.4,1,595,73385.8,Exit After X Bars,,None,None,None,None
1541_240906001_B,182,XAUUSD,Buy,2021-09-10 08:00:00,2021-09-10 12:00:00,1802.63,1801.59,1,-104,73281.8,Exit After X Bars,,None,None,None,None
1542_240906001_B,182,XAUUSD,Buy,2021-09-14 16:00:00,2021-09-14 20:00:00,1804.44,1803.56,1,-88,73193.8,Exit After X Bars,,None,None,None,None
1545_240906001_B,182,XAUUSD,Buy,2021-09-21 12:00:00,2021-09-21 16:00:00,1768.18,1771.79,1,361,73554.8,Exit After X Bars,,None,None,None,None
1550_240906001_B,182,XAUUSD,Buy,2021-09-30 16:00:00,2021-09-30 20:00:00,1746.44,1758.15,1,1171,74725.8,Exit After X Bars,,None,None,None,None
1553_240906001_B,182,XAUUSD,Buy,2021-10-08 12:00:00,2021-10-08 16:00:00,1767.46,1775.77,1,831,75556.8,Exit After X Bars,,None,None,None,None
1555_240906001_B,182,XAUUSD,Buy,2021-10-12 12:00:00,2021-10-12 16:00:00,1761.55,1757.51,1,-404,75152.8,Exit After X Bars,,None,None,None,None
1558_240906001_B,182,XAUUSD,Buy,2021-10-20 12:00:00,2021-10-20 16:00:00,1785.64,1786.43,1,79,75231.8,Exit After X Bars,,None,None,None,None
1563_240906001_B,182,XAUUSD,Buy,2021-11-04 12:00:00,2021-11-04 16:00:00,1788.73,1792.52,1,379,75610.8,Exit After X Bars,,None,None,None,None
1564_240906001_B,182,XAUUSD,Buy,2021-11-12 20:00:00,2021-11-15 00:00:00,1868.04,1869.36,1,132,75742.8,End Of Friday,,None,None,None,None
1565_240906001_B,182,XAUUSD,Buy,2021-11-16 08:00:00,2021-11-16 12:00:00,1871.02,1873.17,1,215,75957.8,Exit After X Bars,,None,None,None,None
1572_240906001_B,182,XAUUSD,Buy,2021-11-26 04:00:00,2021-11-26 08:00:00,1797.73,1797.34,1,-39,75918.8,Exit After X Bars,,None,None,None,None
1575_240906001_B,182,XAUUSD,Buy,2021-12-03 20:00:00,2021-12-06 00:00:00,1782.69,1784.36,1,167,76085.8,End Of Friday,,None,None,None,None
1576_240906001_B,182,XAUUSD,Buy,2021-12-10 16:00:00,2021-12-10 20:00:00,1788.38,1783.36,1,-502,75583.8,Exit After X Bars,,None,None,None,None
1578_240906001_B,182,XAUUSD,Buy,2021-12-16 16:00:00,2021-12-16 20:00:00,1790.2,1797.2,1,700,76283.8,Exit After X Bars,,None,None,None,None
1580_240906001_B,182,XAUUSD,Buy,2021-12-22 20:00:00,2021-12-23 00:00:00,1801.02,1803.8,1,278,76561.8,Exit After X Bars,,None,None,None,None
1582_240906001_B,182,XAUUSD,Buy,2021-12-30 16:00:00,2021-12-30 20:00:00,1808.43,1813.42,1,499,77060.8,Exit After X Bars,,None,None,None,None
1586_240906001_B,182,XAUUSD,Buy,2022-01-10 12:00:00,2022-01-10 16:00:00,1799.45,1792.91,1,-654,76406.8,Exit After X Bars,,None,None,None,None
1589_240906001_B,182,XAUUSD,Buy,2022-01-19 12:00:00,2022-01-19 16:00:00,1823.28,1823.91,1,63,76469.8,Exit After X Bars,,None,None,None,None
1592_240906001_B,182,XAUUSD,Buy,2022-01-25 16:00:00,2022-01-25 20:00:00,1844.93,1849.7,1,477,76946.8,Exit After X Bars,,None,None,None,None
1595_240906001_B,182,XAUUSD,Buy,2022-02-01 04:00:00,2022-02-01 08:00:00,1800.45,1802.6,1,215,77161.8,Exit After X Bars,,None,None,None,None
1596_240906001_B,182,XAUUSD,Buy,2022-02-11 20:00:00,2022-02-14 00:00:00,1842.68,1859.23,1,1655,78816.8,End Of Friday,,None,None,None,None
1598_240906001_B,182,XAUUSD,Buy,2022-02-17 08:00:00,2022-02-17 12:00:00,1880.26,1888.24,1,798,79614.8,Exit After X Bars,,None,None,None,None
1599_240906001_B,182,XAUUSD,Buy,2022-02-21 20:00:00,2022-02-22 00:00:00,1901.84,1908.75,1,691,80305.8,Exit After X Bars,,None,None,None,None
1601_240906001_B,182,XAUUSD,Buy,2022-02-24 04:00:00,2022-02-24 08:00:00,1914.01,1940.37,1,2636,82941.8,Exit After X Bars,,None,None,None,None
1604_240906001_B,182,XAUUSD,Buy,2022-03-01 12:00:00,2022-03-01 16:00:00,1919.41,1916.73,1,-268,82673.8,Exit After X Bars,,None,None,None,None
1605_240906001_B,182,XAUUSD,Buy,2022-03-04 00:00:00,2022-03-04 04:00:00,1948.71,1933.69,1,-1502,81171.8,Exit After X Bars,,None,None,None,None
1606_240906001_B,182,XAUUSD,Buy,2022-03-08 12:00:00,2022-03-08 16:00:00,2006.32,2014.9,1,858,82029.8,Exit After X Bars,,None,None,None,None
1616_240906001_B,182,XAUUSD,Buy,2022-03-23 20:00:00,2022-03-24 00:00:00,1939.56,1942.89,1,333,82362.8,Exit After X Bars,,None,None,None,None
1619_240906001_B,182,XAUUSD,Buy,2022-03-30 12:00:00,2022-03-30 16:00:00,1930.24,1927.08,1,-316,82046.8,Exit After X Bars,,None,None,None,None
1620_240906001_B,182,XAUUSD,Buy,2022-03-31 16:00:00,2022-03-31 20:00:00,1940.8,1944.27,1,347,82393.8,Exit After X Bars,,None,None,None,None
1622_240906001_B,182,XAUUSD,Buy,2022-04-05 16:00:00,2022-04-05 20:00:00,1938.09,1923.31,1,-1478,80915.8,Exit After X Bars,,None,None,None,None
1624_240906001_B,182,XAUUSD,Buy,2022-04-07 16:00:00,2022-04-07 20:00:00,1934.37,1934.09,1,-28,80887.8,Exit After X Bars,,None,None,None,None
1633_240906001_B,182,XAUUSD,Buy,2022-04-29 08:00:00,2022-04-29 12:00:00,1907.61,1913.84,1,623,81510.8,Exit After X Bars,,None,None,None,None
1635_240906001_B,182,XAUUSD,Buy,2022-05-05 00:00:00,2022-05-05 04:00:00,1893.45,1895.71,1,226,81736.8,Exit After X Bars,,None,None,None,None
1640_240906001_B,182,XAUUSD,Buy,2022-05-17 08:00:00,2022-05-17 12:00:00,1829.99,1827.83,1,-216,81520.8,Exit After X Bars,,None,None,None,None
1641_240906001_B,182,XAUUSD,Buy,2022-05-19 12:00:00,2022-05-19 16:00:00,1837.91,1838.19,1,28,81548.8,Exit After X Bars,,None,None,None,None
1646_240906001_B,182,XAUUSD,Buy,2022-06-02 12:00:00,2022-06-02 16:00:00,1857.88,1856.51,1,-137,81411.8,Exit After X Bars,,None,None,None,None
1649_240906001_B,182,XAUUSD,Buy,2022-06-08 16:00:00,2022-06-08 20:00:00,1856.47,1855.32,1,-115,81296.8,Exit After X Bars,,None,None,None,None
1651_240906001_B,182,XAUUSD,Buy,2022-06-10 16:00:00,2022-06-10 20:00:00,1855.74,1871.61,1,1587,82883.8,Exit After X Bars,,None,None,None,None
1654_240906001_B,182,XAUUSD,Buy,2022-06-15 12:00:00,2022-06-15 16:00:00,1832.42,1831.58,1,-84,82799.8,Exit After X Bars,,None,None,None,None
1656_240906001_B,182,XAUUSD,Buy,2022-06-22 12:00:00,2022-06-22 16:00:00,1844.84,1844.59,1,-25,82774.8,Exit After X Bars,,None,None,None,None
1660_240906001_B,182,XAUUSD,Buy,2022-06-29 12:00:00,2022-06-29 16:00:00,1829.81,1831.18,1,137,82911.8,Exit After X Bars,,None,None,None,None
1666_240906001_B,182,XAUUSD,Buy,2022-07-08 16:00:00,2022-07-08 20:00:00,1750.19,1742.24,1,-795,82116.8,Exit After X Bars,,None,None,None,None
1669_240906001_B,182,XAUUSD,Buy,2022-07-13 16:00:00,2022-07-13 20:00:00,1744.8,1737.85,1,-695,81421.8,Exit After X Bars,,None,None,None,None
1671_240906001_B,182,XAUUSD,Buy,2022-07-21 16:00:00,2022-07-21 20:00:00,1715.46,1711.62,1,-384,81037.8,Exit After X Bars,,None,None,None,None
1672_240906001_B,182,XAUUSD,Buy,2022-07-27 20:00:00,2022-07-28 00:00:00,1729.28,1734.05,1,477,81514.8,Exit After X Bars,,None,None,None,None
1676_240906001_B,182,XAUUSD,Buy,2022-08-10 16:00:00,2022-08-10 20:00:00,1801.32,1798.1,1,-322,81192.8,Exit After X Bars,,None,None,None,None
1678_240906001_B,182,XAUUSD,Buy,2022-08-12 20:00:00,2022-08-15 00:00:00,1799.79,1802.31,1,252,81444.8,End Of Friday,,None,None,None,None
1685_240906001_B,182,XAUUSD,Buy,2022-08-23 16:00:00,2022-08-23 20:00:00,1749.89,1749.64,1,-25,81419.8,Exit After X Bars,,None,None,None,None
1690_240906001_B,182,XAUUSD,Buy,2022-09-02 12:00:00,2022-09-02 16:00:00,1709.46,1708.73,1,-73,81346.8,Exit After X Bars,,None,None,None,None
1691_240906001_B,182,XAUUSD,Buy,2022-09-08 12:00:00,2022-09-08 16:00:00,1726.07,1715.66,1,-1041,80305.8,Exit After X Bars,,None,None,None,None
1696_240906001_B,182,XAUUSD,Buy,2022-09-21 20:00:00,2022-09-22 00:00:00,1678.54,1673.04,1,-550,79755.8,Exit After X Bars,,None,None,None,None
1700_240906001_B,182,XAUUSD,Buy,2022-09-28 16:00:00,2022-09-28 20:00:00,1643.39,1659.16,1,1577,81332.8,Exit After X Bars,,None,None,None,None
1712_240906001_B,182,XAUUSD,Buy,2022-10-21 16:00:00,2022-10-21 20:00:00,1646.06,1651.3,1,524,81856.8,Exit After X Bars,,None,None,None,None
1716_240906001_B,182,XAUUSD,Buy,2022-11-14 16:00:00,2022-11-14 20:00:00,1774.12,1770.64,1,-348,81508.8,Exit After X Bars,,None,None,None,None
1721_240906001_B,182,XAUUSD,Buy,2022-11-22 12:00:00,2022-11-22 16:00:00,1748.8,1743.52,1,-528,80980.8,Exit After X Bars,,None,None,None,None
1722_240906001_B,182,XAUUSD,Buy,2022-11-23 20:00:00,2022-11-24 00:00:00,1750.38,1749.33,1,-105,80875.8,Exit After X Bars,,None,None,None,None
1724_240906001_B,182,XAUUSD,Buy,2022-11-28 12:00:00,2022-11-28 16:00:00,1762.94,1753.32,1,-962,79913.8,Exit After X Bars,,None,None,None,None
1725_240906001_B,182,XAUUSD,Buy,2022-11-30 20:00:00,2022-12-01 00:00:00,1765.01,1768.62,1,361,80274.8,Exit After X Bars,,None,None,None,None
1728_240906001_B,182,XAUUSD,Buy,2022-12-07 16:00:00,2022-12-07 20:00:00,1781.74,1782.96,1,122,80396.8,Exit After X Bars,,None,None,None,None
1729_240906001_B,182,XAUUSD,Buy,2022-12-08 12:00:00,2022-12-08 16:00:00,1791.66,1789.41,1,-225,80171.8,Exit After X Bars,,None,None,None,None
1731_240906001_B,182,XAUUSD,Buy,2022-12-13 12:00:00,2022-12-13 16:00:00,1796.23,1810.86,1,1463,81634.8,Exit After X Bars,,None,None,None,None
1736_240906001_B,182,XAUUSD,Buy,2022-12-29 16:00:00,2022-12-29 20:00:00,1814.02,1818.82,1,480,82114.8,Exit After X Bars,,None,None,None,None
1738_240906001_B,182,XAUUSD,Buy,2023-01-06 16:00:00,2023-01-06 20:00:00,1859.96,1862.16,1,220,82334.8,Exit After X Bars,,None,None,None,None
1739_240906001_B,182,XAUUSD,Buy,2023-01-12 12:00:00,2023-01-12 16:00:00,1887.89,1899.53,1,1164,83498.8,Exit After X Bars,,None,None,None,None
1740_240906001_B,182,XAUUSD,Buy,2023-01-13 16:00:00,2023-01-13 20:00:00,1902.99,1916.78,1,1379,84877.8,Exit After X Bars,,None,None,None,None
1742_240906001_B,182,XAUUSD,Buy,2023-01-18 12:00:00,2023-01-18 16:00:00,1917.11,1921.2,1,409,85286.8,Exit After X Bars,,None,None,None,None
1743_240906001_B,182,XAUUSD,Buy,2023-01-19 20:00:00,2023-01-20 00:00:00,1927.44,1931.74,1,430,85716.8,Exit After X Bars,,None,None,None,None
1744_240906001_B,182,XAUUSD,Buy,2023-01-24 08:00:00,2023-01-24 12:00:00,1939.33,1936.08,1,-325,85391.8,Exit After X Bars,,None,None,None,None
1745_240906001_B,182,XAUUSD,Buy,2023-01-25 20:00:00,2023-01-26 00:00:00,1945.11,1946.7,1,159,85550.8,Exit After X Bars,,None,None,None,None
1750_240906001_B,182,XAUUSD,Buy,2023-02-01 20:00:00,2023-02-02 00:00:00,1932.2,1950.39,1,1819,87369.8,Exit After X Bars,,None,None,None,None
1753_240906001_B,182,XAUUSD,Buy,2023-02-07 16:00:00,2023-02-07 20:00:00,1882.57,1880.47,1,-210,87159.8,Exit After X Bars,,None,None,None,None
1756_240906001_B,182,XAUUSD,Buy,2023-02-14 12:00:00,2023-02-14 16:00:00,1867.14,1862.46,1,-468,86691.8,Exit After X Bars,,None,None,None,None
1764_240906001_B,182,XAUUSD,Buy,2023-02-28 16:00:00,2023-02-28 20:00:00,1828.52,1829.15,1,63,86754.8,Exit After X Bars,,None,None,None,None
1767_240906001_B,182,XAUUSD,Buy,2023-03-09 12:00:00,2023-03-09 16:00:00,1825.04,1825.06,1,2,86756.8,Exit After X Bars,,None,None,None,None
1769_240906001_B,182,XAUUSD,Buy,2023-03-17 12:00:00,2023-03-17 16:00:00,1934.2,1944.86,1,1066,87822.8,Exit After X Bars,,None,None,None,None
1771_240906001_B,182,XAUUSD,Buy,2023-03-23 16:00:00,2023-03-23 20:00:00,1986.13,1994.12,1,799,88621.8,Exit After X Bars,,None,None,None,None
1776_240906001_B,182,XAUUSD,Buy,2023-03-30 12:00:00,2023-03-30 16:00:00,1972.61,1970.18,1,-243,88378.8,Exit After X Bars,,None,None,None,None
1777_240906001_B,182,XAUUSD,Buy,2023-04-04 16:00:00,2023-04-04 20:00:00,1990.6,2020.68,1,3008,91386.8,Exit After X Bars,,None,None,None,None
1780_240906001_B,182,XAUUSD,Buy,2023-04-11 16:00:00,2023-04-11 20:00:00,2005.14,2006.04,1,90,91476.8,Exit After X Bars,,None,None,None,None
1784_240906001_B,182,XAUUSD,Buy,2023-04-20 12:00:00,2023-04-20 16:00:00,2008.76,2006.61,1,-215,91261.8,Exit After X Bars,,None,None,None,None
1786_240906001_B,182,XAUUSD,Buy,2023-04-26 16:00:00,2023-04-26 20:00:00,2006.04,1986.49,1,-1955,89306.8,Exit After X Bars,,None,None,None,None
1788_240906001_B,182,XAUUSD,Buy,2023-05-01 12:00:00,2023-05-01 16:00:00,1996.55,2004.07,1,752,90058.8,Exit After X Bars,,None,None,None,None
1789_240906001_B,182,XAUUSD,Buy,2023-05-02 16:00:00,2023-05-02 20:00:00,2006.44,2015.04,1,860,90918.8,Exit After X Bars,,None,None,None,None
1791_240906001_B,182,XAUUSD,Buy,2023-05-09 12:00:00,2023-05-09 16:00:00,2029.94,2026.93,1,-301,90617.8,Exit After X Bars,,None,None,None,None
1800_240906001_B,182,XAUUSD,Buy,2023-05-24 12:00:00,2023-05-24 16:00:00,1984.17,1979.84,1,-433,90184.8,Exit After X Bars,,None,None,None,None
1804_240906001_B,182,XAUUSD,Buy,2023-05-30 12:00:00,2023-05-30 16:00:00,1950.22,1956.33,1,611,90795.8,Exit After X Bars,,None,None,None,None
1806_240906001_B,182,XAUUSD,Buy,2023-06-09 12:00:00,2023-06-09 16:00:00,1971.42,1962.82,1,-860,89935.8,Exit After X Bars,,None,None,None,None
1808_240906001_B,182,XAUUSD,Buy,2023-06-13 12:00:00,2023-06-13 16:00:00,1967.69,1961.33,1,-636,89299.8,Exit After X Bars,,None,None,None,None
1810_240906001_B,182,XAUUSD,Buy,2023-06-16 08:00:00,2023-06-16 12:00:00,1962.05,1963.01,1,96,89395.8,Exit After X Bars,,None,None,None,None
1814_240906001_B,182,XAUUSD,Buy,2023-06-23 16:00:00,2023-06-23 20:00:00,1934.8,1918.59,1,-1621,87774.8,Exit After X Bars,,None,None,None,None
1816_240906001_B,182,XAUUSD,Buy,2023-06-30 16:00:00,2023-06-30 20:00:00,1917.43,1919.9,1,247,88021.8,Exit After X Bars,,None,None,None,None
1818_240906001_B,182,XAUUSD,Buy,2023-07-07 16:00:00,2023-07-07 20:00:00,1928.1,1926.79,1,-131,87890.8,Exit After X Bars,,None,None,None,None
1822_240906001_B,182,XAUUSD,Buy,2023-07-26 08:00:00,2023-07-26 12:00:00,1968.22,1972.0,1,378,88268.8,Exit After X Bars,,None,None,None,None
1824_240906001_B,182,XAUUSD,Buy,2023-07-31 12:00:00,2023-07-31 16:00:00,1964.2,1965.36,1,116,88384.8,Exit After X Bars,,None,None,None,None
1828_240906001_B,182,XAUUSD,Buy,2023-08-04 12:00:00,2023-08-04 16:00:00,1939.47,1938.92,1,-55,88329.8,Exit After X Bars,,None,None,None,None
1838_240906001_B,182,XAUUSD,Buy,2023-09-01 12:00:00,2023-09-01 16:00:00,1948.15,1949.82,1,167,88496.8,Exit After X Bars,,None,None,None,None
1842_240906001_B,182,XAUUSD,Buy,2023-09-08 16:00:00,2023-09-08 20:00:00,1929.49,1919.53,1,-996,87500.8,Exit After X Bars,,None,None,None,None
1846_240906001_B,182,XAUUSD,Buy,2023-09-15 04:00:00,2023-09-15 08:00:00,1916.49,1916.0,1,-49,87451.8,Exit After X Bars,,None,None,None,None
1856_240906001_B,182,XAUUSD,Buy,2023-10-06 16:00:00,2023-10-06 20:00:00,1833.84,1829.1,1,-474,86977.8,Exit After X Bars,,None,None,None,None
1857_240906001_B,182,XAUUSD,Buy,2023-10-17 12:00:00,2023-10-17 16:00:00,1925.92,1925.91,1,-1,86976.8,Exit After X Bars,,None,None,None,None
1860_240906001_B,182,XAUUSD,Buy,2023-10-25 16:00:00,2023-10-25 20:00:00,1981.81,1978.15,1,-366,86610.8,Exit After X Bars,,None,None,None,None
1861_240906001_B,182,XAUUSD,Buy,2023-10-27 20:00:00,2023-10-30 00:00:00,1994.16,2004.14,1,998,87608.8,End Of Friday,,None,None,None,None
1863_240906001_B,182,XAUUSD,Buy,2023-10-31 16:00:00,2023-10-31 20:00:00,2006.13,1990.73,1,-1540,86068.8,Exit After X Bars,,None,None,None,None
1866_240906001_B,182,XAUUSD,Buy,2023-11-03 12:00:00,2023-11-03 16:00:00,1991.37,2000.05,1,868,86936.8,Exit After X Bars,,None,None,None,None
1872_240906001_B,182,XAUUSD,Buy,2023-11-14 16:00:00,2023-11-14 20:00:00,1961.96,1962.07,1,11,86947.8,Exit After X Bars,,None,None,None,None
1874_240906001_B,182,XAUUSD,Buy,2023-11-24 12:00:00,2023-11-24 16:00:00,1999.11,1999.55,1,44,86991.8,Exit After X Bars,,None,None,None,None
1876_240906001_B,182,XAUUSD,Buy,2023-12-01 16:00:00,2023-12-01 20:00:00,2048.57,2067.21,1,1864,88855.8,Exit After X Bars,,None,None,None,None
1880_240906001_B,182,XAUUSD,Buy,2023-12-07 12:00:00,2023-12-07 16:00:00,2036.66,2037.07,1,41,88896.8,Exit After X Bars,,None,None,None,None
1884_240906001_B,182,XAUUSD,Buy,2023-12-13 20:00:00,2023-12-14 00:00:00,1997.41,2025.95,1,2854,91750.8,Exit After X Bars,,None,None,None,None
1886_240906001_B,182,XAUUSD,Buy,2023-12-19 16:00:00,2023-12-19 20:00:00,2034.58,2040.32,1,574,92324.8,Exit After X Bars,,None,None,None,None
1887_240906001_B,182,XAUUSD,Buy,2023-12-21 20:00:00,2023-12-22 00:00:00,2044.04,2048.41,1,437,92761.8,Exit After X Bars,,None,None,None,None
1893_240906001_B,182,XAUUSD,Buy,2024-01-05 16:00:00,2024-01-05 20:00:00,2051.94,2041.84,1,-1010,91751.8,Exit After X Bars,,None,None,None,None
1896_240906001_B,182,XAUUSD,Buy,2024-01-11 12:00:00,2024-01-11 16:00:00,2043.38,2029.37,1,-1401,90350.8,Exit After X Bars,,None,None,None,None
1899_240906001_B,182,XAUUSD,Buy,2024-01-19 12:00:00,2024-01-19 16:00:00,2034.24,2035.14,1,90,90440.8,Exit After X Bars,,None,None,None,None
1901_240906001_B,182,XAUUSD,Buy,2024-01-24 08:00:00,2024-01-24 12:00:00,2030.73,2030.74,1,1,90441.8,Exit After X Bars,,None,None,None,None
1905_240906001_B,182,XAUUSD,Buy,2024-02-07 16:00:00,2024-02-07 20:00:00,2039.26,2035.56,1,-370,90071.8,Exit After X Bars,,None,None,None,None
1909_240906001_B,182,XAUUSD,Buy,2024-02-13 12:00:00,2024-02-13 16:00:00,2028.08,2004.31,1,-2377,87694.8,Exit After X Bars,,None,None,None,None
1911_240906001_B,182,XAUUSD,Buy,2024-02-15 12:00:00,2024-02-15 16:00:00,1996.59,2003.72,1,713,88407.8,Exit After X Bars,,None,None,None,None
1912_240906001_B,182,XAUUSD,Buy,2024-02-23 16:00:00,2024-02-23 20:00:00,2035.74,2037.91,1,217,88624.8,Exit After X Bars,,None,None,None,None
1913_240906001_B,182,XAUUSD,Buy,2024-02-29 12:00:00,2024-02-29 16:00:00,2040.29,2047.56,1,727,89351.8,Exit After X Bars,,None,None,None,None
1921_240906001_B,182,XAUUSD,Buy,2024-03-20 16:00:00,2024-03-20 20:00:00,2163.56,2157.61,1,-595,88756.8,Exit After X Bars,,None,None,None,None
1924_240906001_B,182,XAUUSD,Buy,2024-03-26 12:00:00,2024-03-26 16:00:00,2181.85,2187.85,1,600,89356.8,Exit After X Bars,,None,None,None,None
1925_240906001_B,182,XAUUSD,Buy,2024-03-28 12:00:00,2024-03-28 16:00:00,2200.69,2215.62,1,1493,90849.8,Exit After X Bars,,None,None,None,None
1926_240906001_B,182,XAUUSD,Buy,2024-04-04 20:00:00,2024-04-05 00:00:00,2304.48,2290.13,1,-1435,89414.8,Exit After X Bars,,None,None,None,None
1927_240906001_B,182,XAUUSD,Buy,2024-04-05 16:00:00,2024-04-05 20:00:00,2307.53,2327.17,1,1964,91378.8,Exit After X Bars,,None,None,None,None
1929_240906001_B,182,XAUUSD,Buy,2024-04-11 20:00:00,2024-04-12 00:00:00,2360.86,2371.5,1,1064,92442.8,Exit After X Bars,,None,None,None,None
1932_240906001_B,182,XAUUSD,Buy,2024-04-19 04:00:00,2024-04-19 08:00:00,2397.16,2383.48,1,-1368,91074.8,Exit After X Bars,,None,None,None,None
1935_240906001_B,182,XAUUSD,Buy,2024-04-24 16:00:00,2024-04-24 20:00:00,2335.02,2324.97,1,-1005,90069.8,Exit After X Bars,,None,None,None,None
1936_240906001_B,182,XAUUSD,Buy,2024-04-25 16:00:00,2024-04-25 20:00:00,2338.08,2328.62,1,-946,89123.8,Exit After X Bars,,None,None,None,None
1939_240906001_B,182,XAUUSD,Buy,2024-05-06 12:00:00,2024-05-06 16:00:00,2323.39,2323.15,1,-24,89099.8,Exit After X Bars,,None,None,None,None
1941_240906001_B,182,XAUUSD,Buy,2024-05-09 12:00:00,2024-05-09 16:00:00,2321.96,2326.59,1,463,89562.8,Exit After X Bars,,None,None,None,None
1943_240906001_B,182,XAUUSD,Buy,2024-05-15 08:00:00,2024-05-15 12:00:00,2364.99,2373.09,1,810,90372.8,Exit After X Bars,,None,None,None,None
1944_240906001_B,182,XAUUSD,Buy,2024-05-17 16:00:00,2024-05-17 20:00:00,2397.97,2407.73,1,976,91348.8,Exit After X Bars,,None,None,None,None
1949_240906001_B,182,XAUUSD,Buy,2024-05-27 12:00:00,2024-05-27 16:00:00,2349.02,2347.06,1,-196,91152.8,Exit After X Bars,,None,None,None,None
1950_240906001_B,182,XAUUSD,Buy,2024-05-28 20:00:00,2024-05-29 00:00:00,2361.08,2360.19,1,-89,91063.8,Exit After X Bars,,None,None,None,None
1955_240906001_B,182,XAUUSD,Buy,2024-06-05 16:00:00,2024-06-05 20:00:00,2352.92,2352.47,1,-45,91018.8,Exit After X Bars,,None,None,None,None
1958_240906001_B,182,XAUUSD,Buy,2024-06-11 12:00:00,2024-06-11 16:00:00,2314.4,2317.84,1,344,91362.8,Exit After X Bars,,None,None,None,None
1960_240906001_B,182,XAUUSD,Buy,2024-06-14 12:00:00,2024-06-14 16:00:00,2327.32,2330.23,1,291,91653.8,Exit After X Bars,,None,None,None,None
1961_240906001_B,182,XAUUSD,Buy,2024-06-18 20:00:00,2024-06-19 00:00:00,2331.42,2328.59,1,-283,91370.8,Exit After X Bars,,None,None,None,None
1963_240906001_B,182,XAUUSD,Buy,2024-06-25 12:00:00,2024-06-25 16:00:00,2335.85,2324.05,1,-1180,90190.8,Exit After X Bars,,None,None,None,None
1965_240906001_B,182,XAUUSD,Buy,2024-06-27 12:00:00,2024-06-27 16:00:00,2322.2,2322.74,1,54,90244.8,Exit After X Bars,,None,None,None,None
1968_240906001_B,182,XAUUSD,Buy,2024-07-11 12:00:00,2024-07-11 16:00:00,2387.35,2406.19,1,1884,92128.8,Exit After X Bars,,None,None,None,None
1969_240906001_B,182,XAUUSD,Buy,2024-07-15 12:00:00,2024-07-15 16:00:00,2419.99,2414.69,1,-530,91598.8,Exit After X Bars,,None,None,None,None
1970_240906001_B,182,XAUUSD,Buy,2024-07-16 12:00:00,2024-07-16 16:00:00,2440.2,2432.44,1,-776,90822.8,Exit After X Bars,,None,None,None,None
1974_240906001_B,182,XAUUSD,Buy,2024-07-24 04:00:00,2024-07-24 08:00:00,2413.13,2417.71,1,458,91280.8,Exit After X Bars,,None,None,None,None
1980_240906001_B,182,XAUUSD,Buy,2024-08-08 12:00:00,2024-08-08 16:00:00,2408.43,2407.93,1,-50,91230.8,Exit After X Bars,,None,None,None,None
1982_240906001_B,182,XAUUSD,Buy,2024-08-16 12:00:00,2024-08-16 16:00:00,2471.03,2491.56,1,2053,93283.8,Exit After X Bars,,None,None,None,None
1985_240906001_B,182,XAUUSD,Buy,2024-08-23 16:00:00,2024-08-23 20:00:00,2515.51,2510.2,1,-531,92752.8,Exit After X Bars,,None,None,None,None
1986_240906001_B,182,XAUUSD,Buy,2024-08-28 00:00:00,2024-08-28 04:00:00,2527.82,2524.28,1,-354,92398.8,Exit After X Bars,,None,None,None,None
1987_240906001_B,182,XAUUSD,Buy,2024-08-29 16:00:00,2024-08-29 20:00:00,2526.54,2525.14,1,-140,92258.8,Exit After X Bars,,None,None,None,None
