orderId,strategyRunId,symbol,orderType,openTime,closeTime,openPrice,closePrice,size,profit,balance,closeType,comment,sl,tp,swap,commission
4_240906005_B,186,XAUUSD,Buy,2011-01-07 16:00:00,2011-01-07 20:00:00,1377.02,1367.74,1,-928,9072,Exit After X Bars,,None,None,None,None
5_240906005_B,186,XAUUSD,Buy,2011-01-11 08:00:00,2011-01-11 12:00:00,1378.75,1378.29,1,-46,9026,Exit After X Bars,,None,None,None,None
7_240906005_B,186,XAUUSD,Buy,2011-01-18 08:00:00,2011-01-18 12:00:00,1370.15,1370.18,1,3,9029,Exit After X Bars,,None,None,None,None
12_240906005_B,186,XAUUSD,Buy,2011-01-26 20:00:00,2011-01-27 00:00:00,1335.12,1345.98,1,1086,10115,Exit After X Bars,,None,None,None,None
13_240906005_B,186,XAUUSD,Buy,2011-01-28 16:00:00,2011-01-28 20:00:00,1340.83,1343.01,1,218,10333,Exit After X Bars,,None,None,None,None
14_240906005_B,186,XAUUSD,Buy,2011-02-03 16:00:00,2011-02-03 20:00:00,1339.46,1353.88,1,1442,11775,Exit After X Bars,,None,None,None,None
15_240906005_B,186,XAUUSD,Buy,2011-02-11 12:00:00,2011-02-11 16:00:00,1366.9,1365.53,1,-137,11638,Exit After X Bars,,None,None,None,None
16_240906005_B,186,XAUUSD,Buy,2011-02-15 08:00:00,2011-02-15 12:00:00,1368.35,1371.67,1,332,11970,Exit After X Bars,,None,None,None,None
17_240906005_B,186,XAUUSD,Buy,2011-02-23 16:00:00,2011-02-23 20:00:00,1406.38,1415.25,1,887,12857,Exit After X Bars,,None,None,None,None
19_240906005_B,186,XAUUSD,Buy,2011-03-01 12:00:00,2011-03-01 16:00:00,1415.8,1419.47,1,367,13224,Exit After X Bars,,None,None,None,None
21_240906005_B,186,XAUUSD,Buy,2011-03-04 16:00:00,2011-03-04 20:00:00,1431.96,1427.88,1,-408,12816,Exit After X Bars,,None,None,None,None
28_240906005_B,186,XAUUSD,Buy,2011-03-18 00:00:00,2011-03-18 04:00:00,1406.02,1406.99,1,97,12913,Exit After X Bars,,None,None,None,None
31_240906005_B,186,XAUUSD,Buy,2011-03-29 16:00:00,2011-03-29 20:00:00,1423.21,1416.52,1,-669,12244,Exit After X Bars,,None,None,None,None
32_240906005_B,186,XAUUSD,Buy,2011-03-30 12:00:00,2011-03-30 16:00:00,1423.25,1428.01,1,476,12720,Exit After X Bars,,None,None,None,None
36_240906005_B,186,XAUUSD,Buy,2011-04-14 16:00:00,2011-04-14 20:00:00,1462.02,1471.83,1,981,13701,Exit After X Bars,,None,None,None,None
37_240906005_B,186,XAUUSD,Buy,2011-04-22 12:00:00,2011-04-22 16:00:00,1508.96,1508.04,1,-92,13609,Exit After X Bars,,None,None,None,None
39_240906005_B,186,XAUUSD,Buy,2011-04-27 16:00:00,2011-04-27 20:00:00,1509.97,1512.16,1,219,13828,Exit After X Bars,,None,None,None,None
47_240906005_B,186,XAUUSD,Buy,2011-05-18 16:00:00,2011-05-18 20:00:00,1496.72,1495.8,1,-92,13736,Exit After X Bars,,None,None,None,None
48_240906005_B,186,XAUUSD,Buy,2011-05-27 16:00:00,2011-05-27 20:00:00,1532.18,1537.36,1,518,14254,Exit After X Bars,,None,None,None,None
49_240906005_B,186,XAUUSD,Buy,2011-06-01 16:00:00,2011-06-01 20:00:00,1540.72,1545.4,1,468,14722,Exit After X Bars,,None,None,None,None
50_240906005_B,186,XAUUSD,Buy,2011-06-03 16:00:00,2011-06-03 20:00:00,1544.39,1541.86,1,-253,14469,Exit After X Bars,,None,None,None,None
53_240906005_B,186,XAUUSD,Buy,2011-06-09 16:00:00,2011-06-09 20:00:00,1543.0,1544.6,1,160,14629,Exit After X Bars,,None,None,None,None
57_240906005_B,186,XAUUSD,Buy,2011-06-15 16:00:00,2011-06-15 20:00:00,1527.25,1524.58,1,-267,14362,Exit After X Bars,,None,None,None,None
58_240906005_B,186,XAUUSD,Buy,2011-06-17 16:00:00,2011-06-17 20:00:00,1532.86,1534.88,1,202,14564,Exit After X Bars,,None,None,None,None
62_240906005_B,186,XAUUSD,Buy,2011-06-28 12:00:00,2011-06-28 16:00:00,1503.24,1500.35,1,-289,14275,Exit After X Bars,,None,None,None,None
64_240906005_B,186,XAUUSD,Buy,2011-07-04 16:00:00,2011-07-04 20:00:00,1494.8,1495.57,1,77,14352,Exit After X Bars,,None,None,None,None
68_240906005_B,186,XAUUSD,Buy,2011-07-22 12:00:00,2011-07-22 16:00:00,1601.98,1602.23,1,25,14377,Exit After X Bars,,None,None,None,None
69_240906005_B,186,XAUUSD,Buy,2011-07-27 00:00:00,2011-07-27 04:00:00,1621.56,1622.23,1,67,14444,Exit After X Bars,,None,None,None,None
71_240906005_B,186,XAUUSD,Buy,2011-07-29 12:00:00,2011-07-29 16:00:00,1619.96,1623.19,1,323,14767,Exit After X Bars,,None,None,None,None
73_240906005_B,186,XAUUSD,Buy,2011-08-02 12:00:00,2011-08-02 16:00:00,1631.85,1637.39,1,554,15321,Exit After X Bars,,None,None,None,None
76_240906005_B,186,XAUUSD,Buy,2011-08-15 20:00:00,2011-08-16 00:00:00,1764.05,1765.36,1,131,15452,Exit After X Bars,,None,None,None,None
77_240906005_B,186,XAUUSD,Buy,2011-08-18 12:00:00,2011-08-18 16:00:00,1794.66,1816.92,1,2226,17678,Exit After X Bars,,None,None,None,None
81_240906005_B,186,XAUUSD,Buy,2011-08-26 16:00:00,2011-08-26 20:00:00,1774.52,1786.25,1,1173,18851,Exit After X Bars,,None,None,None,None
82_240906005_B,186,XAUUSD,Buy,2011-08-30 12:00:00,2011-08-30 16:00:00,1822.49,1825.21,1,272,19123,Exit After X Bars,,None,None,None,None
83_240906005_B,186,XAUUSD,Buy,2011-09-02 08:00:00,2011-09-02 12:00:00,1839.8,1849.95,1,1015,20138,Exit After X Bars,,None,None,None,None
85_240906005_B,186,XAUUSD,Buy,2011-09-08 12:00:00,2011-09-08 16:00:00,1846.7,1858.15,1,1145,21283,Exit After X Bars,,None,None,None,None
91_240906005_B,186,XAUUSD,Buy,2011-09-16 16:00:00,2011-09-16 20:00:00,1815.51,1813.72,1,-179,21104,Exit After X Bars,,None,None,None,None
102_240906005_B,186,XAUUSD,Buy,2011-10-21 12:00:00,2011-10-21 16:00:00,1630.32,1642.71,1,1239,22343,Exit After X Bars,,None,None,None,None
104_240906005_B,186,XAUUSD,Buy,2011-11-02 04:00:00,2011-11-02 08:00:00,1727.68,1721.86,1,-582,21761,Exit After X Bars,,None,None,None,None
105_240906005_B,186,XAUUSD,Buy,2011-11-03 12:00:00,2011-11-03 16:00:00,1744.15,1761.62,1,1747,23508,Exit After X Bars,,None,None,None,None
108_240906005_B,186,XAUUSD,Buy,2011-11-11 16:00:00,2011-11-11 20:00:00,1775.29,1786.78,1,1149,24657,Exit After X Bars,,None,None,None,None
120_240906005_B,186,XAUUSD,Buy,2011-12-07 12:00:00,2011-12-07 16:00:00,1732.92,1733.37,1,45,24702,Exit After X Bars,,None,None,None,None
126_240906005_B,186,XAUUSD,Buy,2011-12-16 16:00:00,2011-12-16 20:00:00,1593.85,1593.08,1,-77,24625,Exit After X Bars,,None,None,None,None
131_240906005_B,186,XAUUSD,Buy,2012-01-16 12:00:00,2012-01-16 16:00:00,1644.46,1642.75,1,-171,24454,Exit After X Bars,,None,None,None,None
132_240906005_B,186,XAUUSD,Buy,2012-01-19 08:00:00,2012-01-19 12:00:00,1666.74,1665.42,1,-132,24322,Exit After X Bars,,None,None,None,None
133_240906005_B,186,XAUUSD,Buy,2012-01-20 16:00:00,2012-01-20 20:00:00,1665.68,1663.26,1,-242,24080,Exit After X Bars,,None,None,None,None
135_240906005_B,186,XAUUSD,Buy,2012-01-25 16:00:00,2012-01-25 20:00:00,1670.87,1689.7,1,1883,25963,Exit After X Bars,,None,None,None,None
136_240906005_B,186,XAUUSD,Buy,2012-01-31 08:00:00,2012-01-31 12:00:00,1739.39,1742.51,1,312,26275,Exit After X Bars,,None,None,None,None
137_240906005_B,186,XAUUSD,Buy,2012-02-02 16:00:00,2012-02-02 20:00:00,1751.95,1755.07,1,312,26587,Exit After X Bars,,None,None,None,None
140_240906005_B,186,XAUUSD,Buy,2012-02-07 16:00:00,2012-02-07 20:00:00,1725.18,1746.27,1,2109,28696,Exit After X Bars,,None,None,None,None
142_240906005_B,186,XAUUSD,Buy,2012-02-09 16:00:00,2012-02-09 20:00:00,1748.57,1739.26,1,-931,27765,Exit After X Bars,,None,None,None,None
144_240906005_B,186,XAUUSD,Buy,2012-02-13 16:00:00,2012-02-13 20:00:00,1724.3,1723.02,1,-128,27637,Exit After X Bars,,None,None,None,None
146_240906005_B,186,XAUUSD,Buy,2012-02-15 12:00:00,2012-02-15 16:00:00,1727.68,1730.85,1,317,27954,Exit After X Bars,,None,None,None,None
149_240906005_B,186,XAUUSD,Buy,2012-02-28 12:00:00,2012-02-28 16:00:00,1779.36,1780.06,1,70,28024,Exit After X Bars,,None,None,None,None
154_240906005_B,186,XAUUSD,Buy,2012-03-08 08:00:00,2012-03-08 12:00:00,1692.98,1701.02,1,804,28828,Exit After X Bars,,None,None,None,None
160_240906005_B,186,XAUUSD,Buy,2012-03-23 16:00:00,2012-03-23 20:00:00,1661.85,1662.57,1,72,28900,Exit After X Bars,,None,None,None,None
162_240906005_B,186,XAUUSD,Buy,2012-03-30 12:00:00,2012-03-30 16:00:00,1663.77,1665.58,1,181,29081,Exit After X Bars,,None,None,None,None
165_240906005_B,186,XAUUSD,Buy,2012-04-06 12:00:00,2012-04-06 16:00:00,1633.42,1641.71,1,829,29910,Exit After X Bars,,None,None,None,None
169_240906005_B,186,XAUUSD,Buy,2012-04-19 16:00:00,2012-04-19 20:00:00,1648.84,1639.67,1,-917,28993,Exit After X Bars,,None,None,None,None
172_240906005_B,186,XAUUSD,Buy,2012-04-24 12:00:00,2012-04-24 16:00:00,1639.15,1642.25,1,310,29303,Exit After X Bars,,None,None,None,None
173_240906005_B,186,XAUUSD,Buy,2012-05-01 00:00:00,2012-05-01 04:00:00,1667.35,1665.58,1,-177,29126,Exit After X Bars,,None,None,None,None
180_240906005_B,186,XAUUSD,Buy,2012-05-10 16:00:00,2012-05-10 20:00:00,1595.9,1595.78,1,-12,29114,Exit After X Bars,,None,None,None,None
184_240906005_B,186,XAUUSD,Buy,2012-05-17 16:00:00,2012-05-17 20:00:00,1564.09,1576.13,1,1204,30318,Exit After X Bars,,None,None,None,None
186_240906005_B,186,XAUUSD,Buy,2012-05-24 12:00:00,2012-05-24 16:00:00,1564.62,1575.66,1,1104,31422,Exit After X Bars,,None,None,None,None
189_240906005_B,186,XAUUSD,Buy,2012-06-01 12:00:00,2012-06-01 16:00:00,1573.33,1581.44,1,811,32233,Exit After X Bars,,None,None,None,None
192_240906005_B,186,XAUUSD,Buy,2012-06-11 12:00:00,2012-06-11 16:00:00,1595.05,1593.62,1,-143,32090,Exit After X Bars,,None,None,None,None
193_240906005_B,186,XAUUSD,Buy,2012-06-12 16:00:00,2012-06-12 20:00:00,1601.12,1611.94,1,1082,33172,Exit After X Bars,,None,None,None,None
194_240906005_B,186,XAUUSD,Buy,2012-06-19 08:00:00,2012-06-19 12:00:00,1632.47,1629.85,1,-262,32910,Exit After X Bars,,None,None,None,None
198_240906005_B,186,XAUUSD,Buy,2012-06-25 16:00:00,2012-06-25 20:00:00,1573.35,1583.29,1,994,33904,Exit After X Bars,,None,None,None,None
201_240906005_B,186,XAUUSD,Buy,2012-06-29 12:00:00,2012-06-29 16:00:00,1573.55,1597.36,1,2381,36285,Exit After X Bars,,None,None,None,None
204_240906005_B,186,XAUUSD,Buy,2012-07-10 12:00:00,2012-07-10 16:00:00,1592.85,1600.83,1,798,37083,Exit After X Bars,,None,None,None,None
208_240906005_B,186,XAUUSD,Buy,2012-07-19 12:00:00,2012-07-19 16:00:00,1583.15,1584.15,1,100,37183,Exit After X Bars,,None,None,None,None
211_240906005_B,186,XAUUSD,Buy,2012-07-24 16:00:00,2012-07-24 20:00:00,1580.35,1575.79,1,-456,36727,Exit After X Bars,,None,None,None,None
216_240906005_B,186,XAUUSD,Buy,2012-08-09 20:00:00,2012-08-10 00:00:00,1616.78,1616.66,1,-12,36715,Exit After X Bars,,None,None,None,None
217_240906005_B,186,XAUUSD,Buy,2012-08-10 16:00:00,2012-08-10 20:00:00,1618.35,1621.52,1,317,37032,Exit After X Bars,,None,None,None,None
220_240906005_B,186,XAUUSD,Buy,2012-08-16 12:00:00,2012-08-16 16:00:00,1606.46,1607.65,1,119,37151,Exit After X Bars,,None,None,None,None
224_240906005_B,186,XAUUSD,Buy,2012-08-31 16:00:00,2012-08-31 20:00:00,1664.1,1681.56,1,1746,38897,Exit After X Bars,,None,None,None,None
225_240906005_B,186,XAUUSD,Buy,2012-09-06 08:00:00,2012-09-06 12:00:00,1698.9,1709.11,1,1021,39918,Exit After X Bars,,None,None,None,None
226_240906005_B,186,XAUUSD,Buy,2012-09-07 12:00:00,2012-09-07 16:00:00,1713.68,1724.79,1,1111,41029,Exit After X Bars,,None,None,None,None
227_240906005_B,186,XAUUSD,Buy,2012-09-13 16:00:00,2012-09-13 20:00:00,1745.58,1752.67,1,709,41738,Exit After X Bars,,None,None,None,None
228_240906005_B,186,XAUUSD,Buy,2012-09-18 16:00:00,2012-09-18 20:00:00,1773.27,1766.65,1,-662,41076,Exit After X Bars,,None,None,None,None
234_240906005_B,186,XAUUSD,Buy,2012-09-27 12:00:00,2012-09-27 16:00:00,1765.55,1764.21,1,-134,40942,Exit After X Bars,,None,None,None,None
235_240906005_B,186,XAUUSD,Buy,2012-10-01 12:00:00,2012-10-01 16:00:00,1783.16,1784.74,1,158,41100,Exit After X Bars,,None,None,None,None
236_240906005_B,186,XAUUSD,Buy,2012-10-04 08:00:00,2012-10-04 12:00:00,1784.26,1785.03,1,77,41177,Exit After X Bars,,None,None,None,None
239_240906005_B,186,XAUUSD,Buy,2012-10-09 12:00:00,2012-10-09 16:00:00,1778.04,1774.13,1,-391,40786,Exit After X Bars,,None,None,None,None
241_240906005_B,186,XAUUSD,Buy,2012-10-11 16:00:00,2012-10-11 20:00:00,1768.17,1769.56,1,139,40925,Exit After X Bars,,None,None,None,None
244_240906005_B,186,XAUUSD,Buy,2012-10-17 00:00:00,2012-10-17 04:00:00,1748.76,1750.45,1,169,41094,Exit After X Bars,,None,None,None,None
250_240906005_B,186,XAUUSD,Buy,2012-10-26 16:00:00,2012-10-26 20:00:00,1717.95,1712.97,1,-498,40596,Exit After X Bars,,None,None,None,None
254_240906005_B,186,XAUUSD,Buy,2012-11-14 16:00:00,2012-11-14 20:00:00,1733.05,1729.65,1,-340,40256,Exit After X Bars,,None,None,None,None
257_240906005_B,186,XAUUSD,Buy,2012-11-23 16:00:00,2012-11-23 20:00:00,1735.55,1750.79,1,1524,41780,Exit After X Bars,,None,None,None,None
260_240906005_B,186,XAUUSD,Buy,2012-11-30 12:00:00,2012-11-30 16:00:00,1728.37,1723.27,1,-510,41270,Exit After X Bars,,None,None,None,None
265_240906005_B,186,XAUUSD,Buy,2012-12-07 20:00:00,2012-12-10 00:00:00,1703.23,1704.07,1,84,41354,End Of Friday,,None,None,None,None
268_240906005_B,186,XAUUSD,Buy,2012-12-17 16:00:00,2012-12-17 20:00:00,1699.16,1696.31,1,-285,41069,Exit After X Bars,,None,None,None,None
273_240906005_B,186,XAUUSD,Buy,2013-01-07 12:00:00,2013-01-07 16:00:00,1658.65,1646.09,1,-1256,39813,Exit After X Bars,,None,None,None,None
274_240906005_B,186,XAUUSD,Buy,2013-01-08 16:00:00,2013-01-08 20:00:00,1658.9,1659.3,1,40,39853,Exit After X Bars,,None,None,None,None
279_240906005_B,186,XAUUSD,Buy,2013-02-01 16:00:00,2013-02-01 20:00:00,1677.28,1671.47,1,-581,39272,Exit After X Bars,,None,None,None,None
280_240906005_B,186,XAUUSD,Buy,2013-02-05 12:00:00,2013-02-05 16:00:00,1682.07,1682.95,1,88,39360,Exit After X Bars,,None,None,None,None
284_240906005_B,186,XAUUSD,Buy,2013-02-13 12:00:00,2013-02-13 16:00:00,1653.35,1651.73,1,-162,39198,Exit After X Bars,,None,None,None,None
299_240906005_B,186,XAUUSD,Buy,2013-03-27 16:00:00,2013-03-27 20:00:00,1600.93,1605.55,1,462,39660,Exit After X Bars,,None,None,None,None
305_240906005_B,186,XAUUSD,Buy,2013-04-05 12:00:00,2013-04-05 16:00:00,1556.79,1568.42,1,1163,40823,Exit After X Bars,,None,None,None,None
311_240906005_B,186,XAUUSD,Buy,2013-04-18 12:00:00,2013-04-18 16:00:00,1395.04,1394.75,1,-29,40794,Exit After X Bars,,None,None,None,None
312_240906005_B,186,XAUUSD,Buy,2013-05-02 16:00:00,2013-05-02 20:00:00,1472.23,1468.85,1,-338,40456,Exit After X Bars,,None,None,None,None
314_240906005_B,186,XAUUSD,Buy,2013-05-08 12:00:00,2013-05-08 16:00:00,1465.57,1466.24,1,67,40523,Exit After X Bars,,None,None,None,None
321_240906005_B,186,XAUUSD,Buy,2013-05-20 16:00:00,2013-05-20 20:00:00,1383.75,1384.75,1,100,40623,Exit After X Bars,,None,None,None,None
323_240906005_B,186,XAUUSD,Buy,2013-05-30 04:00:00,2013-05-30 08:00:00,1396.57,1395.21,1,-136,40487,Exit After X Bars,,None,None,None,None
324_240906005_B,186,XAUUSD,Buy,2013-06-03 16:00:00,2013-06-03 20:00:00,1415.79,1412.84,1,-295,40192,Exit After X Bars,,None,None,None,None
326_240906005_B,186,XAUUSD,Buy,2013-06-06 16:00:00,2013-06-06 20:00:00,1410.52,1416.45,1,593,40785,Exit After X Bars,,None,None,None,None
330_240906005_B,186,XAUUSD,Buy,2013-06-12 16:00:00,2013-06-12 20:00:00,1380.91,1390.86,1,995,41780,Exit After X Bars,,None,None,None,None
341_240906005_B,186,XAUUSD,Buy,2013-07-09 04:00:00,2013-07-09 08:00:00,1243.28,1254.4,1,1112,42892,Exit After X Bars,,None,None,None,None
345_240906005_B,186,XAUUSD,Buy,2013-07-29 12:00:00,2013-07-29 16:00:00,1334.17,1328.71,1,-546,42346,Exit After X Bars,,None,None,None,None
346_240906005_B,186,XAUUSD,Buy,2013-07-31 04:00:00,2013-07-31 08:00:00,1338.26,1333.29,1,-497,41849,Exit After X Bars,,None,None,None,None
351_240906005_B,186,XAUUSD,Buy,2013-08-08 08:00:00,2013-08-08 12:00:00,1296.76,1289.08,1,-768,41081,Exit After X Bars,,None,None,None,None
352_240906005_B,186,XAUUSD,Buy,2013-08-15 00:00:00,2013-08-15 04:00:00,1336.33,1341.41,1,508,41589,Exit After X Bars,,None,None,None,None
354_240906005_B,186,XAUUSD,Buy,2013-08-21 20:00:00,2013-08-22 00:00:00,1377.51,1366.09,1,-1142,40447,Exit After X Bars,,None,None,None,None
355_240906005_B,186,XAUUSD,Buy,2013-08-22 16:00:00,2013-08-22 20:00:00,1378.99,1371.75,1,-724,39723,Exit After X Bars,,None,None,None,None
356_240906005_B,186,XAUUSD,Buy,2013-08-23 16:00:00,2013-08-23 20:00:00,1381.71,1395.8,1,1409,41132,Exit After X Bars,,None,None,None,None
360_240906005_B,186,XAUUSD,Buy,2013-09-03 12:00:00,2013-09-03 16:00:00,1395.16,1398.01,1,285,41417,Exit After X Bars,,None,None,None,None
371_240906005_B,186,XAUUSD,Buy,2013-09-18 20:00:00,2013-09-19 00:00:00,1323.61,1362.63,1,3902,45319,Exit After X Bars,,None,None,None,None
373_240906005_B,186,XAUUSD,Buy,2013-09-25 16:00:00,2013-09-25 20:00:00,1330.21,1337.14,1,693,46012,Exit After X Bars,,None,None,None,None
374_240906005_B,186,XAUUSD,Buy,2013-09-27 12:00:00,2013-09-27 16:00:00,1338.16,1335.57,1,-259,45753,Exit After X Bars,,None,None,None,None
377_240906005_B,186,XAUUSD,Buy,2013-10-04 12:00:00,2013-10-04 16:00:00,1323.82,1317.36,1,-646,45107,Exit After X Bars,,None,None,None,None
382_240906005_B,186,XAUUSD,Buy,2013-10-17 08:00:00,2013-10-17 12:00:00,1289.92,1305.41,1,1549,46656,Exit After X Bars,,None,None,None,None
384_240906005_B,186,XAUUSD,Buy,2013-10-30 12:00:00,2013-10-30 16:00:00,1352.94,1354.15,1,121,46777,Exit After X Bars,,None,None,None,None
389_240906005_B,186,XAUUSD,Buy,2013-11-06 12:00:00,2013-11-06 16:00:00,1319.82,1316.76,1,-306,46471,Exit After X Bars,,None,None,None,None
394_240906005_B,186,XAUUSD,Buy,2013-11-14 00:00:00,2013-11-14 04:00:00,1285.32,1282.24,1,-308,46163,Exit After X Bars,,None,None,None,None
399_240906005_B,186,XAUUSD,Buy,2013-11-25 20:00:00,2013-11-26 00:00:00,1248.95,1251.21,1,226,46389,Exit After X Bars,,None,None,None,None
402_240906005_B,186,XAUUSD,Buy,2013-12-04 12:00:00,2013-12-04 16:00:00,1226.14,1225.9,1,-24,46365,Exit After X Bars,,None,None,None,None
405_240906005_B,186,XAUUSD,Buy,2013-12-16 16:00:00,2013-12-16 20:00:00,1238.62,1246.12,1,750,47115,Exit After X Bars,,None,None,None,None
407_240906005_B,186,XAUUSD,Buy,2013-12-18 20:00:00,2013-12-19 00:00:00,1243.04,1218.09,1,-2495,44620,Exit After X Bars,,None,None,None,None
411_240906005_B,186,XAUUSD,Buy,2013-12-24 16:00:00,2013-12-24 20:00:00,1203.91,1203.84,1,-7,44613,Exit After X Bars,,None,None,None,None
413_240906005_B,186,XAUUSD,Buy,2013-12-31 16:00:00,2013-12-31 20:00:00,1208.48,1204.8,1,-368,44245,Exit After X Bars,,None,None,None,None
415_240906005_B,186,XAUUSD,Buy,2014-01-10 04:00:00,2014-01-10 08:00:00,1231.89,1236.55,1,466,44711,Exit After X Bars,,None,None,None,None
417_240906005_B,186,XAUUSD,Buy,2014-01-16 16:00:00,2014-01-16 20:00:00,1242.5,1241.14,1,-136,44575,Exit After X Bars,,None,None,None,None
418_240906005_B,186,XAUUSD,Buy,2014-01-17 12:00:00,2014-01-17 16:00:00,1245.2,1248.12,1,292,44867,Exit After X Bars,,None,None,None,None
422_240906005_B,186,XAUUSD,Buy,2014-01-29 12:00:00,2014-01-29 16:00:00,1261.42,1266.85,1,543,45410,Exit After X Bars,,None,None,None,None
425_240906005_B,186,XAUUSD,Buy,2014-02-03 16:00:00,2014-02-03 20:00:00,1254.91,1259.36,1,445,45855,Exit After X Bars,,None,None,None,None
426_240906005_B,186,XAUUSD,Buy,2014-02-05 12:00:00,2014-02-05 16:00:00,1266.24,1265.41,1,-83,45772,Exit After X Bars,,None,None,None,None
429_240906005_B,186,XAUUSD,Buy,2014-02-20 20:00:00,2014-02-21 00:00:00,1322.02,1322.82,1,80,45852,Exit After X Bars,,None,None,None,None
430_240906005_B,186,XAUUSD,Buy,2014-02-21 12:00:00,2014-02-21 16:00:00,1324.98,1321.95,1,-303,45549,Exit After X Bars,,None,None,None,None
435_240906005_B,186,XAUUSD,Buy,2014-03-05 16:00:00,2014-03-05 20:00:00,1340.64,1341.02,1,38,45587,Exit After X Bars,,None,None,None,None
436_240906005_B,186,XAUUSD,Buy,2014-03-06 16:00:00,2014-03-06 20:00:00,1341.81,1348.87,1,706,46293,Exit After X Bars,,None,None,None,None
449_240906005_B,186,XAUUSD,Buy,2014-04-02 12:00:00,2014-04-02 16:00:00,1287.84,1291.57,1,373,46666,Exit After X Bars,,None,None,None,None
456_240906005_B,186,XAUUSD,Buy,2014-04-24 16:00:00,2014-04-24 20:00:00,1288.95,1289.87,1,92,46758,Exit After X Bars,,None,None,None,None
460_240906005_B,186,XAUUSD,Buy,2014-05-02 16:00:00,2014-05-02 20:00:00,1288.79,1298.41,1,962,47720,Exit After X Bars,,None,None,None,None
463_240906005_B,186,XAUUSD,Buy,2014-05-12 12:00:00,2014-05-12 16:00:00,1294.35,1300.66,1,631,48351,Exit After X Bars,,None,None,None,None
464_240906005_B,186,XAUUSD,Buy,2014-05-14 12:00:00,2014-05-14 16:00:00,1303.83,1307.38,1,355,48706,Exit After X Bars,,None,None,None,None
476_240906005_B,186,XAUUSD,Buy,2014-06-05 12:00:00,2014-06-05 16:00:00,1250.74,1254.85,1,411,49117,Exit After X Bars,,None,None,None,None
478_240906005_B,186,XAUUSD,Buy,2014-06-18 12:00:00,2014-06-18 16:00:00,1272.37,1271.69,1,-68,49049,Exit After X Bars,,None,None,None,None
481_240906005_B,186,XAUUSD,Buy,2014-06-27 16:00:00,2014-06-27 20:00:00,1318.49,1318.3,1,-19,49030,Exit After X Bars,,None,None,None,None
482_240906005_B,186,XAUUSD,Buy,2014-06-30 20:00:00,2014-07-01 00:00:00,1320.97,1327.15,1,618,49648,Exit After X Bars,,None,None,None,None
483_240906005_B,186,XAUUSD,Buy,2014-07-02 16:00:00,2014-07-02 20:00:00,1330.9,1329.4,1,-150,49498,Exit After X Bars,,None,None,None,None
487_240906005_B,186,XAUUSD,Buy,2014-07-08 12:00:00,2014-07-08 16:00:00,1319.83,1321.99,1,216,49714,Exit After X Bars,,None,None,None,None
488_240906005_B,186,XAUUSD,Buy,2014-07-09 12:00:00,2014-07-09 16:00:00,1324.76,1325.7,1,94,49808,Exit After X Bars,,None,None,None,None
492_240906005_B,186,XAUUSD,Buy,2014-07-17 12:00:00,2014-07-17 16:00:00,1303.71,1305.77,1,206,50014,Exit After X Bars,,None,None,None,None
496_240906005_B,186,XAUUSD,Buy,2014-07-25 20:00:00,2014-07-28 00:00:00,1301.26,1307.57,1,631,50645,End Of Friday,,None,None,None,None
500_240906005_B,186,XAUUSD,Buy,2014-08-06 12:00:00,2014-08-06 16:00:00,1294.88,1302.07,1,719,51364,Exit After X Bars,,None,None,None,None
501_240906005_B,186,XAUUSD,Buy,2014-08-12 12:00:00,2014-08-12 16:00:00,1311.31,1314.85,1,354,51718,Exit After X Bars,,None,None,None,None
502_240906005_B,186,XAUUSD,Buy,2014-08-14 12:00:00,2014-08-14 16:00:00,1317.82,1314.57,1,-325,51393,Exit After X Bars,,None,None,None,None
509_240906005_B,186,XAUUSD,Buy,2014-08-26 04:00:00,2014-08-26 08:00:00,1282.85,1282.24,1,-61,51332,Exit After X Bars,,None,None,None,None
517_240906005_B,186,XAUUSD,Buy,2014-09-16 08:00:00,2014-09-16 12:00:00,1239.09,1239.76,1,67,51399,Exit After X Bars,,None,None,None,None
520_240906005_B,186,XAUUSD,Buy,2014-09-23 08:00:00,2014-09-23 12:00:00,1225.72,1223.54,1,-218,51181,Exit After X Bars,,None,None,None,None
521_240906005_B,186,XAUUSD,Buy,2014-09-26 04:00:00,2014-09-26 08:00:00,1226.01,1222.61,1,-340,50841,Exit After X Bars,,None,None,None,None
523_240906005_B,186,XAUUSD,Buy,2014-10-02 04:00:00,2014-10-02 08:00:00,1220.08,1219.5,1,-58,50783,Exit After X Bars,,None,None,None,None
525_240906005_B,186,XAUUSD,Buy,2014-10-07 08:00:00,2014-10-07 12:00:00,1209.33,1208.79,1,-54,50729,Exit After X Bars,,None,None,None,None
526_240906005_B,186,XAUUSD,Buy,2014-10-15 12:00:00,2014-10-15 16:00:00,1238.17,1236.12,1,-205,50524,Exit After X Bars,,None,None,None,None
532_240906005_B,186,XAUUSD,Buy,2014-10-28 12:00:00,2014-10-28 16:00:00,1231.78,1232.63,1,85,50609,Exit After X Bars,,None,None,None,None
537_240906005_B,186,XAUUSD,Buy,2014-11-04 12:00:00,2014-11-04 16:00:00,1173.78,1169.24,1,-454,50155,Exit After X Bars,,None,None,None,None
540_240906005_B,186,XAUUSD,Buy,2014-11-07 12:00:00,2014-11-07 16:00:00,1149.5,1148.58,1,-92,50063,Exit After X Bars,,None,None,None,None
541_240906005_B,186,XAUUSD,Buy,2014-11-14 16:00:00,2014-11-14 20:00:00,1167.88,1188.32,1,2044,52107,Exit After X Bars,,None,None,None,None
542_240906005_B,186,XAUUSD,Buy,2014-11-21 12:00:00,2014-11-21 16:00:00,1202.13,1202.94,1,81,52188,Exit After X Bars,,None,None,None,None
543_240906005_B,186,XAUUSD,Buy,2014-11-25 20:00:00,2014-11-26 00:00:00,1200.32,1200.55,1,23,52211,Exit After X Bars,,None,None,None,None
547_240906005_B,186,XAUUSD,Buy,2014-12-01 16:00:00,2014-12-01 20:00:00,1189.27,1215.34,1,2607,54818,Exit After X Bars,,None,None,None,None
549_240906005_B,186,XAUUSD,Buy,2014-12-08 20:00:00,2014-12-09 00:00:00,1207.48,1202.88,1,-460,54358,Exit After X Bars,,None,None,None,None
553_240906005_B,186,XAUUSD,Buy,2014-12-16 12:00:00,2014-12-16 16:00:00,1217.15,1211.4,1,-575,53783,Exit After X Bars,,None,None,None,None
555_240906005_B,186,XAUUSD,Buy,2014-12-18 12:00:00,2014-12-18 16:00:00,1202.91,1202.87,1,-4,53779,Exit After X Bars,,None,None,None,None
559_240906005_B,186,XAUUSD,Buy,2014-12-26 00:00:00,2014-12-26 04:00:00,1181.34,1183.63,1,229,54008,Exit After X Bars,,None,None,None,None
561_240906005_B,186,XAUUSD,Buy,2015-01-09 12:00:00,2015-01-09 16:00:00,1218.26,1214.26,1,-400,53608,Exit After X Bars,,None,None,None,None
562_240906005_B,186,XAUUSD,Buy,2015-01-14 16:00:00,2015-01-14 20:00:00,1242.87,1238.64,1,-423,53185,Exit After X Bars,,None,None,None,None
563_240906005_B,186,XAUUSD,Buy,2015-01-15 12:00:00,2015-01-15 16:00:00,1244.31,1254.5,1,1019,54204,Exit After X Bars,,None,None,None,None
564_240906005_B,186,XAUUSD,Buy,2015-01-22 16:00:00,2015-01-22 20:00:00,1305.24,1300.98,1,-426,53778,Exit After X Bars,,None,None,None,None
567_240906005_B,186,XAUUSD,Buy,2015-01-27 12:00:00,2015-01-27 16:00:00,1287.45,1287.31,1,-14,53764,Exit After X Bars,,None,None,None,None
570_240906005_B,186,XAUUSD,Buy,2015-01-30 16:00:00,2015-01-30 20:00:00,1277.28,1275.44,1,-184,53580,Exit After X Bars,,None,None,None,None
571_240906005_B,186,XAUUSD,Buy,2015-02-03 08:00:00,2015-02-03 12:00:00,1284.7,1280.88,1,-382,53198,Exit After X Bars,,None,None,None,None
583_240906005_B,186,XAUUSD,Buy,2015-02-25 08:00:00,2015-02-25 12:00:00,1210.28,1208.09,1,-219,52979,Exit After X Bars,,None,None,None,None
586_240906005_B,186,XAUUSD,Buy,2015-03-05 16:00:00,2015-03-05 20:00:00,1207.23,1199.08,1,-815,52164,Exit After X Bars,,None,None,None,None
594_240906005_B,186,XAUUSD,Buy,2015-04-01 12:00:00,2015-04-01 16:00:00,1190.72,1193.54,1,282,52446,Exit After X Bars,,None,None,None,None
598_240906005_B,186,XAUUSD,Buy,2015-04-10 12:00:00,2015-04-10 16:00:00,1202.6,1204.96,1,236,52682,Exit After X Bars,,None,None,None,None
601_240906005_B,186,XAUUSD,Buy,2015-04-15 20:00:00,2015-04-16 00:00:00,1199.0,1202.18,1,318,53000,Exit After X Bars,,None,None,None,None
604_240906005_B,186,XAUUSD,Buy,2015-04-22 08:00:00,2015-04-22 12:00:00,1204.73,1200.73,1,-400,52600,Exit After X Bars,,None,None,None,None
607_240906005_B,186,XAUUSD,Buy,2015-04-27 16:00:00,2015-04-27 20:00:00,1192.74,1206.76,1,1402,54002,Exit After X Bars,,None,None,None,None
611_240906005_B,186,XAUUSD,Buy,2015-05-08 12:00:00,2015-05-08 16:00:00,1188.48,1189.59,1,111,54113,Exit After X Bars,,None,None,None,None
613_240906005_B,186,XAUUSD,Buy,2015-05-12 12:00:00,2015-05-12 16:00:00,1191.77,1195.14,1,337,54450,Exit After X Bars,,None,None,None,None
616_240906005_B,186,XAUUSD,Buy,2015-05-22 08:00:00,2015-05-22 12:00:00,1213.37,1212.43,1,-94,54356,Exit After X Bars,,None,None,None,None
620_240906005_B,186,XAUUSD,Buy,2015-05-28 16:00:00,2015-05-28 20:00:00,1189.02,1188.44,1,-58,54298,Exit After X Bars,,None,None,None,None
621_240906005_B,186,XAUUSD,Buy,2015-05-29 12:00:00,2015-05-29 16:00:00,1190.88,1189.8,1,-108,54190,Exit After X Bars,,None,None,None,None
622_240906005_B,186,XAUUSD,Buy,2015-06-01 16:00:00,2015-06-01 20:00:00,1193.87,1191.04,1,-283,53907,Exit After X Bars,,None,None,None,None
626_240906005_B,186,XAUUSD,Buy,2015-06-09 04:00:00,2015-06-09 08:00:00,1176.6,1177.58,1,98,54005,Exit After X Bars,,None,None,None,None
628_240906005_B,186,XAUUSD,Buy,2015-06-17 20:00:00,2015-06-18 00:00:00,1184.75,1184.86,1,11,54016,Exit After X Bars,,None,None,None,None
633_240906005_B,186,XAUUSD,Buy,2015-06-29 00:00:00,2015-06-29 04:00:00,1184.23,1185.47,1,123.9,54139.9,Exit After X Bars,,None,None,None,None
637_240906005_B,186,XAUUSD,Buy,2015-07-03 12:00:00,2015-07-03 16:00:00,1169.36,1169.48,1,12,54151.9,Exit After X Bars,,None,None,None,None
638_240906005_B,186,XAUUSD,Buy,2015-07-06 16:00:00,2015-07-06 20:00:00,1169.87,1172.13,1,226,54377.9,Exit After X Bars,,None,None,None,None
641_240906005_B,186,XAUUSD,Buy,2015-07-09 12:00:00,2015-07-09 16:00:00,1164.63,1164.53,1,-10,54367.9,Exit After X Bars,,None,None,None,None
643_240906005_B,186,XAUUSD,Buy,2015-07-14 16:00:00,2015-07-14 20:00:00,1159.44,1155.13,1,-431,53936.9,Exit After X Bars,,None,None,None,None
652_240906005_B,186,XAUUSD,Buy,2015-07-31 16:00:00,2015-07-31 20:00:00,1095.38,1094.21,1,-117,53819.9,Exit After X Bars,,None,None,None,None
653_240906005_B,186,XAUUSD,Buy,2015-08-04 12:00:00,2015-08-04 16:00:00,1094.18,1091.62,1,-256,53563.9,Exit After X Bars,,None,None,None,None
657_240906005_B,186,XAUUSD,Buy,2015-08-28 12:00:00,2015-08-28 16:00:00,1129.3,1129.06,1,-24,53539.9,Exit After X Bars,,None,None,None,None
658_240906005_B,186,XAUUSD,Buy,2015-09-01 04:00:00,2015-09-01 08:00:00,1140.79,1142.28,1,149,53688.9,Exit After X Bars,,None,None,None,None
663_240906005_B,186,XAUUSD,Buy,2015-09-08 12:00:00,2015-09-08 16:00:00,1123.22,1122.09,1,-113,53575.9,Exit After X Bars,,None,None,None,None
667_240906005_B,186,XAUUSD,Buy,2015-09-14 12:00:00,2015-09-14 16:00:00,1108.44,1105.19,1,-325,53250.9,Exit After X Bars,,None,None,None,None
669_240906005_B,186,XAUUSD,Buy,2015-09-16 12:00:00,2015-09-16 16:00:00,1109.04,1114.03,1,499,53749.9,Exit After X Bars,,None,None,None,None
671_240906005_B,186,XAUUSD,Buy,2015-09-24 04:00:00,2015-09-24 08:00:00,1135.06,1134.21,1,-85,53664.9,Exit After X Bars,,None,None,None,None
676_240906005_B,186,XAUUSD,Buy,2015-10-02 12:00:00,2015-10-02 16:00:00,1119.11,1131.89,1,1278,54942.9,Exit After X Bars,,None,None,None,None
677_240906005_B,186,XAUUSD,Buy,2015-10-09 08:00:00,2015-10-09 12:00:00,1153.63,1153.75,1,12,54954.9,Exit After X Bars,,None,None,None,None
678_240906005_B,186,XAUUSD,Buy,2015-10-14 04:00:00,2015-10-14 08:00:00,1169.0,1173.73,1,473,55427.9,Exit After X Bars,,None,None,None,None
681_240906005_B,186,XAUUSD,Buy,2015-10-20 16:00:00,2015-10-20 20:00:00,1178.15,1176.93,1,-122,55305.9,Exit After X Bars,,None,None,None,None
685_240906005_B,186,XAUUSD,Buy,2015-10-28 08:00:00,2015-10-28 12:00:00,1169.64,1172.1,1,246,55551.9,Exit After X Bars,,None,None,None,None
695_240906005_B,186,XAUUSD,Buy,2015-11-19 16:00:00,2015-11-19 20:00:00,1083.44,1080.32,1,-312,55239.9,Exit After X Bars,,None,None,None,None
698_240906005_B,186,XAUUSD,Buy,2015-11-30 20:00:00,2015-12-01 00:00:00,1066.91,1064.8,1,-211,55028.9,Exit After X Bars,,None,None,None,None
700_240906005_B,186,XAUUSD,Buy,2015-12-04 12:00:00,2015-12-04 16:00:00,1067.74,1068.32,1,58,55086.9,Exit After X Bars,,None,None,None,None
702_240906005_B,186,XAUUSD,Buy,2015-12-11 16:00:00,2015-12-11 20:00:00,1075.57,1075.16,1,-41,55045.9,Exit After X Bars,,None,None,None,None
705_240906005_B,186,XAUUSD,Buy,2015-12-16 12:00:00,2015-12-16 16:00:00,1068.67,1072.87,1,420,55465.9,Exit After X Bars,,None,None,None,None
707_240906005_B,186,XAUUSD,Buy,2015-12-18 16:00:00,2015-12-18 20:00:00,1068.28,1065.61,1,-267,55198.9,Exit After X Bars,,None,None,None,None
713_240906005_B,186,XAUUSD,Buy,2016-01-13 20:00:00,2016-01-14 00:00:00,1095.45,1093.36,1,-209,54989.9,Exit After X Bars,,None,None,None,None
715_240906005_B,186,XAUUSD,Buy,2016-01-15 12:00:00,2016-01-15 16:00:00,1093.1,1093.84,1,74,55063.9,Exit After X Bars,,None,None,None,None
717_240906005_B,186,XAUUSD,Buy,2016-01-20 04:00:00,2016-01-20 08:00:00,1092.13,1091.18,1,-95,54968.9,Exit After X Bars,,None,None,None,None
718_240906005_B,186,XAUUSD,Buy,2016-01-22 16:00:00,2016-01-22 20:00:00,1102.68,1097.71,1,-497,54471.9,Exit After X Bars,,None,None,None,None
720_240906005_B,186,XAUUSD,Buy,2016-02-03 16:00:00,2016-02-03 20:00:00,1130.95,1139.41,1,846,55317.9,Exit After X Bars,,None,None,None,None
721_240906005_B,186,XAUUSD,Buy,2016-02-11 00:00:00,2016-02-11 04:00:00,1198.88,1207.95,1,907,56224.9,Exit After X Bars,,None,None,None,None
723_240906005_B,186,XAUUSD,Buy,2016-02-16 12:00:00,2016-02-16 16:00:00,1214.04,1214.62,1,58,56282.9,Exit After X Bars,,None,None,None,None
725_240906005_B,186,XAUUSD,Buy,2016-02-18 16:00:00,2016-02-18 20:00:00,1213.71,1227.06,1,1335,57617.9,Exit After X Bars,,None,None,None,None
729_240906005_B,186,XAUUSD,Buy,2016-02-29 20:00:00,2016-03-01 00:00:00,1238.1,1237.53,1,-57,57560.9,Exit After X Bars,,None,None,None,None
731_240906005_B,186,XAUUSD,Buy,2016-03-03 12:00:00,2016-03-03 16:00:00,1244.01,1241.71,1,-230,57330.9,Exit After X Bars,,None,None,None,None
733_240906005_B,186,XAUUSD,Buy,2016-03-10 16:00:00,2016-03-10 20:00:00,1260.31,1272.46,1,1215,58545.9,Exit After X Bars,,None,None,None,None
737_240906005_B,186,XAUUSD,Buy,2016-03-16 20:00:00,2016-03-17 00:00:00,1238.04,1260.82,1,2278,60823.9,Exit After X Bars,,None,None,None,None
739_240906005_B,186,XAUUSD,Buy,2016-03-22 08:00:00,2016-03-22 12:00:00,1258.6,1252.25,1,-635,60188.9,Exit After X Bars,,None,None,None,None
743_240906005_B,186,XAUUSD,Buy,2016-03-29 16:00:00,2016-03-29 20:00:00,1223.06,1235.67,1,1261,61449.9,Exit After X Bars,,None,None,None,None
745_240906005_B,186,XAUUSD,Buy,2016-04-05 08:00:00,2016-04-05 12:00:00,1233.93,1232.66,1,-127,61322.9,Exit After X Bars,,None,None,None,None
746_240906005_B,186,XAUUSD,Buy,2016-04-07 12:00:00,2016-04-07 16:00:00,1236.75,1239.3,1,255,61577.9,Exit After X Bars,,None,None,None,None
750_240906005_B,186,XAUUSD,Buy,2016-04-18 12:00:00,2016-04-18 16:00:00,1235.84,1239.54,1,370,61947.9,Exit After X Bars,,None,None,None,None
753_240906005_B,186,XAUUSD,Buy,2016-04-26 16:00:00,2016-04-26 20:00:00,1242.23,1240.55,1,-168,61779.9,Exit After X Bars,,None,None,None,None
756_240906005_B,186,XAUUSD,Buy,2016-05-06 12:00:00,2016-05-06 16:00:00,1286.4,1291.99,1,559,62338.9,Exit After X Bars,,None,None,None,None
759_240906005_B,186,XAUUSD,Buy,2016-05-12 16:00:00,2016-05-12 20:00:00,1279.08,1271.05,1,-803,61535.9,Exit After X Bars,,None,None,None,None
764_240906005_B,186,XAUUSD,Buy,2016-05-20 16:00:00,2016-05-20 20:00:00,1259.09,1250.82,1,-827,60708.9,Exit After X Bars,,None,None,None,None
768_240906005_B,186,XAUUSD,Buy,2016-05-26 12:00:00,2016-05-26 16:00:00,1227.23,1229.33,1,210,60918.9,Exit After X Bars,,None,None,None,None
770_240906005_B,186,XAUUSD,Buy,2016-06-03 12:00:00,2016-06-03 16:00:00,1221.91,1236.96,1,1505,62423.9,Exit After X Bars,,None,None,None,None
771_240906005_B,186,XAUUSD,Buy,2016-06-15 20:00:00,2016-06-16 00:00:00,1289.77,1291.66,1,189,62612.9,Exit After X Bars,,None,None,None,None
776_240906005_B,186,XAUUSD,Buy,2016-06-24 00:00:00,2016-06-24 04:00:00,1269.35,1271.53,1,218,62830.9,Exit After X Bars,,None,None,None,None
778_240906005_B,186,XAUUSD,Buy,2016-07-01 04:00:00,2016-07-01 08:00:00,1327.8,1330.3,1,250,63080.9,Exit After X Bars,,None,None,None,None
779_240906005_B,186,XAUUSD,Buy,2016-07-05 16:00:00,2016-07-05 20:00:00,1353.81,1354.83,1,102,63182.9,Exit After X Bars,,None,None,None,None
781_240906005_B,186,XAUUSD,Buy,2016-07-08 16:00:00,2016-07-08 20:00:00,1367.83,1355.82,1,-1201,61981.9,Exit After X Bars,,None,None,None,None
786_240906005_B,186,XAUUSD,Buy,2016-07-15 20:00:00,2016-07-18 00:00:00,1336.71,1332.62,1,-409,61572.9,End Of Friday,,None,None,None,None
788_240906005_B,186,XAUUSD,Buy,2016-07-20 04:00:00,2016-07-20 08:00:00,1335.47,1331.76,1,-371,61201.9,Exit After X Bars,,None,None,None,None
789_240906005_B,186,XAUUSD,Buy,2016-07-21 16:00:00,2016-07-21 20:00:00,1327.29,1330.09,1,280,61481.9,Exit After X Bars,,None,None,None,None
792_240906005_B,186,XAUUSD,Buy,2016-07-26 12:00:00,2016-07-26 16:00:00,1322.13,1320.7,1,-143,61338.9,Exit After X Bars,,None,None,None,None
793_240906005_B,186,XAUUSD,Buy,2016-07-27 16:00:00,2016-07-27 20:00:00,1324.49,1327.14,1,265,61603.9,Exit After X Bars,,None,None,None,None
797_240906005_B,186,XAUUSD,Buy,2016-08-09 16:00:00,2016-08-09 20:00:00,1338.09,1339.93,1,184,61787.9,Exit After X Bars,,None,None,None,None
799_240906005_B,186,XAUUSD,Buy,2016-08-12 12:00:00,2016-08-12 16:00:00,1353.28,1355.01,1,173,61960.9,Exit After X Bars,,None,None,None,None
800_240906005_B,186,XAUUSD,Buy,2016-08-16 12:00:00,2016-08-16 16:00:00,1356.34,1349.02,1,-732,61228.9,Exit After X Bars,,None,None,None,None
804_240906005_B,186,XAUUSD,Buy,2016-08-23 12:00:00,2016-08-23 16:00:00,1340.03,1343.74,1,371,61599.9,Exit After X Bars,,None,None,None,None
807_240906005_B,186,XAUUSD,Buy,2016-08-26 12:00:00,2016-08-26 16:00:00,1326.9,1331.14,1,424,62023.9,Exit After X Bars,,None,None,None,None
811_240906005_B,186,XAUUSD,Buy,2016-09-01 16:00:00,2016-09-01 20:00:00,1314.85,1313.54,1,-131,61892.9,Exit After X Bars,,None,None,None,None
816_240906005_B,186,XAUUSD,Buy,2016-09-15 12:00:00,2016-09-15 16:00:00,1325.95,1320.64,1,-531,61361.9,Exit After X Bars,,None,None,None,None
818_240906005_B,186,XAUUSD,Buy,2016-09-19 12:00:00,2016-09-19 16:00:00,1316.14,1313.45,1,-269,61092.9,Exit After X Bars,,None,None,None,None
821_240906005_B,186,XAUUSD,Buy,2016-09-30 08:00:00,2016-09-30 12:00:00,1326.92,1326.0,1,-92,61000.9,Exit After X Bars,,None,None,None,None
828_240906005_B,186,XAUUSD,Buy,2016-10-28 20:00:00,2016-10-31 00:00:00,1272.78,1277.21,1,443,61443.9,End Of Friday,,None,None,None,None
831_240906005_B,186,XAUUSD,Buy,2016-11-08 16:00:00,2016-11-08 20:00:00,1288.95,1276.86,1,-1209,60234.9,Exit After X Bars,,None,None,None,None
835_240906005_B,186,XAUUSD,Buy,2016-11-16 00:00:00,2016-11-16 04:00:00,1231.33,1231.18,1,-15,60219.9,Exit After X Bars,,None,None,None,None
839_240906005_B,186,XAUUSD,Buy,2016-11-25 12:00:00,2016-11-25 16:00:00,1189.65,1187.54,1,-211,60008.9,Exit After X Bars,,None,None,None,None
841_240906005_B,186,XAUUSD,Buy,2016-12-07 16:00:00,2016-12-07 20:00:00,1177.96,1175.55,1,-241,59767.9,Exit After X Bars,,None,None,None,None
845_240906005_B,186,XAUUSD,Buy,2016-12-16 16:00:00,2016-12-16 20:00:00,1137.45,1137.32,1,-13,59754.9,Exit After X Bars,,None,None,None,None
849_240906005_B,186,XAUUSD,Buy,2017-01-20 20:00:00,2017-01-23 00:00:00,1208.0,1209.46,1,146,59900.9,End Of Friday,,None,None,None,None
854_240906005_B,186,XAUUSD,Buy,2017-01-30 12:00:00,2017-01-30 16:00:00,1191.57,1193.3,1,173,60073.9,Exit After X Bars,,None,None,None,None
858_240906005_B,186,XAUUSD,Buy,2017-02-14 12:00:00,2017-02-14 16:00:00,1231.14,1232.82,1,168,60241.9,Exit After X Bars,,None,None,None,None
859_240906005_B,186,XAUUSD,Buy,2017-02-16 00:00:00,2017-02-16 04:00:00,1234.48,1236.16,1,168,60409.9,Exit After X Bars,,None,None,None,None
862_240906005_B,186,XAUUSD,Buy,2017-02-22 12:00:00,2017-02-22 16:00:00,1238.82,1238.65,1,-17,60392.9,Exit After X Bars,,None,None,None,None
863_240906005_B,186,XAUUSD,Buy,2017-02-23 12:00:00,2017-02-23 16:00:00,1240.33,1248.47,1,814,61206.9,Exit After X Bars,,None,None,None,None
878_240906005_B,186,XAUUSD,Buy,2017-04-03 16:00:00,2017-04-03 20:00:00,1250.54,1252.34,1,180,61386.9,Exit After X Bars,,None,None,None,None
880_240906005_B,186,XAUUSD,Buy,2017-04-07 04:00:00,2017-04-07 08:00:00,1258.81,1263.51,1,470,61856.9,Exit After X Bars,,None,None,None,None
882_240906005_B,186,XAUUSD,Buy,2017-04-11 12:00:00,2017-04-11 16:00:00,1257.04,1260.48,1,344,62200.9,Exit After X Bars,,None,None,None,None
886_240906005_B,186,XAUUSD,Buy,2017-04-21 12:00:00,2017-04-21 16:00:00,1283.39,1282.38,1,-101,62099.9,Exit After X Bars,,None,None,None,None
891_240906005_B,186,XAUUSD,Buy,2017-04-28 12:00:00,2017-04-28 16:00:00,1267.17,1266.6,1,-57,62042.9,Exit After X Bars,,None,None,None,None
897_240906005_B,186,XAUUSD,Buy,2017-05-08 12:00:00,2017-05-08 16:00:00,1235.56,1230.3,1,-526,61516.9,Exit After X Bars,,None,None,None,None
899_240906005_B,186,XAUUSD,Buy,2017-05-11 16:00:00,2017-05-11 20:00:00,1226.46,1224.91,1,-155,61361.9,Exit After X Bars,,None,None,None,None
901_240906005_B,186,XAUUSD,Buy,2017-05-26 08:00:00,2017-05-26 12:00:00,1258.92,1263.49,1,457,61818.9,Exit After X Bars,,None,None,None,None
903_240906005_B,186,XAUUSD,Buy,2017-05-31 12:00:00,2017-05-31 16:00:00,1265.34,1266.08,1,74,61892.9,Exit After X Bars,,None,None,None,None
905_240906005_B,186,XAUUSD,Buy,2017-06-02 12:00:00,2017-06-02 16:00:00,1268.83,1273.68,1,485,62377.9,Exit After X Bars,,None,None,None,None
910_240906005_B,186,XAUUSD,Buy,2017-06-14 12:00:00,2017-06-14 16:00:00,1268.91,1276.32,1,741,63118.9,Exit After X Bars,,None,None,None,None
915_240906005_B,186,XAUUSD,Buy,2017-06-22 00:00:00,2017-06-22 04:00:00,1248.09,1250.85,1,276,63394.9,Exit After X Bars,,None,None,None,None
921_240906005_B,186,XAUUSD,Buy,2017-07-06 00:00:00,2017-07-06 04:00:00,1227.39,1227.31,1,-8,63386.9,Exit After X Bars,,None,None,None,None
922_240906005_B,186,XAUUSD,Buy,2017-07-07 12:00:00,2017-07-07 16:00:00,1227.37,1221.02,1,-635,62751.9,Exit After X Bars,,None,None,None,None
924_240906005_B,186,XAUUSD,Buy,2017-07-11 16:00:00,2017-07-11 20:00:00,1216.0,1215.74,1,-26,62725.9,Exit After X Bars,,None,None,None,None
926_240906005_B,186,XAUUSD,Buy,2017-07-26 20:00:00,2017-07-27 00:00:00,1255.14,1260.47,1,533,63258.9,Exit After X Bars,,None,None,None,None
931_240906005_B,186,XAUUSD,Buy,2017-08-08 20:00:00,2017-08-09 00:00:00,1259.87,1260.4,1,53,63311.9,Exit After X Bars,,None,None,None,None
934_240906005_B,186,XAUUSD,Buy,2017-08-16 20:00:00,2017-08-17 00:00:00,1275.4,1283.5,1,810,64121.9,Exit After X Bars,,None,None,None,None
937_240906005_B,186,XAUUSD,Buy,2017-08-23 12:00:00,2017-08-23 16:00:00,1290.97,1289.25,1,-172,63949.9,Exit After X Bars,,None,None,None,None
939_240906005_B,186,XAUUSD,Buy,2017-08-25 16:00:00,2017-08-25 20:00:00,1290.11,1292.64,1,253,64202.9,Exit After X Bars,,None,None,None,None
941_240906005_B,186,XAUUSD,Buy,2017-08-31 16:00:00,2017-08-31 20:00:00,1313.64,1316.85,1,321,64523.9,Exit After X Bars,,None,None,None,None
942_240906005_B,186,XAUUSD,Buy,2017-09-07 12:00:00,2017-09-07 16:00:00,1341.83,1343.87,1,204,64727.9,Exit After X Bars,,None,None,None,None
945_240906005_B,186,XAUUSD,Buy,2017-09-13 12:00:00,2017-09-13 16:00:00,1334.52,1331.65,1,-287,64440.9,Exit After X Bars,,None,None,None,None
950_240906005_B,186,XAUUSD,Buy,2017-09-20 16:00:00,2017-09-20 20:00:00,1311.64,1313.22,1,158,64598.9,Exit After X Bars,,None,None,None,None
952_240906005_B,186,XAUUSD,Buy,2017-09-22 16:00:00,2017-09-22 20:00:00,1297.64,1294.74,1,-290,64308.9,Exit After X Bars,,None,None,None,None
953_240906005_B,186,XAUUSD,Buy,2017-09-25 16:00:00,2017-09-25 20:00:00,1298.46,1310.15,1,1169,65477.9,Exit After X Bars,,None,None,None,None
956_240906005_B,186,XAUUSD,Buy,2017-09-29 12:00:00,2017-09-29 16:00:00,1288.74,1288.61,1,-13,65464.9,Exit After X Bars,,None,None,None,None
958_240906005_B,186,XAUUSD,Buy,2017-10-04 08:00:00,2017-10-04 12:00:00,1277.21,1275.54,1,-167,65297.9,Exit After X Bars,,None,None,None,None
965_240906005_B,186,XAUUSD,Buy,2017-10-26 08:00:00,2017-10-26 12:00:00,1281.29,1277.93,1,-336,64961.9,Exit After X Bars,,None,None,None,None
967_240906005_B,186,XAUUSD,Buy,2017-10-30 16:00:00,2017-10-30 20:00:00,1273.97,1278.05,1,408,65369.9,Exit After X Bars,,None,None,None,None
968_240906005_B,186,XAUUSD,Buy,2017-11-01 12:00:00,2017-11-01 16:00:00,1276.37,1275.13,1,-124,65245.9,Exit After X Bars,,None,None,None,None
969_240906005_B,186,XAUUSD,Buy,2017-11-06 16:00:00,2017-11-06 20:00:00,1280.14,1280.84,1,70,65315.9,Exit After X Bars,,None,None,None,None
971_240906005_B,186,XAUUSD,Buy,2017-11-14 16:00:00,2017-11-14 20:00:00,1279.72,1281.0,1,128,65443.9,Exit After X Bars,,None,None,None,None
972_240906005_B,186,XAUUSD,Buy,2017-11-17 16:00:00,2017-11-17 20:00:00,1289.45,1293.4,1,395,65838.9,Exit After X Bars,,None,None,None,None
974_240906005_B,186,XAUUSD,Buy,2017-11-22 12:00:00,2017-11-22 16:00:00,1284.7,1285.34,1,64,65902.9,Exit After X Bars,,None,None,None,None
978_240906005_B,186,XAUUSD,Buy,2017-12-01 16:00:00,2017-12-01 20:00:00,1283.27,1283.66,1,39,65941.9,Exit After X Bars,,None,None,None,None
985_240906005_B,186,XAUUSD,Buy,2017-12-13 20:00:00,2017-12-14 00:00:00,1251.52,1255.03,1,351,66292.9,Exit After X Bars,,None,None,None,None
986_240906005_B,186,XAUUSD,Buy,2018-01-04 16:00:00,2018-01-04 20:00:00,1317.91,1319.68,1,177,66469.9,Exit After X Bars,,None,None,None,None
990_240906005_B,186,XAUUSD,Buy,2018-01-10 12:00:00,2018-01-10 16:00:00,1315.92,1319.7,1,378,66847.9,Exit After X Bars,,None,None,None,None
991_240906005_B,186,XAUUSD,Buy,2018-01-12 04:00:00,2018-01-12 08:00:00,1327.69,1328.26,1,57,66904.9,Exit After X Bars,,None,None,None,None
992_240906005_B,186,XAUUSD,Buy,2018-01-17 00:00:00,2018-01-17 04:00:00,1343.66,1343.65,1,-1,66903.9,Exit After X Bars,,None,None,None,None
994_240906005_B,186,XAUUSD,Buy,2018-01-23 00:00:00,2018-01-23 04:00:00,1336.48,1336.56,1,8,66911.9,Exit After X Bars,,None,None,None,None
997_240906005_B,186,XAUUSD,Buy,2018-01-30 16:00:00,2018-01-30 20:00:00,1348.69,1338.57,1,-1012,65899.9,Exit After X Bars,,None,None,None,None
999_240906005_B,186,XAUUSD,Buy,2018-02-01 20:00:00,2018-02-02 00:00:00,1347.52,1348.64,1,112,66011.9,Exit After X Bars,,None,None,None,None
1013_240906005_B,186,XAUUSD,Buy,2018-03-02 12:00:00,2018-03-02 16:00:00,1322.52,1325.0,1,248,66259.9,Exit After X Bars,,None,None,None,None
1016_240906005_B,186,XAUUSD,Buy,2018-03-13 00:00:00,2018-03-13 04:00:00,1325.12,1324.25,1,-87,66172.9,Exit After X Bars,,None,None,None,None
1025_240906005_B,186,XAUUSD,Buy,2018-04-06 16:00:00,2018-04-06 20:00:00,1332.24,1331.36,1,-88,66084.9,Exit After X Bars,,None,None,None,None
1026_240906005_B,186,XAUUSD,Buy,2018-04-09 16:00:00,2018-04-09 20:00:00,1335.36,1335.22,1,-14,66070.9,Exit After X Bars,,None,None,None,None
1029_240906005_B,186,XAUUSD,Buy,2018-04-18 12:00:00,2018-04-18 16:00:00,1347.72,1353.13,1,541,66611.9,Exit After X Bars,,None,None,None,None
1033_240906005_B,186,XAUUSD,Buy,2018-04-24 16:00:00,2018-04-24 20:00:00,1329.43,1331.84,1,241,66852.9,Exit After X Bars,,None,None,None,None
1035_240906005_B,186,XAUUSD,Buy,2018-04-26 12:00:00,2018-04-26 16:00:00,1325.69,1324.72,1,-97,66755.9,Exit After X Bars,,None,None,None,None
1039_240906005_B,186,XAUUSD,Buy,2018-05-02 12:00:00,2018-05-02 16:00:00,1310.24,1308.94,1,-130,66625.9,Exit After X Bars,,None,None,None,None
1040_240906005_B,186,XAUUSD,Buy,2018-05-08 20:00:00,2018-05-09 00:00:00,1317.01,1314.58,1,-243,66382.9,Exit After X Bars,,None,None,None,None
1041_240906005_B,186,XAUUSD,Buy,2018-05-10 12:00:00,2018-05-10 16:00:00,1317.76,1322.01,1,425,66807.9,Exit After X Bars,,None,None,None,None
1045_240906005_B,186,XAUUSD,Buy,2018-05-18 16:00:00,2018-05-18 20:00:00,1291.75,1292.53,1,78,66885.9,Exit After X Bars,,None,None,None,None
1046_240906005_B,186,XAUUSD,Buy,2018-05-22 08:00:00,2018-05-22 12:00:00,1294.15,1293.72,1,-43,66842.9,Exit After X Bars,,None,None,None,None
1047_240906005_B,186,XAUUSD,Buy,2018-05-31 08:00:00,2018-05-31 12:00:00,1305.25,1304.6,1,-65,66777.9,Exit After X Bars,,None,None,None,None
1050_240906005_B,186,XAUUSD,Buy,2018-06-05 16:00:00,2018-06-05 20:00:00,1298.02,1298.38,1,36,66813.9,Exit After X Bars,,None,None,None,None
1051_240906005_B,186,XAUUSD,Buy,2018-06-11 20:00:00,2018-06-12 00:00:00,1300.54,1298.68,1,-186,66627.9,Exit After X Bars,,None,None,None,None
1053_240906005_B,186,XAUUSD,Buy,2018-06-13 20:00:00,2018-06-14 00:00:00,1299.69,1299.25,1,-44,66583.9,Exit After X Bars,,None,None,None,None
1059_240906005_B,186,XAUUSD,Buy,2018-06-22 12:00:00,2018-06-22 16:00:00,1270.08,1268.64,1,-144,66439.9,Exit After X Bars,,None,None,None,None
1063_240906005_B,186,XAUUSD,Buy,2018-06-29 16:00:00,2018-06-29 20:00:00,1254.24,1255.26,1,102,66541.9,Exit After X Bars,,None,None,None,None
1064_240906005_B,186,XAUUSD,Buy,2018-07-03 16:00:00,2018-07-03 20:00:00,1250.76,1252.72,1,196,66737.9,Exit After X Bars,,None,None,None,None
1069_240906005_B,186,XAUUSD,Buy,2018-07-17 12:00:00,2018-07-17 16:00:00,1244.9,1239.1,1,-580,66157.9,Exit After X Bars,,None,None,None,None
1071_240906005_B,186,XAUUSD,Buy,2018-07-19 20:00:00,2018-07-20 00:00:00,1228.48,1223.01,1,-547,65610.9,Exit After X Bars,,None,None,None,None
1072_240906005_B,186,XAUUSD,Buy,2018-07-20 12:00:00,2018-07-20 16:00:00,1229.0,1229.95,1,95,65705.9,Exit After X Bars,,None,None,None,None
1073_240906005_B,186,XAUUSD,Buy,2018-07-25 12:00:00,2018-07-25 16:00:00,1232.59,1232.4,1,-19,65686.9,Exit After X Bars,,None,None,None,None
1076_240906005_B,186,XAUUSD,Buy,2018-07-31 16:00:00,2018-07-31 20:00:00,1225.03,1225.98,1,95,65781.9,Exit After X Bars,,None,None,None,None
1078_240906005_B,186,XAUUSD,Buy,2018-08-03 16:00:00,2018-08-03 20:00:00,1218.3,1215.78,1,-252,65529.9,Exit After X Bars,,None,None,None,None
1080_240906005_B,186,XAUUSD,Buy,2018-08-09 08:00:00,2018-08-09 12:00:00,1216.11,1212.92,1,-319,65210.9,Exit After X Bars,,None,None,None,None
1086_240906005_B,186,XAUUSD,Buy,2018-08-17 20:00:00,2018-08-20 00:00:00,1181.7,1183.33,1,163,65373.9,End Of Friday,,None,None,None,None
1087_240906005_B,186,XAUUSD,Buy,2018-08-24 12:00:00,2018-08-24 16:00:00,1192.87,1193.8,1,93,65466.9,Exit After X Bars,,None,None,None,None
1089_240906005_B,186,XAUUSD,Buy,2018-08-31 08:00:00,2018-08-31 12:00:00,1207.81,1206.3,1,-151,65315.9,Exit After X Bars,,None,None,None,None
1092_240906005_B,186,XAUUSD,Buy,2018-09-05 16:00:00,2018-09-05 20:00:00,1196.56,1195.41,1,-115,65200.9,Exit After X Bars,,None,None,None,None
1095_240906005_B,186,XAUUSD,Buy,2018-09-11 20:00:00,2018-09-12 00:00:00,1198.44,1198.01,1,-43,65157.9,Exit After X Bars,,None,None,None,None
1096_240906005_B,186,XAUUSD,Buy,2018-09-12 16:00:00,2018-09-12 20:00:00,1199.37,1203.97,1,460,65617.9,Exit After X Bars,,None,None,None,None
1098_240906005_B,186,XAUUSD,Buy,2018-09-19 12:00:00,2018-09-19 16:00:00,1204.78,1205.23,1,45,65662.9,Exit After X Bars,,None,None,None,None
1105_240906005_B,186,XAUUSD,Buy,2018-10-02 08:00:00,2018-10-02 12:00:00,1193.84,1193.13,1,-71,65591.9,Exit After X Bars,,None,None,None,None
1108_240906005_B,186,XAUUSD,Buy,2018-10-10 20:00:00,2018-10-11 00:00:00,1190.58,1194.76,1,418,66009.9,Exit After X Bars,,None,None,None,None
1110_240906005_B,186,XAUUSD,Buy,2018-10-18 16:00:00,2018-10-18 20:00:00,1229.45,1227.71,1,-174,65835.9,Exit After X Bars,,None,None,None,None
1111_240906005_B,186,XAUUSD,Buy,2018-10-19 12:00:00,2018-10-19 16:00:00,1230.09,1228.2,1,-189,65646.9,Exit After X Bars,,None,None,None,None
1112_240906005_B,186,XAUUSD,Buy,2018-10-23 08:00:00,2018-10-23 12:00:00,1230.75,1235.63,1,488,66134.9,Exit After X Bars,,None,None,None,None
1114_240906005_B,186,XAUUSD,Buy,2018-10-26 08:00:00,2018-10-26 12:00:00,1236.61,1237.36,1,75,66209.9,Exit After X Bars,,None,None,None,None
1117_240906005_B,186,XAUUSD,Buy,2018-11-01 08:00:00,2018-11-01 12:00:00,1226.48,1225.73,1,-75,66134.9,Exit After X Bars,,None,None,None,None
1119_240906005_B,186,XAUUSD,Buy,2018-11-07 12:00:00,2018-11-07 16:00:00,1235.87,1228.55,1,-732,65402.9,Exit After X Bars,,None,None,None,None
1124_240906005_B,186,XAUUSD,Buy,2018-11-14 16:00:00,2018-11-14 20:00:00,1204.35,1208.29,1,394,65796.9,Exit After X Bars,,None,None,None,None
1127_240906005_B,186,XAUUSD,Buy,2018-11-28 16:00:00,2018-11-28 20:00:00,1225.19,1221.12,1,-407,65389.9,Exit After X Bars,,None,None,None,None
1132_240906005_B,186,XAUUSD,Buy,2018-12-17 12:00:00,2018-12-17 16:00:00,1240.31,1241.54,1,123,65512.9,Exit After X Bars,,None,None,None,None
1133_240906005_B,186,XAUUSD,Buy,2018-12-20 16:00:00,2018-12-20 20:00:00,1257.95,1262.55,1,460,65972.9,Exit After X Bars,,None,None,None,None
1135_240906005_B,186,XAUUSD,Buy,2019-01-07 12:00:00,2019-01-07 16:00:00,1292.06,1292.27,1,21,65993.9,Exit After X Bars,,None,None,None,None
1137_240906005_B,186,XAUUSD,Buy,2019-01-09 16:00:00,2019-01-09 20:00:00,1287.02,1289.85,1,283,66276.9,Exit After X Bars,,None,None,None,None
1138_240906005_B,186,XAUUSD,Buy,2019-01-11 04:00:00,2019-01-11 08:00:00,1293.85,1293.86,1,1,66277.9,Exit After X Bars,,None,None,None,None
1141_240906005_B,186,XAUUSD,Buy,2019-01-16 16:00:00,2019-01-16 20:00:00,1294.68,1293.74,1,-94,66183.9,Exit After X Bars,,None,None,None,None
1145_240906005_B,186,XAUUSD,Buy,2019-01-23 12:00:00,2019-01-23 16:00:00,1285.62,1280.78,1,-484,65699.9,Exit After X Bars,,None,None,None,None
1147_240906005_B,186,XAUUSD,Buy,2019-01-25 12:00:00,2019-01-25 16:00:00,1283.84,1288.55,1,471,66170.9,Exit After X Bars,,None,None,None,None
1149_240906005_B,186,XAUUSD,Buy,2019-02-05 12:00:00,2019-02-05 16:00:00,1315.2,1314.58,1,-62,66108.9,Exit After X Bars,,None,None,None,None
1152_240906005_B,186,XAUUSD,Buy,2019-02-08 12:00:00,2019-02-08 16:00:00,1311.88,1314.73,1,285,66393.9,Exit After X Bars,,None,None,None,None
1155_240906005_B,186,XAUUSD,Buy,2019-02-15 12:00:00,2019-02-15 16:00:00,1318.08,1317.47,1,-61,66332.9,Exit After X Bars,,None,None,None,None
1164_240906005_B,186,XAUUSD,Buy,2019-03-06 08:00:00,2019-03-06 12:00:00,1289.7,1285.95,1,-375,65957.9,Exit After X Bars,,None,None,None,None
1165_240906005_B,186,XAUUSD,Buy,2019-03-07 12:00:00,2019-03-07 16:00:00,1288.48,1284.79,1,-369,65588.9,Exit After X Bars,,None,None,None,None
1167_240906005_B,186,XAUUSD,Buy,2019-03-18 12:00:00,2019-03-18 16:00:00,1306.33,1305.47,1,-86,65502.9,Exit After X Bars,,None,None,None,None
1170_240906005_B,186,XAUUSD,Buy,2019-03-27 12:00:00,2019-03-27 16:00:00,1318.77,1315.07,1,-370,65132.9,Exit After X Bars,,None,None,None,None
1184_240906005_B,186,XAUUSD,Buy,2019-04-24 12:00:00,2019-04-24 16:00:00,1273.93,1270.9,1,-303,64829.9,Exit After X Bars,,None,None,None,None
1185_240906005_B,186,XAUUSD,Buy,2019-05-01 20:00:00,2019-05-02 00:00:00,1286.12,1276.65,1,-947,63882.9,Exit After X Bars,,None,None,None,None
1187_240906005_B,186,XAUUSD,Buy,2019-05-03 12:00:00,2019-05-03 16:00:00,1272.95,1275.84,1,289,64171.9,Exit After X Bars,,None,None,None,None
1193_240906005_B,186,XAUUSD,Buy,2019-05-22 12:00:00,2019-05-22 16:00:00,1276.28,1275.58,1,-70,64101.9,Exit After X Bars,,None,None,None,None
1194_240906005_B,186,XAUUSD,Buy,2019-05-23 12:00:00,2019-05-23 16:00:00,1277.27,1282.7,1,543,64644.9,Exit After X Bars,,None,None,None,None
1196_240906005_B,186,XAUUSD,Buy,2019-05-29 12:00:00,2019-05-29 16:00:00,1284.83,1282.64,1,-219,64425.9,Exit After X Bars,,None,None,None,None
1197_240906005_B,186,XAUUSD,Buy,2019-05-30 16:00:00,2019-05-30 20:00:00,1285.46,1287.07,1,161,64586.9,Exit After X Bars,,None,None,None,None
1198_240906005_B,186,XAUUSD,Buy,2019-06-07 12:00:00,2019-06-07 16:00:00,1339.75,1341.0,1,125,64711.9,Exit After X Bars,,None,None,None,None
1200_240906005_B,186,XAUUSD,Buy,2019-06-12 04:00:00,2019-06-12 08:00:00,1330.06,1332.3,1,224,64935.9,Exit After X Bars,,None,None,None,None
1201_240906005_B,186,XAUUSD,Buy,2019-06-13 16:00:00,2019-06-13 20:00:00,1337.81,1339.35,1,154,65089.9,Exit After X Bars,,None,None,None,None
1203_240906005_B,186,XAUUSD,Buy,2019-06-19 20:00:00,2019-06-20 00:00:00,1354.61,1360.32,1,571,65660.9,Exit After X Bars,,None,None,None,None
1205_240906005_B,186,XAUUSD,Buy,2019-06-28 00:00:00,2019-06-28 04:00:00,1415.2,1414.25,1,-95,65565.9,Exit After X Bars,,None,None,None,None
1207_240906005_B,186,XAUUSD,Buy,2019-07-02 16:00:00,2019-07-02 20:00:00,1396.28,1404.96,1,868,66433.9,Exit After X Bars,,None,None,None,None
1212_240906005_B,186,XAUUSD,Buy,2019-07-10 12:00:00,2019-07-10 16:00:00,1400.03,1410.09,1,1006,67439.9,Exit After X Bars,,None,None,None,None
1215_240906005_B,186,XAUUSD,Buy,2019-07-17 16:00:00,2019-07-17 20:00:00,1416.24,1422.27,1,603,68042.9,Exit After X Bars,,None,None,None,None
1217_240906005_B,186,XAUUSD,Buy,2019-07-23 16:00:00,2019-07-23 20:00:00,1429.05,1419.41,1,-964,67078.9,Exit After X Bars,,None,None,None,None
1219_240906005_B,186,XAUUSD,Buy,2019-07-25 12:00:00,2019-07-25 16:00:00,1429.45,1424.48,1,-497,66581.9,Exit After X Bars,,None,None,None,None
1221_240906005_B,186,XAUUSD,Buy,2019-07-29 20:00:00,2019-07-30 00:00:00,1424.77,1426.49,1,172,66753.9,Exit After X Bars,,None,None,None,None
1222_240906005_B,186,XAUUSD,Buy,2019-08-01 20:00:00,2019-08-02 00:00:00,1434.26,1444.8,1,1054,67807.9,Exit After X Bars,,None,None,None,None
1223_240906005_B,186,XAUUSD,Buy,2019-08-12 12:00:00,2019-08-12 16:00:00,1505.88,1501.91,1,-397,67410.9,Exit After X Bars,,None,None,None,None
1225_240906005_B,186,XAUUSD,Buy,2019-08-15 20:00:00,2019-08-16 00:00:00,1523.97,1523.39,1,-58,67352.9,Exit After X Bars,,None,None,None,None
1228_240906005_B,186,XAUUSD,Buy,2019-08-20 12:00:00,2019-08-20 16:00:00,1503.35,1504.12,1,77,67429.9,Exit After X Bars,,None,None,None,None
1231_240906005_B,186,XAUUSD,Buy,2019-08-23 12:00:00,2019-08-23 16:00:00,1504.52,1502.29,1,-223,67206.9,Exit After X Bars,,None,None,None,None
1234_240906005_B,186,XAUUSD,Buy,2019-09-03 08:00:00,2019-09-03 12:00:00,1532.76,1532.2,1,-56,67150.9,Exit After X Bars,,None,None,None,None
1235_240906005_B,186,XAUUSD,Buy,2019-09-04 20:00:00,2019-09-05 00:00:00,1550.05,1551.92,1,187,67337.9,Exit After X Bars,,None,None,None,None
1240_240906005_B,186,XAUUSD,Buy,2019-09-12 08:00:00,2019-09-12 12:00:00,1500.95,1504.38,1,343,67680.9,Exit After X Bars,,None,None,None,None
1242_240906005_B,186,XAUUSD,Buy,2019-09-17 16:00:00,2019-09-17 20:00:00,1506.2,1505.75,1,-45,67635.9,Exit After X Bars,,None,None,None,None
1243_240906005_B,186,XAUUSD,Buy,2019-09-20 20:00:00,2019-09-23 00:00:00,1511.56,1513.99,1,243,67878.9,End Of Friday,,None,None,None,None
1248_240906005_B,186,XAUUSD,Buy,2019-10-02 12:00:00,2019-10-02 16:00:00,1487.14,1492.34,1,520,68398.9,Exit After X Bars,,None,None,None,None
1250_240906005_B,186,XAUUSD,Buy,2019-10-08 12:00:00,2019-10-08 16:00:00,1504.07,1503.57,1,-50,68348.9,Exit After X Bars,,None,None,None,None
1256_240906005_B,186,XAUUSD,Buy,2019-10-23 16:00:00,2019-10-23 20:00:00,1495.21,1492.28,1,-293,68055.9,Exit After X Bars,,None,None,None,None
1258_240906005_B,186,XAUUSD,Buy,2019-10-30 12:00:00,2019-10-30 16:00:00,1494.49,1492.42,1,-207,67848.9,Exit After X Bars,,None,None,None,None
1264_240906005_B,186,XAUUSD,Buy,2019-11-13 12:00:00,2019-11-13 16:00:00,1466.38,1461.75,1,-463,67385.9,Exit After X Bars,,None,None,None,None
1266_240906005_B,186,XAUUSD,Buy,2019-11-22 12:00:00,2019-11-22 16:00:00,1471.5,1468.69,1,-281,67104.9,Exit After X Bars,,None,None,None,None
1268_240906005_B,186,XAUUSD,Buy,2019-11-26 16:00:00,2019-11-26 20:00:00,1460.71,1460.05,1,-66,67038.9,Exit After X Bars,,None,None,None,None
1269_240906005_B,186,XAUUSD,Buy,2019-11-29 16:00:00,2019-11-29 20:00:00,1462.85,1463.89,1,104,67142.9,Exit After X Bars,,None,None,None,None
1272_240906005_B,186,XAUUSD,Buy,2019-12-10 12:00:00,2019-12-10 16:00:00,1465.32,1466.97,1,165,67307.9,Exit After X Bars,,None,None,None,None
1273_240906005_B,186,XAUUSD,Buy,2019-12-11 16:00:00,2019-12-11 20:00:00,1469.13,1470.33,1,120,67427.9,Exit After X Bars,,None,None,None,None
1276_240906005_B,186,XAUUSD,Buy,2019-12-19 16:00:00,2019-12-19 20:00:00,1479.21,1479.76,1,55,67482.9,Exit After X Bars,,None,None,None,None
1277_240906005_B,186,XAUUSD,Buy,2020-01-02 12:00:00,2020-01-02 16:00:00,1524.8,1528.01,1,321,67803.9,Exit After X Bars,,None,None,None,None
1278_240906005_B,186,XAUUSD,Buy,2020-01-08 00:00:00,2020-01-08 04:00:00,1579.28,1593.29,1,1401,69204.9,Exit After X Bars,,None,None,None,None
1280_240906005_B,186,XAUUSD,Buy,2020-01-10 12:00:00,2020-01-10 16:00:00,1556.49,1548.64,1,-785,68419.9,Exit After X Bars,,None,None,None,None
1284_240906005_B,186,XAUUSD,Buy,2020-01-17 12:00:00,2020-01-17 16:00:00,1557.42,1555.36,1,-206,68213.9,Exit After X Bars,,None,None,None,None
1286_240906005_B,186,XAUUSD,Buy,2020-01-23 00:00:00,2020-01-23 04:00:00,1559.95,1559.89,1,-6,68207.9,Exit After X Bars,,None,None,None,None
1287_240906005_B,186,XAUUSD,Buy,2020-01-24 16:00:00,2020-01-24 20:00:00,1567.85,1571.61,1,376,68583.9,Exit After X Bars,,None,None,None,None
1289_240906005_B,186,XAUUSD,Buy,2020-01-30 04:00:00,2020-01-30 08:00:00,1580.67,1578.08,1,-259,68324.9,Exit After X Bars,,None,None,None,None
1290_240906005_B,186,XAUUSD,Buy,2020-01-31 16:00:00,2020-01-31 20:00:00,1585.89,1583.5,1,-239,68085.9,Exit After X Bars,,None,None,None,None
1295_240906005_B,186,XAUUSD,Buy,2020-02-13 04:00:00,2020-02-13 08:00:00,1573.98,1574.09,1,11,68096.9,Exit After X Bars,,None,None,None,None
1298_240906005_B,186,XAUUSD,Buy,2020-02-27 12:00:00,2020-02-27 16:00:00,1650.74,1651.83,1,109,68205.9,Exit After X Bars,,None,None,None,None
1301_240906005_B,186,XAUUSD,Buy,2020-03-03 16:00:00,2020-03-03 20:00:00,1610.96,1645.16,1,3420,71625.9,Exit After X Bars,,None,None,None,None
1303_240906005_B,186,XAUUSD,Buy,2020-03-11 12:00:00,2020-03-11 16:00:00,1667.46,1665.52,1,-194,71431.9,Exit After X Bars,,None,None,None,None
1307_240906005_B,186,XAUUSD,Buy,2020-03-17 16:00:00,2020-03-17 20:00:00,1540.83,1527.22,1,-1361,70070.9,Exit After X Bars,,None,None,None,None
1312_240906005_B,186,XAUUSD,Buy,2020-04-02 12:00:00,2020-04-02 16:00:00,1596.83,1601.04,1,421,70491.9,Exit After X Bars,,None,None,None,None
1314_240906005_B,186,XAUUSD,Buy,2020-04-16 12:00:00,2020-04-16 16:00:00,1726.41,1724.86,1,-155,70336.9,Exit After X Bars,,None,None,None,None
1316_240906005_B,186,XAUUSD,Buy,2020-04-20 16:00:00,2020-04-20 20:00:00,1701.62,1693.91,1,-771,69565.9,Exit After X Bars,,None,None,None,None
1320_240906005_B,186,XAUUSD,Buy,2020-04-29 20:00:00,2020-04-30 00:00:00,1714.57,1711.6,1,-297,69268.9,Exit After X Bars,,None,None,None,None
1321_240906005_B,186,XAUUSD,Buy,2020-04-30 12:00:00,2020-04-30 16:00:00,1717.4,1706.46,1,-1094,68174.9,Exit After X Bars,,None,None,None,None
1323_240906005_B,186,XAUUSD,Buy,2020-05-04 12:00:00,2020-05-04 16:00:00,1705.07,1701.12,1,-395,67779.9,Exit After X Bars,,None,None,None,None
1326_240906005_B,186,XAUUSD,Buy,2020-05-07 16:00:00,2020-05-07 20:00:00,1704.85,1715.17,1,1032,68811.9,Exit After X Bars,,None,None,None,None
1328_240906005_B,186,XAUUSD,Buy,2020-05-12 16:00:00,2020-05-12 20:00:00,1708.17,1702.46,1,-571,68240.9,Exit After X Bars,,None,None,None,None
1329_240906005_B,186,XAUUSD,Buy,2020-05-13 12:00:00,2020-05-13 16:00:00,1710.7,1712.08,1,138,68378.9,Exit After X Bars,,None,None,None,None
1336_240906005_B,186,XAUUSD,Buy,2020-05-29 12:00:00,2020-05-29 16:00:00,1727.43,1730.55,1,312,68690.9,Exit After X Bars,,None,None,None,None
1340_240906005_B,186,XAUUSD,Buy,2020-06-09 12:00:00,2020-06-09 16:00:00,1711.58,1716.31,1,473,69163.9,Exit After X Bars,,None,None,None,None
1342_240906005_B,186,XAUUSD,Buy,2020-06-18 08:00:00,2020-06-18 12:00:00,1732.0,1732.86,1,86,69249.9,Exit After X Bars,,None,None,None,None
1343_240906005_B,186,XAUUSD,Buy,2020-06-19 16:00:00,2020-06-19 20:00:00,1737.44,1741.5,1,406,69655.9,Exit After X Bars,,None,None,None,None
1345_240906005_B,186,XAUUSD,Buy,2020-06-26 16:00:00,2020-06-26 20:00:00,1766.41,1767.46,1,105,69760.9,Exit After X Bars,,None,None,None,None
1346_240906005_B,186,XAUUSD,Buy,2020-06-29 20:00:00,2020-06-30 00:00:00,1771.95,1769.79,1,-216,69544.9,Exit After X Bars,,None,None,None,None
1347_240906005_B,186,XAUUSD,Buy,2020-06-30 16:00:00,2020-06-30 20:00:00,1774.06,1783.36,1,930,70474.9,Exit After X Bars,,None,None,None,None
1350_240906005_B,186,XAUUSD,Buy,2020-07-06 12:00:00,2020-07-06 16:00:00,1776.98,1783.07,1,609,71083.9,Exit After X Bars,,None,None,None,None
1351_240906005_B,186,XAUUSD,Buy,2020-07-07 16:00:00,2020-07-07 20:00:00,1786.92,1795.77,1,885,71968.9,Exit After X Bars,,None,None,None,None
1353_240906005_B,186,XAUUSD,Buy,2020-07-13 16:00:00,2020-07-13 20:00:00,1810.5,1809.68,1,-82,71886.9,Exit After X Bars,,None,None,None,None
1354_240906005_B,186,XAUUSD,Buy,2020-07-15 08:00:00,2020-07-15 12:00:00,1813.2,1812.4,1,-80,71806.9,Exit After X Bars,,None,None,None,None
1356_240906005_B,186,XAUUSD,Buy,2020-07-17 16:00:00,2020-07-17 20:00:00,1808.72,1807.75,1,-97,71709.9,Exit After X Bars,,None,None,None,None
1357_240906005_B,186,XAUUSD,Buy,2020-07-29 20:00:00,2020-07-30 00:00:00,1967.18,1969.59,1,241,71950.9,Exit After X Bars,,None,None,None,None
1358_240906005_B,186,XAUUSD,Buy,2020-07-31 08:00:00,2020-07-31 12:00:00,1980.8,1976.84,1,-396,71554.9,Exit After X Bars,,None,None,None,None
1359_240906005_B,186,XAUUSD,Buy,2020-08-04 04:00:00,2020-08-04 08:00:00,1978.2,1974.49,1,-371,71183.9,Exit After X Bars,,None,None,None,None
1364_240906005_B,186,XAUUSD,Buy,2020-08-13 16:00:00,2020-08-13 20:00:00,1949.15,1953.66,1,451,71634.9,Exit After X Bars,,None,None,None,None
1366_240906005_B,186,XAUUSD,Buy,2020-08-17 12:00:00,2020-08-17 16:00:00,1956.28,1958.03,1,175,71809.9,Exit After X Bars,,None,None,None,None
1370_240906005_B,186,XAUUSD,Buy,2020-08-26 16:00:00,2020-08-26 20:00:00,1931.91,1943.23,1,1132,72941.9,Exit After X Bars,,None,None,None,None
1373_240906005_B,186,XAUUSD,Buy,2020-09-04 12:00:00,2020-09-04 16:00:00,1945.75,1927.17,1,-1858,71083.9,Exit After X Bars,,None,None,None,None
1375_240906005_B,186,XAUUSD,Buy,2020-09-08 16:00:00,2020-09-08 20:00:00,1932.57,1938.77,1,620,71703.9,Exit After X Bars,,None,None,None,None
1376_240906005_B,186,XAUUSD,Buy,2020-09-09 16:00:00,2020-09-09 20:00:00,1940.75,1948.25,1,750,72453.9,Exit After X Bars,,None,None,None,None
1383_240906005_B,186,XAUUSD,Buy,2020-09-28 16:00:00,2020-09-28 20:00:00,1872.57,1874.47,1,190,72643.9,Exit After X Bars,,None,None,None,None
1384_240906005_B,186,XAUUSD,Buy,2020-10-05 16:00:00,2020-10-05 20:00:00,1911.9,1916.22,1,432,73075.9,Exit After X Bars,,None,None,None,None
1387_240906005_B,186,XAUUSD,Buy,2020-10-16 12:00:00,2020-10-16 16:00:00,1912.83,1906.71,1,-612,72463.9,Exit After X Bars,,None,None,None,None
1388_240906005_B,186,XAUUSD,Buy,2020-10-19 12:00:00,2020-10-19 16:00:00,1913.81,1911.79,1,-202,72261.9,Exit After X Bars,,None,None,None,None
1389_240906005_B,186,XAUUSD,Buy,2020-10-21 04:00:00,2020-10-21 08:00:00,1918.34,1918.98,1,64,72325.9,Exit After X Bars,,None,None,None,None
1393_240906005_B,186,XAUUSD,Buy,2020-10-27 16:00:00,2020-10-27 20:00:00,1908.46,1909.17,1,71,72396.9,Exit After X Bars,,None,None,None,None
1396_240906005_B,186,XAUUSD,Buy,2020-10-30 12:00:00,2020-10-30 16:00:00,1881.74,1887.35,1,561,72957.9,Exit After X Bars,,None,None,None,None
1400_240906005_B,186,XAUUSD,Buy,2020-11-12 16:00:00,2020-11-12 20:00:00,1881.83,1877.3,1,-453,72504.9,Exit After X Bars,,None,None,None,None
1404_240906005_B,186,XAUUSD,Buy,2020-11-20 12:00:00,2020-11-20 16:00:00,1867.61,1867.3,1,-31,72473.9,Exit After X Bars,,None,None,None,None
1410_240906005_B,186,XAUUSD,Buy,2020-12-01 12:00:00,2020-12-01 16:00:00,1809.68,1812.76,1,308,72781.9,Exit After X Bars,,None,None,None,None
1419_240906005_B,186,XAUUSD,Buy,2020-12-30 16:00:00,2020-12-30 20:00:00,1886.28,1888.73,1,245,73026.9,Exit After X Bars,,None,None,None,None
1423_240906005_B,186,XAUUSD,Buy,2021-01-12 20:00:00,2021-01-13 00:00:00,1852.4,1854.33,1,193,73219.9,Exit After X Bars,,None,None,None,None
1427_240906005_B,186,XAUUSD,Buy,2021-01-20 08:00:00,2021-01-20 12:00:00,1855.8,1854.51,1,-129,73090.9,Exit After X Bars,,None,None,None,None
1431_240906005_B,186,XAUUSD,Buy,2021-01-28 12:00:00,2021-01-28 16:00:00,1850.49,1856.92,1,643,73733.9,Exit After X Bars,,None,None,None,None
1432_240906005_B,186,XAUUSD,Buy,2021-01-29 12:00:00,2021-01-29 16:00:00,1863.92,1871.93,1,801,74534.9,Exit After X Bars,,None,None,None,None
1442_240906005_B,186,XAUUSD,Buy,2021-02-19 16:00:00,2021-02-19 20:00:00,1789.47,1783.0,1,-647,73887.9,Exit After X Bars,,None,None,None,None
1453_240906005_B,186,XAUUSD,Buy,2021-03-23 12:00:00,2021-03-23 16:00:00,1740.99,1739.18,1,-181,73706.9,Exit After X Bars,,None,None,None,None
1454_240906005_B,186,XAUUSD,Buy,2021-03-25 16:00:00,2021-03-25 20:00:00,1742.38,1728.18,1,-1420,72286.9,Exit After X Bars,,None,None,None,None
1458_240906005_B,186,XAUUSD,Buy,2021-03-31 16:00:00,2021-03-31 20:00:00,1700.83,1711.84,1,1101,73387.9,Exit After X Bars,,None,None,None,None
1461_240906005_B,186,XAUUSD,Buy,2021-04-13 16:00:00,2021-04-13 20:00:00,1744.94,1742.5,1,-244,73143.9,Exit After X Bars,,None,None,None,None
1462_240906005_B,186,XAUUSD,Buy,2021-04-21 16:00:00,2021-04-21 20:00:00,1789.97,1790.73,1,76,73219.9,Exit After X Bars,,None,None,None,None
1464_240906005_B,186,XAUUSD,Buy,2021-04-23 12:00:00,2021-04-23 16:00:00,1790.62,1793.44,1,282,73501.9,Exit After X Bars,,None,None,None,None
1466_240906005_B,186,XAUUSD,Buy,2021-04-27 12:00:00,2021-04-27 16:00:00,1782.4,1782.93,1,53,73554.9,Exit After X Bars,,None,None,None,None
1467_240906005_B,186,XAUUSD,Buy,2021-04-29 00:00:00,2021-04-29 04:00:00,1785.46,1784.61,1,-85,73469.9,Exit After X Bars,,None,None,None,None
1469_240906005_B,186,XAUUSD,Buy,2021-05-06 16:00:00,2021-05-06 20:00:00,1798.88,1815.7,1,1682,75151.9,Exit After X Bars,,None,None,None,None
1470_240906005_B,186,XAUUSD,Buy,2021-05-12 16:00:00,2021-05-12 20:00:00,1841.72,1820.23,1,-2149,73002.9,Exit After X Bars,,None,None,None,None
1473_240906005_B,186,XAUUSD,Buy,2021-05-21 12:00:00,2021-05-21 16:00:00,1883.76,1886.94,1,318,73320.9,Exit After X Bars,,None,None,None,None
1475_240906005_B,186,XAUUSD,Buy,2021-05-25 16:00:00,2021-05-25 20:00:00,1886.14,1895.23,1,909,74229.9,Exit After X Bars,,None,None,None,None
1477_240906005_B,186,XAUUSD,Buy,2021-05-28 16:00:00,2021-05-28 20:00:00,1898.74,1899.75,1,101,74330.9,Exit After X Bars,,None,None,None,None
1482_240906005_B,186,XAUUSD,Buy,2021-06-07 20:00:00,2021-06-08 00:00:00,1896.1,1897.97,1,187,74517.9,Exit After X Bars,,None,None,None,None
1485_240906005_B,186,XAUUSD,Buy,2021-06-10 20:00:00,2021-06-11 00:00:00,1898.92,1897.78,1,-114,74403.9,Exit After X Bars,,None,None,None,None
1494_240906005_B,186,XAUUSD,Buy,2021-07-01 04:00:00,2021-07-01 08:00:00,1775.84,1774.39,1,-145,74258.9,Exit After X Bars,,None,None,None,None
1495_240906005_B,186,XAUUSD,Buy,2021-07-13 04:00:00,2021-07-13 08:00:00,1812.3,1809.55,1,-275,73983.9,Exit After X Bars,,None,None,None,None
1498_240906005_B,186,XAUUSD,Buy,2021-07-20 12:00:00,2021-07-20 16:00:00,1815.45,1822.68,1,723,74706.9,Exit After X Bars,,None,None,None,None
1500_240906005_B,186,XAUUSD,Buy,2021-07-23 08:00:00,2021-07-23 12:00:00,1808.84,1804.31,1,-453,74253.9,Exit After X Bars,,None,None,None,None
1502_240906005_B,186,XAUUSD,Buy,2021-07-28 20:00:00,2021-07-29 00:00:00,1805.12,1806.93,1,181,74434.9,Exit After X Bars,,None,None,None,None
1505_240906005_B,186,XAUUSD,Buy,2021-08-04 12:00:00,2021-08-04 16:00:00,1814.91,1827.06,1,1215,75649.9,Exit After X Bars,,None,None,None,None
1510_240906005_B,186,XAUUSD,Buy,2021-08-11 12:00:00,2021-08-11 16:00:00,1733.64,1744.61,1,1097,76746.9,Exit After X Bars,,None,None,None,None
1511_240906005_B,186,XAUUSD,Buy,2021-08-19 16:00:00,2021-08-19 20:00:00,1791.11,1782.5,1,-861,75885.9,Exit After X Bars,,None,None,None,None
1513_240906005_B,186,XAUUSD,Buy,2021-08-26 16:00:00,2021-08-26 20:00:00,1797.67,1792.11,1,-556,75329.9,Exit After X Bars,,None,None,None,None
1515_240906005_B,186,XAUUSD,Buy,2021-09-03 12:00:00,2021-09-03 16:00:00,1817.0,1823.4,1,640,75969.9,Exit After X Bars,,None,None,None,None
1518_240906005_B,186,XAUUSD,Buy,2021-09-10 08:00:00,2021-09-10 12:00:00,1802.07,1801.59,1,-48,75921.9,Exit After X Bars,,None,None,None,None
1520_240906005_B,186,XAUUSD,Buy,2021-09-14 12:00:00,2021-09-14 16:00:00,1798.26,1797.16,1,-110,75811.9,Exit After X Bars,,None,None,None,None
1523_240906005_B,186,XAUUSD,Buy,2021-09-21 12:00:00,2021-09-21 16:00:00,1767.42,1771.79,1,437,76248.9,Exit After X Bars,,None,None,None,None
1528_240906005_B,186,XAUUSD,Buy,2021-09-29 12:00:00,2021-09-29 16:00:00,1743.76,1738.32,1,-544,75704.9,Exit After X Bars,,None,None,None,None
1529_240906005_B,186,XAUUSD,Buy,2021-09-30 16:00:00,2021-09-30 20:00:00,1745.42,1758.15,1,1273,76977.9,Exit After X Bars,,None,None,None,None
1530_240906005_B,186,XAUUSD,Buy,2021-10-06 16:00:00,2021-10-06 20:00:00,1762.93,1762.34,1,-59,76918.9,Exit After X Bars,,None,None,None,None
1532_240906005_B,186,XAUUSD,Buy,2021-10-12 12:00:00,2021-10-12 16:00:00,1760.09,1757.51,1,-258,76660.9,Exit After X Bars,,None,None,None,None
1535_240906005_B,186,XAUUSD,Buy,2021-10-20 12:00:00,2021-10-20 16:00:00,1785.04,1786.43,1,139,76799.9,Exit After X Bars,,None,None,None,None
1537_240906005_B,186,XAUUSD,Buy,2021-10-28 12:00:00,2021-10-28 16:00:00,1804.52,1798.98,1,-554,76245.9,Exit After X Bars,,None,None,None,None
1542_240906005_B,186,XAUUSD,Buy,2021-11-04 12:00:00,2021-11-04 16:00:00,1785.55,1792.52,1,697,76942.9,Exit After X Bars,,None,None,None,None
1543_240906005_B,186,XAUUSD,Buy,2021-11-12 20:00:00,2021-11-15 00:00:00,1865.9,1869.36,1,346,77288.9,End Of Friday,,None,None,None,None
1550_240906005_B,186,XAUUSD,Buy,2021-11-26 00:00:00,2021-11-26 04:00:00,1793.13,1792.39,1,-74,77214.9,Exit After X Bars,,None,None,None,None
1552_240906005_B,186,XAUUSD,Buy,2021-12-03 16:00:00,2021-12-03 20:00:00,1781.15,1780.42,1,-73,77141.9,Exit After X Bars,,None,None,None,None
1555_240906005_B,186,XAUUSD,Buy,2021-12-16 08:00:00,2021-12-16 12:00:00,1785.58,1785.43,1,-15,77126.9,Exit After X Bars,,None,None,None,None
1556_240906005_B,186,XAUUSD,Buy,2021-12-21 12:00:00,2021-12-21 16:00:00,1800.08,1797.87,1,-221,76905.9,Exit After X Bars,,None,None,None,None
1557_240906005_B,186,XAUUSD,Buy,2021-12-22 20:00:00,2021-12-23 00:00:00,1800.44,1803.8,1,336,77241.9,Exit After X Bars,,None,None,None,None
1559_240906005_B,186,XAUUSD,Buy,2021-12-30 16:00:00,2021-12-30 20:00:00,1805.65,1813.42,1,777,78018.9,Exit After X Bars,,None,None,None,None
1561_240906005_B,186,XAUUSD,Buy,2022-01-05 12:00:00,2022-01-05 16:00:00,1827.41,1825.4,1,-201,77817.9,Exit After X Bars,,None,None,None,None
1564_240906005_B,186,XAUUSD,Buy,2022-01-10 12:00:00,2022-01-10 16:00:00,1798.52,1792.91,1,-561,77256.9,Exit After X Bars,,None,None,None,None
1567_240906005_B,186,XAUUSD,Buy,2022-01-19 12:00:00,2022-01-19 16:00:00,1820.05,1823.91,1,386,77642.9,Exit After X Bars,,None,None,None,None
1568_240906005_B,186,XAUUSD,Buy,2022-01-25 16:00:00,2022-01-25 20:00:00,1844.03,1849.7,1,567,78209.9,Exit After X Bars,,None,None,None,None
1572_240906005_B,186,XAUUSD,Buy,2022-01-31 12:00:00,2022-01-31 16:00:00,1792.87,1797.59,1,472,78681.9,Exit After X Bars,,None,None,None,None
1573_240906005_B,186,XAUUSD,Buy,2022-02-02 16:00:00,2022-02-02 20:00:00,1808.64,1809.98,1,134,78815.9,Exit After X Bars,,None,None,None,None
1574_240906005_B,186,XAUUSD,Buy,2022-02-11 20:00:00,2022-02-14 00:00:00,1841.84,1859.23,1,1739,80554.9,End Of Friday,,None,None,None,None
1577_240906005_B,186,XAUUSD,Buy,2022-02-23 16:00:00,2022-02-23 20:00:00,1907.04,1908.22,1,118,80672.9,Exit After X Bars,,None,None,None,None
1579_240906005_B,186,XAUUSD,Buy,2022-02-28 12:00:00,2022-02-28 16:00:00,1913.8,1917.14,1,334,81006.9,Exit After X Bars,,None,None,None,None
1580_240906005_B,186,XAUUSD,Buy,2022-03-01 12:00:00,2022-03-01 16:00:00,1918.16,1916.73,1,-143,80863.9,Exit After X Bars,,None,None,None,None
1582_240906005_B,186,XAUUSD,Buy,2022-03-03 12:00:00,2022-03-03 16:00:00,1935.52,1926.01,1,-951,79912.9,Exit After X Bars,,None,None,None,None
1588_240906005_B,186,XAUUSD,Buy,2022-03-17 04:00:00,2022-03-17 08:00:00,1934.81,1935.8,1,99,80011.9,Exit After X Bars,,None,None,None,None
1590_240906005_B,186,XAUUSD,Buy,2022-03-21 20:00:00,2022-03-22 00:00:00,1940.71,1935.43,1,-528,79483.9,Exit After X Bars,,None,None,None,None
1592_240906005_B,186,XAUUSD,Buy,2022-03-23 12:00:00,2022-03-23 16:00:00,1930.8,1928.83,1,-197,79286.9,Exit After X Bars,,None,None,None,None
1595_240906005_B,186,XAUUSD,Buy,2022-03-30 12:00:00,2022-03-30 16:00:00,1921.31,1927.08,1,577,79863.9,Exit After X Bars,,None,None,None,None
1596_240906005_B,186,XAUUSD,Buy,2022-03-31 16:00:00,2022-03-31 20:00:00,1938.43,1944.27,1,584,80447.9,Exit After X Bars,,None,None,None,None
1598_240906005_B,186,XAUUSD,Buy,2022-04-04 16:00:00,2022-04-04 20:00:00,1936.36,1931.39,1,-497,79950.9,Exit After X Bars,,None,None,None,None
1600_240906005_B,186,XAUUSD,Buy,2022-04-07 12:00:00,2022-04-07 16:00:00,1933.35,1927.55,1,-580,79370.9,Exit After X Bars,,None,None,None,None
1608_240906005_B,186,XAUUSD,Buy,2022-04-29 08:00:00,2022-04-29 12:00:00,1906.9,1913.84,1,694,80064.9,Exit After X Bars,,None,None,None,None
1611_240906005_B,186,XAUUSD,Buy,2022-05-04 20:00:00,2022-05-05 00:00:00,1878.0,1881.3,1,330,80394.9,Exit After X Bars,,None,None,None,None
1618_240906005_B,186,XAUUSD,Buy,2022-05-16 20:00:00,2022-05-17 00:00:00,1824.52,1824.7,1,18,80412.9,Exit After X Bars,,None,None,None,None
1619_240906005_B,186,XAUUSD,Buy,2022-05-19 12:00:00,2022-05-19 16:00:00,1836.0,1838.19,1,219,80631.9,Exit After X Bars,,None,None,None,None
1620_240906005_B,186,XAUUSD,Buy,2022-05-27 08:00:00,2022-05-27 12:00:00,1859.29,1856.65,1,-264,80367.9,Exit After X Bars,,None,None,None,None
1622_240906005_B,186,XAUUSD,Buy,2022-06-02 12:00:00,2022-06-02 16:00:00,1855.31,1856.51,1,120,80487.9,Exit After X Bars,,None,None,None,None
1625_240906005_B,186,XAUUSD,Buy,2022-06-08 16:00:00,2022-06-08 20:00:00,1855.46,1855.32,1,-14,80473.9,Exit After X Bars,,None,None,None,None
1627_240906005_B,186,XAUUSD,Buy,2022-06-10 16:00:00,2022-06-10 20:00:00,1852.53,1871.61,1,1908,82381.9,Exit After X Bars,,None,None,None,None
1630_240906005_B,186,XAUUSD,Buy,2022-06-15 12:00:00,2022-06-15 16:00:00,1825.69,1831.58,1,589,82970.9,Exit After X Bars,,None,None,None,None
1632_240906005_B,186,XAUUSD,Buy,2022-06-22 12:00:00,2022-06-22 16:00:00,1843.52,1844.59,1,107,83077.9,Exit After X Bars,,None,None,None,None
1636_240906005_B,186,XAUUSD,Buy,2022-06-29 12:00:00,2022-06-29 16:00:00,1827.75,1831.18,1,343,83420.9,Exit After X Bars,,None,None,None,None
1642_240906005_B,186,XAUUSD,Buy,2022-07-08 16:00:00,2022-07-08 20:00:00,1749.01,1742.24,1,-677,82743.9,Exit After X Bars,,None,None,None,None
1645_240906005_B,186,XAUUSD,Buy,2022-07-13 16:00:00,2022-07-13 20:00:00,1739.31,1737.85,1,-146,82597.9,Exit After X Bars,,None,None,None,None
1648_240906005_B,186,XAUUSD,Buy,2022-07-21 16:00:00,2022-07-21 20:00:00,1714.41,1711.62,1,-279,82318.9,Exit After X Bars,,None,None,None,None
1649_240906005_B,186,XAUUSD,Buy,2022-08-04 12:00:00,2022-08-04 16:00:00,1787.93,1780.64,1,-729,81589.9,Exit After X Bars,,None,None,None,None
1651_240906005_B,186,XAUUSD,Buy,2022-08-08 16:00:00,2022-08-08 20:00:00,1789.12,1787.56,1,-156,81433.9,Exit After X Bars,,None,None,None,None
1652_240906005_B,186,XAUUSD,Buy,2022-08-10 16:00:00,2022-08-10 20:00:00,1800.36,1798.1,1,-226,81207.9,Exit After X Bars,,None,None,None,None
1654_240906005_B,186,XAUUSD,Buy,2022-08-12 20:00:00,2022-08-15 00:00:00,1799.15,1802.31,1,316,81523.9,End Of Friday,,None,None,None,None
1661_240906005_B,186,XAUUSD,Buy,2022-08-23 16:00:00,2022-08-23 20:00:00,1739.93,1749.64,1,971,82494.9,Exit After X Bars,,None,None,None,None
1667_240906005_B,186,XAUUSD,Buy,2022-09-02 12:00:00,2022-09-02 16:00:00,1708.6,1708.73,1,13,82507.9,Exit After X Bars,,None,None,None,None
1668_240906005_B,186,XAUUSD,Buy,2022-09-07 16:00:00,2022-09-07 20:00:00,1714.94,1714.98,1,4,82511.9,Exit After X Bars,,None,None,None,None
1678_240906005_B,186,XAUUSD,Buy,2022-09-28 16:00:00,2022-09-28 20:00:00,1642.34,1659.16,1,1682,84193.9,Exit After X Bars,,None,None,None,None
1683_240906005_B,186,XAUUSD,Buy,2022-10-13 12:00:00,2022-10-13 16:00:00,1678.22,1654.55,1,-2367,81826.9,Exit After X Bars,,None,None,None,None
1685_240906005_B,186,XAUUSD,Buy,2022-10-17 12:00:00,2022-10-17 16:00:00,1663.86,1666.48,1,262,82088.9,Exit After X Bars,,None,None,None,None
1688_240906005_B,186,XAUUSD,Buy,2022-10-20 16:00:00,2022-10-20 20:00:00,1642.02,1636.03,1,-599,81489.9,Exit After X Bars,,None,None,None,None
1689_240906005_B,186,XAUUSD,Buy,2022-10-21 16:00:00,2022-10-21 20:00:00,1645.44,1651.3,1,586,82075.9,Exit After X Bars,,None,None,None,None
1692_240906005_B,186,XAUUSD,Buy,2022-11-04 16:00:00,2022-11-04 20:00:00,1669.26,1673.16,1,390,82465.9,Exit After X Bars,,None,None,None,None
1697_240906005_B,186,XAUUSD,Buy,2022-11-22 12:00:00,2022-11-22 16:00:00,1746.85,1743.52,1,-333,82132.9,Exit After X Bars,,None,None,None,None
1698_240906005_B,186,XAUUSD,Buy,2022-11-23 20:00:00,2022-11-24 00:00:00,1749.6,1749.33,1,-27,82105.9,Exit After X Bars,,None,None,None,None
1700_240906005_B,186,XAUUSD,Buy,2022-11-29 08:00:00,2022-11-29 12:00:00,1756.19,1753.91,1,-228,81877.9,Exit After X Bars,,None,None,None,None
1702_240906005_B,186,XAUUSD,Buy,2022-12-07 16:00:00,2022-12-07 20:00:00,1780.73,1782.96,1,223,82100.9,Exit After X Bars,,None,None,None,None
1703_240906005_B,186,XAUUSD,Buy,2022-12-08 12:00:00,2022-12-08 16:00:00,1790.36,1789.41,1,-95,82005.9,Exit After X Bars,,None,None,None,None
1705_240906005_B,186,XAUUSD,Buy,2022-12-13 12:00:00,2022-12-13 16:00:00,1795.33,1810.86,1,1553,83558.9,Exit After X Bars,,None,None,None,None
1707_240906005_B,186,XAUUSD,Buy,2022-12-16 12:00:00,2022-12-16 16:00:00,1785.9,1785.4,1,-50,83508.9,Exit After X Bars,,None,None,None,None
1710_240906005_B,186,XAUUSD,Buy,2022-12-29 12:00:00,2022-12-29 16:00:00,1809.35,1810.3,1,95,83603.9,Exit After X Bars,,None,None,None,None
1712_240906005_B,186,XAUUSD,Buy,2023-01-06 12:00:00,2023-01-06 16:00:00,1851.05,1851.63,1,58,83661.9,Exit After X Bars,,None,None,None,None
1714_240906005_B,186,XAUUSD,Buy,2023-01-18 12:00:00,2023-01-18 16:00:00,1916.55,1921.2,1,465,84126.9,Exit After X Bars,,None,None,None,None
1715_240906005_B,186,XAUUSD,Buy,2023-01-19 20:00:00,2023-01-20 00:00:00,1925.8,1931.74,1,594,84720.9,Exit After X Bars,,None,None,None,None
1716_240906005_B,186,XAUUSD,Buy,2023-01-23 20:00:00,2023-01-24 00:00:00,1931.2,1930.6,1,-60,84660.9,Exit After X Bars,,None,None,None,None
1717_240906005_B,186,XAUUSD,Buy,2023-01-24 20:00:00,2023-01-25 00:00:00,1935.72,1937.4,1,168,84828.9,Exit After X Bars,,None,None,None,None
1718_240906005_B,186,XAUUSD,Buy,2023-01-25 16:00:00,2023-01-25 20:00:00,1939.28,1937.2,1,-208,84620.9,Exit After X Bars,,None,None,None,None
1722_240906005_B,186,XAUUSD,Buy,2023-01-31 20:00:00,2023-02-01 00:00:00,1930.62,1927.54,1,-308,84312.9,Exit After X Bars,,None,None,None,None
1723_240906005_B,186,XAUUSD,Buy,2023-02-01 12:00:00,2023-02-01 16:00:00,1931.0,1929.13,1,-187,84125.9,Exit After X Bars,,None,None,None,None
1726_240906005_B,186,XAUUSD,Buy,2023-02-07 16:00:00,2023-02-07 20:00:00,1875.66,1880.47,1,481,84606.9,Exit After X Bars,,None,None,None,None
1727_240906005_B,186,XAUUSD,Buy,2023-02-09 08:00:00,2023-02-09 12:00:00,1884.35,1883.04,1,-131,84475.9,Exit After X Bars,,None,None,None,None
1730_240906005_B,186,XAUUSD,Buy,2023-02-14 12:00:00,2023-02-14 16:00:00,1862.95,1862.46,1,-49,84426.9,Exit After X Bars,,None,None,None,None
1732_240906005_B,186,XAUUSD,Buy,2023-02-16 16:00:00,2023-02-16 20:00:00,1842.16,1842.34,1,18,84444.9,Exit After X Bars,,None,None,None,None
1737_240906005_B,186,XAUUSD,Buy,2023-02-28 16:00:00,2023-02-28 20:00:00,1820.06,1829.15,1,909,85353.9,Exit After X Bars,,None,None,None,None
1740_240906005_B,186,XAUUSD,Buy,2023-03-09 12:00:00,2023-03-09 16:00:00,1824.19,1825.06,1,87,85440.9,Exit After X Bars,,None,None,None,None
1742_240906005_B,186,XAUUSD,Buy,2023-03-22 20:00:00,2023-03-23 00:00:00,1969.74,1969.71,1,-3,85437.9,Exit After X Bars,,None,None,None,None
1744_240906005_B,186,XAUUSD,Buy,2023-03-28 16:00:00,2023-03-28 20:00:00,1968.6,1968.94,1,34,85471.9,Exit After X Bars,,None,None,None,None
1746_240906005_B,186,XAUUSD,Buy,2023-03-30 12:00:00,2023-03-30 16:00:00,1971.61,1970.18,1,-143,85328.9,Exit After X Bars,,None,None,None,None
1748_240906005_B,186,XAUUSD,Buy,2023-04-03 16:00:00,2023-04-03 20:00:00,1987.49,1986.82,1,-67,85261.9,Exit After X Bars,,None,None,None,None
1749_240906005_B,186,XAUUSD,Buy,2023-04-04 16:00:00,2023-04-04 20:00:00,1990.37,2020.68,1,3031,88292.9,Exit After X Bars,,None,None,None,None
1751_240906005_B,186,XAUUSD,Buy,2023-04-11 16:00:00,2023-04-11 20:00:00,2002.88,2006.04,1,316,88608.9,Exit After X Bars,,None,None,None,None
1756_240906005_B,186,XAUUSD,Buy,2023-04-20 12:00:00,2023-04-20 16:00:00,1996.75,2006.61,1,986,89594.9,Exit After X Bars,,None,None,None,None
1758_240906005_B,186,XAUUSD,Buy,2023-04-25 00:00:00,2023-04-25 04:00:00,1997.86,1996.92,1,-94,89500.9,Exit After X Bars,,None,None,None,None
1761_240906005_B,186,XAUUSD,Buy,2023-05-01 12:00:00,2023-05-01 16:00:00,1994.92,2004.07,1,915,90415.9,Exit After X Bars,,None,None,None,None
1762_240906005_B,186,XAUUSD,Buy,2023-05-02 16:00:00,2023-05-02 20:00:00,2005.85,2015.04,1,919,91334.9,Exit After X Bars,,None,None,None,None
1765_240906005_B,186,XAUUSD,Buy,2023-05-09 12:00:00,2023-05-09 16:00:00,2029.33,2026.93,1,-240,91094.9,Exit After X Bars,,None,None,None,None
1772_240906005_B,186,XAUUSD,Buy,2023-05-19 16:00:00,2023-05-19 20:00:00,1978.83,1978.26,1,-57,91037.9,Exit After X Bars,,None,None,None,None
1773_240906005_B,186,XAUUSD,Buy,2023-05-24 12:00:00,2023-05-24 16:00:00,1982.51,1979.84,1,-267,90770.9,Exit After X Bars,,None,None,None,None
1777_240906005_B,186,XAUUSD,Buy,2023-05-30 12:00:00,2023-05-30 16:00:00,1949.58,1956.33,1,675,91445.9,Exit After X Bars,,None,None,None,None
1779_240906005_B,186,XAUUSD,Buy,2023-06-08 16:00:00,2023-06-08 20:00:00,1970.09,1966.18,1,-391,91054.9,Exit After X Bars,,None,None,None,None
1782_240906005_B,186,XAUUSD,Buy,2023-06-16 04:00:00,2023-06-16 08:00:00,1960.21,1955.39,1,-482,90572.9,Exit After X Bars,,None,None,None,None
1787_240906005_B,186,XAUUSD,Buy,2023-06-23 16:00:00,2023-06-23 20:00:00,1930.88,1918.59,1,-1229,89343.9,Exit After X Bars,,None,None,None,None
1789_240906005_B,186,XAUUSD,Buy,2023-06-30 12:00:00,2023-06-30 16:00:00,1913.24,1910.94,1,-230,89113.9,Exit After X Bars,,None,None,None,None
1791_240906005_B,186,XAUUSD,Buy,2023-07-07 12:00:00,2023-07-07 16:00:00,1927.51,1918.66,1,-885,88228.9,Exit After X Bars,,None,None,None,None
1792_240906005_B,186,XAUUSD,Buy,2023-07-18 08:00:00,2023-07-18 12:00:00,1962.58,1961.65,1,-93,88135.9,Exit After X Bars,,None,None,None,None
1795_240906005_B,186,XAUUSD,Buy,2023-07-26 08:00:00,2023-07-26 12:00:00,1967.73,1972.0,1,427,88562.9,Exit After X Bars,,None,None,None,None
1798_240906005_B,186,XAUUSD,Buy,2023-07-31 12:00:00,2023-07-31 16:00:00,1963.37,1965.36,1,199,88761.9,Exit After X Bars,,None,None,None,None
1802_240906005_B,186,XAUUSD,Buy,2023-08-04 12:00:00,2023-08-04 16:00:00,1938.66,1938.92,1,26,88787.9,Exit After X Bars,,None,None,None,None
1806_240906005_B,186,XAUUSD,Buy,2023-08-10 12:00:00,2023-08-10 16:00:00,1928.24,1926.09,1,-215,88572.9,Exit After X Bars,,None,None,None,None
1813_240906005_B,186,XAUUSD,Buy,2023-08-21 12:00:00,2023-08-21 16:00:00,1896.68,1897.12,1,44,88616.9,Exit After X Bars,,None,None,None,None
1818_240906005_B,186,XAUUSD,Buy,2023-09-08 16:00:00,2023-09-08 20:00:00,1924.4,1919.53,1,-487,88129.9,Exit After X Bars,,None,None,None,None
1819_240906005_B,186,XAUUSD,Buy,2023-09-11 16:00:00,2023-09-11 20:00:00,1929.6,1923.35,1,-625,87504.9,Exit After X Bars,,None,None,None,None
1822_240906005_B,186,XAUUSD,Buy,2023-09-15 04:00:00,2023-09-15 08:00:00,1915.66,1916.0,1,34,87538.9,Exit After X Bars,,None,None,None,None
1824_240906005_B,186,XAUUSD,Buy,2023-09-22 16:00:00,2023-09-22 20:00:00,1926.01,1925.23,1,-78,87460.9,Exit After X Bars,,None,None,None,None
1829_240906005_B,186,XAUUSD,Buy,2023-09-29 16:00:00,2023-09-29 20:00:00,1879.49,1853.54,1,-2595,84865.9,Exit After X Bars,,None,None,None,None
1833_240906005_B,186,XAUUSD,Buy,2023-10-06 16:00:00,2023-10-06 20:00:00,1830.46,1829.1,1,-136,84729.9,Exit After X Bars,,None,None,None,None
1836_240906005_B,186,XAUUSD,Buy,2023-10-25 16:00:00,2023-10-25 20:00:00,1977.49,1978.15,1,66,84795.9,Exit After X Bars,,None,None,None,None
1837_240906005_B,186,XAUUSD,Buy,2023-10-26 20:00:00,2023-10-27 00:00:00,1987.12,1984.49,1,-263,84532.9,Exit After X Bars,,None,None,None,None
1838_240906005_B,186,XAUUSD,Buy,2023-10-27 20:00:00,2023-10-30 00:00:00,1992.08,2004.14,1,1206,85738.9,End Of Friday,,None,None,None,None
1840_240906005_B,186,XAUUSD,Buy,2023-10-31 16:00:00,2023-10-31 20:00:00,2002.44,1990.73,1,-1171,84567.9,Exit After X Bars,,None,None,None,None
1843_240906005_B,186,XAUUSD,Buy,2023-11-03 12:00:00,2023-11-03 16:00:00,1990.94,2000.05,1,911,85478.9,Exit After X Bars,,None,None,None,None
1850_240906005_B,186,XAUUSD,Buy,2023-11-14 12:00:00,2023-11-14 16:00:00,1949.12,1954.21,1,509,85987.9,Exit After X Bars,,None,None,None,None
1851_240906005_B,186,XAUUSD,Buy,2023-11-21 04:00:00,2023-11-21 08:00:00,1993.34,1991.69,1,-165,85822.9,Exit After X Bars,,None,None,None,None
1853_240906005_B,186,XAUUSD,Buy,2023-11-24 12:00:00,2023-11-24 16:00:00,1994.86,1999.55,1,469,86291.9,Exit After X Bars,,None,None,None,None
1854_240906005_B,186,XAUUSD,Buy,2023-12-01 08:00:00,2023-12-01 12:00:00,2049.44,2046.33,1,-311,85980.9,Exit After X Bars,,None,None,None,None
1856_240906005_B,186,XAUUSD,Buy,2023-12-06 12:00:00,2023-12-06 16:00:00,2030.78,2030.17,1,-61,85919.9,Exit After X Bars,,None,None,None,None
1857_240906005_B,186,XAUUSD,Buy,2023-12-08 00:00:00,2023-12-08 04:00:00,2032.94,2032.19,1,-75,85844.9,Exit After X Bars,,None,None,None,None
1860_240906005_B,186,XAUUSD,Buy,2023-12-13 20:00:00,2023-12-14 00:00:00,1996.63,2025.95,1,2932,88776.9,Exit After X Bars,,None,None,None,None
1862_240906005_B,186,XAUUSD,Buy,2023-12-19 16:00:00,2023-12-19 20:00:00,2033.62,2040.32,1,670,89446.9,Exit After X Bars,,None,None,None,None
1867_240906005_B,186,XAUUSD,Buy,2024-01-05 16:00:00,2024-01-05 20:00:00,2050.76,2041.84,1,-892,88554.9,Exit After X Bars,,None,None,None,None
1869_240906005_B,186,XAUUSD,Buy,2024-01-09 12:00:00,2024-01-09 16:00:00,2036.78,2038.49,1,171,88725.9,Exit After X Bars,,None,None,None,None
1870_240906005_B,186,XAUUSD,Buy,2024-01-11 12:00:00,2024-01-11 16:00:00,2041.9,2029.37,1,-1253,87472.9,Exit After X Bars,,None,None,None,None
1873_240906005_B,186,XAUUSD,Buy,2024-01-19 08:00:00,2024-01-19 12:00:00,2028.9,2029.64,1,74,87546.9,Exit After X Bars,,None,None,None,None
1876_240906005_B,186,XAUUSD,Buy,2024-02-01 20:00:00,2024-02-02 00:00:00,2055.88,2053.79,1,-209,87337.9,Exit After X Bars,,None,None,None,None
1879_240906005_B,186,XAUUSD,Buy,2024-02-06 12:00:00,2024-02-06 16:00:00,2028.51,2029.07,1,56,87393.9,Exit After X Bars,,None,None,None,None
1883_240906005_B,186,XAUUSD,Buy,2024-02-13 12:00:00,2024-02-13 16:00:00,2027.51,2004.31,1,-2320,85073.9,Exit After X Bars,,None,None,None,None
1885_240906005_B,186,XAUUSD,Buy,2024-02-23 16:00:00,2024-02-23 20:00:00,2031.15,2037.91,1,676,85749.9,Exit After X Bars,,None,None,None,None
1886_240906005_B,186,XAUUSD,Buy,2024-02-29 12:00:00,2024-02-29 16:00:00,2038.98,2047.56,1,858,86607.9,Exit After X Bars,,None,None,None,None
1890_240906005_B,186,XAUUSD,Buy,2024-03-15 12:00:00,2024-03-15 16:00:00,2171.94,2161.7,1,-1024,85583.9,Exit After X Bars,,None,None,None,None
1893_240906005_B,186,XAUUSD,Buy,2024-03-20 16:00:00,2024-03-20 20:00:00,2159.57,2157.61,1,-196,85387.9,Exit After X Bars,,None,None,None,None
1895_240906005_B,186,XAUUSD,Buy,2024-03-25 16:00:00,2024-03-25 20:00:00,2180.03,2175.72,1,-431,84956.9,Exit After X Bars,,None,None,None,None
1896_240906005_B,186,XAUUSD,Buy,2024-03-26 12:00:00,2024-03-26 16:00:00,2181.21,2187.85,1,664,85620.9,Exit After X Bars,,None,None,None,None
1897_240906005_B,186,XAUUSD,Buy,2024-03-28 08:00:00,2024-03-28 12:00:00,2199.99,2194.65,1,-534,85086.9,Exit After X Bars,,None,None,None,None
1898_240906005_B,186,XAUUSD,Buy,2024-04-05 16:00:00,2024-04-05 20:00:00,2305.43,2327.17,1,2174,87260.9,Exit After X Bars,,None,None,None,None
1900_240906005_B,186,XAUUSD,Buy,2024-04-11 20:00:00,2024-04-12 00:00:00,2354.74,2371.5,1,1676,88936.9,Exit After X Bars,,None,None,None,None
1902_240906005_B,186,XAUUSD,Buy,2024-04-16 16:00:00,2024-04-16 20:00:00,2392.03,2397.41,1,538,89474.9,Exit After X Bars,,None,None,None,None
1904_240906005_B,186,XAUUSD,Buy,2024-04-19 04:00:00,2024-04-19 08:00:00,2395.45,2383.48,1,-1197,88277.9,Exit After X Bars,,None,None,None,None
1907_240906005_B,186,XAUUSD,Buy,2024-04-24 16:00:00,2024-04-24 20:00:00,2332.05,2324.97,1,-708,87569.9,Exit After X Bars,,None,None,None,None
1908_240906005_B,186,XAUUSD,Buy,2024-04-25 16:00:00,2024-04-25 20:00:00,2337.13,2328.62,1,-851,86718.9,Exit After X Bars,,None,None,None,None
1911_240906005_B,186,XAUUSD,Buy,2024-05-01 20:00:00,2024-05-02 00:00:00,2317.9,2319.3,1,140,86858.9,Exit After X Bars,,None,None,None,None
1913_240906005_B,186,XAUUSD,Buy,2024-05-03 12:00:00,2024-05-03 16:00:00,2309.34,2304.69,1,-465,86393.9,Exit After X Bars,,None,None,None,None
1914_240906005_B,186,XAUUSD,Buy,2024-05-09 12:00:00,2024-05-09 16:00:00,2320.95,2326.59,1,564,86957.9,Exit After X Bars,,None,None,None,None
1916_240906005_B,186,XAUUSD,Buy,2024-05-14 12:00:00,2024-05-14 16:00:00,2349.68,2348.16,1,-152,86805.9,Exit After X Bars,,None,None,None,None
1921_240906005_B,186,XAUUSD,Buy,2024-05-27 12:00:00,2024-05-27 16:00:00,2347.32,2347.06,1,-26,86779.9,Exit After X Bars,,None,None,None,None
1922_240906005_B,186,XAUUSD,Buy,2024-05-28 16:00:00,2024-05-28 20:00:00,2358.39,2356.51,1,-188,86591.9,Exit After X Bars,,None,None,None,None
1924_240906005_B,186,XAUUSD,Buy,2024-05-30 16:00:00,2024-05-30 20:00:00,2347.12,2347.76,1,64,86655.9,Exit After X Bars,,None,None,None,None
1925_240906005_B,186,XAUUSD,Buy,2024-05-31 12:00:00,2024-05-31 16:00:00,2351.7,2354.55,1,285,86940.9,Exit After X Bars,,None,None,None,None
1928_240906005_B,186,XAUUSD,Buy,2024-06-05 12:00:00,2024-06-05 16:00:00,2337.93,2342.02,1,409,87349.9,Exit After X Bars,,None,None,None,None
1931_240906005_B,186,XAUUSD,Buy,2024-06-11 12:00:00,2024-06-11 16:00:00,2313.66,2317.84,1,418,87767.9,Exit After X Bars,,None,None,None,None
1933_240906005_B,186,XAUUSD,Buy,2024-06-14 12:00:00,2024-06-14 16:00:00,2326.49,2330.23,1,374,88141.9,Exit After X Bars,,None,None,None,None
1935_240906005_B,186,XAUUSD,Buy,2024-06-25 12:00:00,2024-06-25 16:00:00,2334.59,2324.05,1,-1054,87087.9,Exit After X Bars,,None,None,None,None
1937_240906005_B,186,XAUUSD,Buy,2024-06-27 12:00:00,2024-06-27 16:00:00,2318.28,2322.74,1,446,87533.9,Exit After X Bars,,None,None,None,None
1941_240906005_B,186,XAUUSD,Buy,2024-07-23 12:00:00,2024-07-23 16:00:00,2408.27,2405.27,1,-300,87233.9,Exit After X Bars,,None,None,None,None
1942_240906005_B,186,XAUUSD,Buy,2024-07-24 12:00:00,2024-07-24 16:00:00,2411.91,2421.36,1,945,88178.9,Exit After X Bars,,None,None,None,None
1944_240906005_B,186,XAUUSD,Buy,2024-07-26 16:00:00,2024-07-26 20:00:00,2382.49,2389.07,1,658,88836.9,Exit After X Bars,,None,None,None,None
1945_240906005_B,186,XAUUSD,Buy,2024-07-30 16:00:00,2024-07-30 20:00:00,2396.59,2399.83,1,324,89160.9,Exit After X Bars,,None,None,None,None
1949_240906005_B,186,XAUUSD,Buy,2024-08-08 12:00:00,2024-08-08 16:00:00,2406.86,2407.93,1,107,89267.9,Exit After X Bars,,None,None,None,None
1951_240906005_B,186,XAUUSD,Buy,2024-08-16 12:00:00,2024-08-16 16:00:00,2469.95,2491.56,1,2161,91428.9,Exit After X Bars,,None,None,None,None
1954_240906005_B,186,XAUUSD,Buy,2024-08-23 16:00:00,2024-08-23 20:00:00,2509.01,2510.2,1,119,91547.9,Exit After X Bars,,None,None,None,None
1955_240906005_B,186,XAUUSD,Buy,2024-08-28 00:00:00,2024-08-28 04:00:00,2526.71,2524.28,1,-243,91304.9,Exit After X Bars,,None,None,None,None
1956_240906005_B,186,XAUUSD,Buy,2024-08-29 16:00:00,2024-08-29 20:00:00,2515.16,2525.14,1,998,92302.9,Exit After X Bars,,None,None,None,None
