orderId,strategyRunId,symbol,orderType,openTime,closeTime,openPrice,closePrice,size,profit,balance,closeType,comment,sl,tp,swap,commission
5_240906006_B,187,XAUUSD,Buy,2011-01-11 08:00:00,2011-01-11 12:00:00,1380.11,1378.29,1,-182,9818,Exit After X Bars,,None,None,None,None
12_240906006_B,187,XAUUSD,Buy,2011-01-26 20:00:00,2011-01-27 00:00:00,1336.5,1345.98,1,948,10766,Exit After X Bars,,None,None,None,None
16_240906006_B,187,XAUUSD,Buy,2011-02-11 12:00:00,2011-02-11 16:00:00,1366.98,1365.53,1,-145,10621,Exit After X Bars,,None,None,None,None
17_240906006_B,187,XAUUSD,Buy,2011-02-15 08:00:00,2011-02-15 12:00:00,1369.11,1371.67,1,256,10877,Exit After X Bars,,None,None,None,None
19_240906006_B,187,XAUUSD,Buy,2011-02-23 16:00:00,2011-02-23 20:00:00,1408.13,1415.25,1,712,11589,Exit After X Bars,,None,None,None,None
22_240906006_B,187,XAUUSD,Buy,2011-02-28 12:00:00,2011-02-28 16:00:00,1413.04,1411.62,1,-142,11447,Exit After X Bars,,None,None,None,None
23_240906006_B,187,XAUUSD,Buy,2011-03-01 12:00:00,2011-03-01 16:00:00,1417.09,1419.47,1,238,11685,Exit After X Bars,,None,None,None,None
26_240906006_B,187,XAUUSD,Buy,2011-03-07 20:00:00,2011-03-08 00:00:00,1432.85,1431.33,1,-152,11533,Exit After X Bars,,None,None,None,None
31_240906006_B,187,XAUUSD,Buy,2011-03-14 12:00:00,2011-03-14 16:00:00,1427.27,1427.1,1,-17,11516,Exit After X Bars,,None,None,None,None
34_240906006_B,187,XAUUSD,Buy,2011-03-18 00:00:00,2011-03-18 04:00:00,1408.86,1406.99,1,-187,11329,Exit After X Bars,,None,None,None,None
38_240906006_B,187,XAUUSD,Buy,2011-03-30 12:00:00,2011-03-30 16:00:00,1423.85,1428.01,1,416,11745,Exit After X Bars,,None,None,None,None
43_240906006_B,187,XAUUSD,Buy,2011-04-14 16:00:00,2011-04-14 20:00:00,1462.73,1471.83,1,910,12655,Exit After X Bars,,None,None,None,None
44_240906006_B,187,XAUUSD,Buy,2011-04-21 20:00:00,2011-04-22 00:00:00,1506.85,1504.57,1,-228,12427,Exit After X Bars,,None,None,None,None
56_240906006_B,187,XAUUSD,Buy,2011-05-20 16:00:00,2011-05-20 20:00:00,1505.37,1511.1,1,573,13000,Exit After X Bars,,None,None,None,None
57_240906006_B,187,XAUUSD,Buy,2011-05-31 16:00:00,2011-05-31 20:00:00,1540.26,1536.0,1,-426,12574,Exit After X Bars,,None,None,None,None
58_240906006_B,187,XAUUSD,Buy,2011-06-01 16:00:00,2011-06-01 20:00:00,1541.36,1545.4,1,404,12978,Exit After X Bars,,None,None,None,None
60_240906006_B,187,XAUUSD,Buy,2011-06-03 16:00:00,2011-06-03 20:00:00,1544.85,1541.86,1,-299,12679,Exit After X Bars,,None,None,None,None
61_240906006_B,187,XAUUSD,Buy,2011-06-06 16:00:00,2011-06-06 20:00:00,1546.03,1551.51,1,548,13227,Exit After X Bars,,None,None,None,None
64_240906006_B,187,XAUUSD,Buy,2011-06-09 16:00:00,2011-06-09 20:00:00,1543.77,1544.6,1,83,13310,Exit After X Bars,,None,None,None,None
68_240906006_B,187,XAUUSD,Buy,2011-06-15 16:00:00,2011-06-15 20:00:00,1526.93,1524.58,1,-235,13075,Exit After X Bars,,None,None,None,None
72_240906006_B,187,XAUUSD,Buy,2011-06-29 08:00:00,2011-06-29 12:00:00,1506.47,1508.24,1,177,13252,Exit After X Bars,,None,None,None,None
78_240906006_B,187,XAUUSD,Buy,2011-07-22 16:00:00,2011-07-22 20:00:00,1605.37,1600.72,1,-465,12787,Exit After X Bars,,None,None,None,None
79_240906006_B,187,XAUUSD,Buy,2011-07-27 00:00:00,2011-07-27 04:00:00,1622.21,1622.23,1,2,12789,Exit After X Bars,,None,None,None,None
81_240906006_B,187,XAUUSD,Buy,2011-07-29 12:00:00,2011-07-29 16:00:00,1620.74,1623.19,1,245,13034,Exit After X Bars,,None,None,None,None
83_240906006_B,187,XAUUSD,Buy,2011-08-02 12:00:00,2011-08-02 16:00:00,1632.63,1637.39,1,476,13510,Exit After X Bars,,None,None,None,None
87_240906006_B,187,XAUUSD,Buy,2011-08-16 08:00:00,2011-08-16 12:00:00,1771.61,1778.08,1,647,14157,Exit After X Bars,,None,None,None,None
88_240906006_B,187,XAUUSD,Buy,2011-08-17 16:00:00,2011-08-17 20:00:00,1788.19,1784.78,1,-341,13816,Exit After X Bars,,None,None,None,None
89_240906006_B,187,XAUUSD,Buy,2011-08-18 12:00:00,2011-08-18 16:00:00,1796.09,1816.92,1,2083,15899,Exit After X Bars,,None,None,None,None
93_240906006_B,187,XAUUSD,Buy,2011-08-26 16:00:00,2011-08-26 20:00:00,1779.56,1786.25,1,669,16568,Exit After X Bars,,None,None,None,None
95_240906006_B,187,XAUUSD,Buy,2011-08-30 12:00:00,2011-08-30 16:00:00,1827.31,1825.21,1,-210,16358,Exit After X Bars,,None,None,None,None
97_240906006_B,187,XAUUSD,Buy,2011-09-09 08:00:00,2011-09-09 12:00:00,1883.93,1883.07,1,-86,16272,Exit After X Bars,,None,None,None,None
113_240906006_B,187,XAUUSD,Buy,2011-10-21 12:00:00,2011-10-21 16:00:00,1633.89,1642.71,1,882,17154,Exit After X Bars,,None,None,None,None
116_240906006_B,187,XAUUSD,Buy,2011-11-03 12:00:00,2011-11-03 16:00:00,1745.27,1761.62,1,1635,18789,Exit After X Bars,,None,None,None,None
120_240906006_B,187,XAUUSD,Buy,2011-11-11 16:00:00,2011-11-11 20:00:00,1778.89,1786.78,1,789,19578,Exit After X Bars,,None,None,None,None
132_240906006_B,187,XAUUSD,Buy,2011-12-07 12:00:00,2011-12-07 16:00:00,1734.0,1733.37,1,-63,19515,Exit After X Bars,,None,None,None,None
142_240906006_B,187,XAUUSD,Buy,2012-01-17 00:00:00,2012-01-17 04:00:00,1650.31,1652.94,1,263,19778,Exit After X Bars,,None,None,None,None
147_240906006_B,187,XAUUSD,Buy,2012-01-25 16:00:00,2012-01-25 20:00:00,1678.61,1689.7,1,1109,20887,Exit After X Bars,,None,None,None,None
148_240906006_B,187,XAUUSD,Buy,2012-01-31 08:00:00,2012-01-31 12:00:00,1741.02,1742.51,1,149,21036,Exit After X Bars,,None,None,None,None
149_240906006_B,187,XAUUSD,Buy,2012-02-01 12:00:00,2012-02-01 16:00:00,1748.73,1744.87,1,-386,20650,Exit After X Bars,,None,None,None,None
150_240906006_B,187,XAUUSD,Buy,2012-02-02 16:00:00,2012-02-02 20:00:00,1753.08,1755.07,1,199,20849,Exit After X Bars,,None,None,None,None
151_240906006_B,187,XAUUSD,Buy,2012-02-03 12:00:00,2012-02-03 16:00:00,1761.81,1752.12,1,-969,19880,Exit After X Bars,,None,None,None,None
153_240906006_B,187,XAUUSD,Buy,2012-02-07 16:00:00,2012-02-07 20:00:00,1739.33,1746.27,1,694,20574,Exit After X Bars,,None,None,None,None
158_240906006_B,187,XAUUSD,Buy,2012-02-15 16:00:00,2012-02-15 20:00:00,1734.32,1727.41,1,-691,19883,Exit After X Bars,,None,None,None,None
161_240906006_B,187,XAUUSD,Buy,2012-02-28 12:00:00,2012-02-28 16:00:00,1780.06,1780.06,1,0,19883,Exit After X Bars,,None,None,None,None
167_240906006_B,187,XAUUSD,Buy,2012-03-09 16:00:00,2012-03-09 20:00:00,1707.04,1711.65,1,461,20344,Exit After X Bars,,None,None,None,None
171_240906006_B,187,XAUUSD,Buy,2012-03-23 16:00:00,2012-03-23 20:00:00,1663.68,1662.57,1,-111,20233,Exit After X Bars,,None,None,None,None
174_240906006_B,187,XAUUSD,Buy,2012-03-30 12:00:00,2012-03-30 16:00:00,1664.54,1665.58,1,104,20337,Exit After X Bars,,None,None,None,None
175_240906006_B,187,XAUUSD,Buy,2012-04-02 16:00:00,2012-04-02 20:00:00,1672.37,1679.54,1,717,21054,Exit After X Bars,,None,None,None,None
178_240906006_B,187,XAUUSD,Buy,2012-04-06 12:00:00,2012-04-06 16:00:00,1634.2,1641.71,1,751,21805,Exit After X Bars,,None,None,None,None
185_240906006_B,187,XAUUSD,Buy,2012-04-24 12:00:00,2012-04-24 16:00:00,1643.62,1642.25,1,-137,21668,Exit After X Bars,,None,None,None,None
186_240906006_B,187,XAUUSD,Buy,2012-04-26 08:00:00,2012-04-26 12:00:00,1649.86,1648.76,1,-110,21558,Exit After X Bars,,None,None,None,None
197_240906006_B,187,XAUUSD,Buy,2012-05-17 16:00:00,2012-05-17 20:00:00,1565.44,1576.13,1,1069,22627,Exit After X Bars,,None,None,None,None
199_240906006_B,187,XAUUSD,Buy,2012-05-24 12:00:00,2012-05-24 16:00:00,1565.65,1575.66,1,1001,23628,Exit After X Bars,,None,None,None,None
202_240906006_B,187,XAUUSD,Buy,2012-06-01 12:00:00,2012-06-01 16:00:00,1574.87,1581.44,1,657,24285,Exit After X Bars,,None,None,None,None
205_240906006_B,187,XAUUSD,Buy,2012-06-11 20:00:00,2012-06-12 00:00:00,1598.14,1596.16,1,-198,24087,Exit After X Bars,,None,None,None,None
206_240906006_B,187,XAUUSD,Buy,2012-06-12 16:00:00,2012-06-12 20:00:00,1605.75,1611.94,1,619,24706,Exit After X Bars,,None,None,None,None
208_240906006_B,187,XAUUSD,Buy,2012-06-19 12:00:00,2012-06-19 16:00:00,1630.77,1629.61,1,-116,24590,Exit After X Bars,,None,None,None,None
212_240906006_B,187,XAUUSD,Buy,2012-06-25 16:00:00,2012-06-25 20:00:00,1575.18,1583.29,1,811,25401,Exit After X Bars,,None,None,None,None
215_240906006_B,187,XAUUSD,Buy,2012-06-29 12:00:00,2012-06-29 16:00:00,1584.91,1597.36,1,1245,26646,Exit After X Bars,,None,None,None,None
219_240906006_B,187,XAUUSD,Buy,2012-07-10 12:00:00,2012-07-10 16:00:00,1593.6,1600.83,1,723,27369,Exit After X Bars,,None,None,None,None
221_240906006_B,187,XAUUSD,Buy,2012-07-13 12:00:00,2012-07-13 16:00:00,1583.76,1582.39,1,-137,27232,Exit After X Bars,,None,None,None,None
224_240906006_B,187,XAUUSD,Buy,2012-07-24 16:00:00,2012-07-24 20:00:00,1582.09,1575.79,1,-630,26602,Exit After X Bars,,None,None,None,None
230_240906006_B,187,XAUUSD,Buy,2012-08-09 20:00:00,2012-08-10 00:00:00,1617.64,1616.66,1,-98,26504,Exit After X Bars,,None,None,None,None
231_240906006_B,187,XAUUSD,Buy,2012-08-10 16:00:00,2012-08-10 20:00:00,1618.89,1621.52,1,263,26767,Exit After X Bars,,None,None,None,None
234_240906006_B,187,XAUUSD,Buy,2012-08-16 12:00:00,2012-08-16 16:00:00,1607.39,1607.65,1,26,26793,Exit After X Bars,,None,None,None,None
239_240906006_B,187,XAUUSD,Buy,2012-08-31 16:00:00,2012-08-31 20:00:00,1664.71,1681.56,1,1685,28478,Exit After X Bars,,None,None,None,None
240_240906006_B,187,XAUUSD,Buy,2012-09-06 08:00:00,2012-09-06 12:00:00,1700.05,1709.11,1,906,29384,Exit After X Bars,,None,None,None,None
241_240906006_B,187,XAUUSD,Buy,2012-09-07 12:00:00,2012-09-07 16:00:00,1715.13,1724.79,1,966,30350,Exit After X Bars,,None,None,None,None
242_240906006_B,187,XAUUSD,Buy,2012-09-12 08:00:00,2012-09-12 12:00:00,1741.0,1742.76,1,176,30526,Exit After X Bars,,None,None,None,None
243_240906006_B,187,XAUUSD,Buy,2012-09-13 16:00:00,2012-09-13 20:00:00,1747.71,1752.67,1,496,31022,Exit After X Bars,,None,None,None,None
245_240906006_B,187,XAUUSD,Buy,2012-09-19 08:00:00,2012-09-19 12:00:00,1778.02,1774.05,1,-397,30625,Exit After X Bars,,None,None,None,None
248_240906006_B,187,XAUUSD,Buy,2012-09-25 12:00:00,2012-09-25 16:00:00,1768.24,1771.76,1,352,30977,Exit After X Bars,,None,None,None,None
250_240906006_B,187,XAUUSD,Buy,2012-09-27 12:00:00,2012-09-27 16:00:00,1766.48,1764.21,1,-227,30750,Exit After X Bars,,None,None,None,None
251_240906006_B,187,XAUUSD,Buy,2012-10-01 12:00:00,2012-10-01 16:00:00,1784.74,1784.74,1,0,30750,Exit After X Bars,,None,None,None,None
252_240906006_B,187,XAUUSD,Buy,2012-10-04 08:00:00,2012-10-04 12:00:00,1784.83,1785.03,1,20,30770,Exit After X Bars,,None,None,None,None
257_240906006_B,187,XAUUSD,Buy,2012-10-11 12:00:00,2012-10-11 16:00:00,1768.97,1767.0,1,-197,30573,Exit After X Bars,,None,None,None,None
260_240906006_B,187,XAUUSD,Buy,2012-10-17 00:00:00,2012-10-17 04:00:00,1749.76,1750.45,1,69,30642,Exit After X Bars,,None,None,None,None
266_240906006_B,187,XAUUSD,Buy,2012-11-06 16:00:00,2012-11-06 20:00:00,1717.81,1717.26,1,-55,30587,Exit After X Bars,,None,None,None,None
273_240906006_B,187,XAUUSD,Buy,2012-11-23 08:00:00,2012-11-23 12:00:00,1733.02,1734.0,1,98,30685,Exit After X Bars,,None,None,None,None
277_240906006_B,187,XAUUSD,Buy,2012-11-30 12:00:00,2012-11-30 16:00:00,1729.14,1723.27,1,-587,30098,Exit After X Bars,,None,None,None,None
284_240906006_B,187,XAUUSD,Buy,2012-12-18 04:00:00,2012-12-18 08:00:00,1702.65,1702.44,1,-21,30077,Exit After X Bars,,None,None,None,None
290_240906006_B,187,XAUUSD,Buy,2013-01-09 08:00:00,2013-01-09 12:00:00,1663.76,1662.59,1,-117,29960,Exit After X Bars,,None,None,None,None
291_240906006_B,187,XAUUSD,Buy,2013-01-17 16:00:00,2013-01-17 20:00:00,1685.53,1694.35,1,882,30842,Exit After X Bars,,None,None,None,None
293_240906006_B,187,XAUUSD,Buy,2013-01-22 16:00:00,2013-01-22 20:00:00,1692.18,1694.39,1,221,31063,Exit After X Bars,,None,None,None,None
298_240906006_B,187,XAUUSD,Buy,2013-01-29 12:00:00,2013-01-29 16:00:00,1663.36,1663.16,1,-20,31043,Exit After X Bars,,None,None,None,None
300_240906006_B,187,XAUUSD,Buy,2013-02-01 16:00:00,2013-02-01 20:00:00,1681.59,1671.47,1,-1012,30031,Exit After X Bars,,None,None,None,None
301_240906006_B,187,XAUUSD,Buy,2013-02-05 12:00:00,2013-02-05 16:00:00,1683.09,1682.95,1,-14,30017,Exit After X Bars,,None,None,None,None
319_240906006_B,187,XAUUSD,Buy,2013-03-21 12:00:00,2013-03-21 16:00:00,1615.36,1615.14,1,-22,29995,Exit After X Bars,,None,None,None,None
323_240906006_B,187,XAUUSD,Buy,2013-03-27 16:00:00,2013-03-27 20:00:00,1605.21,1605.55,1,34,30029,Exit After X Bars,,None,None,None,None
329_240906006_B,187,XAUUSD,Buy,2013-04-05 12:00:00,2013-04-05 16:00:00,1557.66,1568.42,1,1076,31105,Exit After X Bars,,None,None,None,None
335_240906006_B,187,XAUUSD,Buy,2013-04-19 08:00:00,2013-04-19 12:00:00,1406.37,1416.26,1,989,32094,Exit After X Bars,,None,None,None,None
337_240906006_B,187,XAUUSD,Buy,2013-05-03 08:00:00,2013-05-03 12:00:00,1477.95,1476.7,1,-125,31969,Exit After X Bars,,None,None,None,None
340_240906006_B,187,XAUUSD,Buy,2013-05-08 20:00:00,2013-05-09 00:00:00,1470.62,1473.79,1,317,32286,Exit After X Bars,,None,None,None,None
348_240906006_B,187,XAUUSD,Buy,2013-05-20 20:00:00,2013-05-21 00:00:00,1398.23,1393.85,1,-438,31848,Exit After X Bars,,None,None,None,None
352_240906006_B,187,XAUUSD,Buy,2013-06-06 16:00:00,2013-06-06 20:00:00,1411.44,1416.45,1,501,32349,Exit After X Bars,,None,None,None,None
356_240906006_B,187,XAUUSD,Buy,2013-06-12 16:00:00,2013-06-12 20:00:00,1387.55,1390.86,1,331,32680,Exit After X Bars,,None,None,None,None
369_240906006_B,187,XAUUSD,Buy,2013-07-16 16:00:00,2013-07-16 20:00:00,1295.05,1291.46,1,-359,32321,Exit After X Bars,,None,None,None,None
370_240906006_B,187,XAUUSD,Buy,2013-07-17 12:00:00,2013-07-17 16:00:00,1296.53,1291.87,1,-466,31855,Exit After X Bars,,None,None,None,None
372_240906006_B,187,XAUUSD,Buy,2013-07-19 12:00:00,2013-07-19 16:00:00,1289.1,1291.65,1,255,32110,Exit After X Bars,,None,None,None,None
378_240906006_B,187,XAUUSD,Buy,2013-07-31 20:00:00,2013-08-01 00:00:00,1332.8,1323.42,1,-938,31172,Exit After X Bars,,None,None,None,None
383_240906006_B,187,XAUUSD,Buy,2013-08-08 16:00:00,2013-08-08 20:00:00,1308.04,1310.27,1,223,31395,Exit After X Bars,,None,None,None,None
385_240906006_B,187,XAUUSD,Buy,2013-08-21 20:00:00,2013-08-22 00:00:00,1378.54,1366.09,1,-1245,30150,Exit After X Bars,,None,None,None,None
386_240906006_B,187,XAUUSD,Buy,2013-08-22 16:00:00,2013-08-22 20:00:00,1381.5,1371.75,1,-975,29175,Exit After X Bars,,None,None,None,None
387_240906006_B,187,XAUUSD,Buy,2013-08-23 16:00:00,2013-08-23 20:00:00,1383.21,1395.8,1,1259,30434,Exit After X Bars,,None,None,None,None
391_240906006_B,187,XAUUSD,Buy,2013-09-03 12:00:00,2013-09-03 16:00:00,1399.27,1398.01,1,-126,30308,Exit After X Bars,,None,None,None,None
401_240906006_B,187,XAUUSD,Buy,2013-09-18 20:00:00,2013-09-18 20:00:00,1327.58,1351.08,1,2350,32658,PT,,None,None,None,None
403_240906006_B,187,XAUUSD,Buy,2013-09-25 16:00:00,2013-09-25 20:00:00,1333.21,1337.14,1,393,33051,Exit After X Bars,,None,None,None,None
410_240906006_B,187,XAUUSD,Buy,2013-10-17 08:00:00,2013-10-17 12:00:00,1291.91,1305.41,1,1350,34401,Exit After X Bars,,None,None,None,None
411_240906006_B,187,XAUUSD,Buy,2013-10-25 20:00:00,2013-10-28 00:00:00,1352.67,1353.48,1,81,34482,End Of Friday,,None,None,None,None
412_240906006_B,187,XAUUSD,Buy,2013-10-28 16:00:00,2013-10-28 20:00:00,1356.99,1353.27,1,-372,34110,Exit After X Bars,,None,None,None,None
419_240906006_B,187,XAUUSD,Buy,2013-11-06 12:00:00,2013-11-06 16:00:00,1320.57,1316.76,1,-381,33729,Exit After X Bars,,None,None,None,None
424_240906006_B,187,XAUUSD,Buy,2013-11-14 00:00:00,2013-11-14 04:00:00,1286.39,1282.24,1,-415,33314,Exit After X Bars,,None,None,None,None
428_240906006_B,187,XAUUSD,Buy,2013-11-25 20:00:00,2013-11-26 00:00:00,1250.34,1251.21,1,87,33401,Exit After X Bars,,None,None,None,None
431_240906006_B,187,XAUUSD,Buy,2013-12-04 12:00:00,2013-12-04 16:00:00,1226.92,1225.9,1,-102,33299,Exit After X Bars,,None,None,None,None
434_240906006_B,187,XAUUSD,Buy,2013-12-16 16:00:00,2013-12-16 20:00:00,1239.37,1246.12,1,675,33974,Exit After X Bars,,None,None,None,None
439_240906006_B,187,XAUUSD,Buy,2013-12-26 12:00:00,2013-12-26 16:00:00,1208.38,1212.34,1,396,34370,Exit After X Bars,,None,None,None,None
440_240906006_B,187,XAUUSD,Buy,2013-12-31 16:00:00,2013-12-31 20:00:00,1212.01,1204.8,1,-721,33649,Exit After X Bars,,None,None,None,None
443_240906006_B,187,XAUUSD,Buy,2014-01-10 04:00:00,2014-01-10 08:00:00,1232.6,1236.55,1,395,34044,Exit After X Bars,,None,None,None,None
446_240906006_B,187,XAUUSD,Buy,2014-01-16 16:00:00,2014-01-16 20:00:00,1243.02,1241.14,1,-188,33856,Exit After X Bars,,None,None,None,None
447_240906006_B,187,XAUUSD,Buy,2014-01-17 12:00:00,2014-01-17 16:00:00,1245.69,1248.12,1,243,34099,Exit After X Bars,,None,None,None,None
452_240906006_B,187,XAUUSD,Buy,2014-01-29 12:00:00,2014-01-29 16:00:00,1263.06,1266.85,1,379,34478,Exit After X Bars,,None,None,None,None
455_240906006_B,187,XAUUSD,Buy,2014-02-03 16:00:00,2014-02-03 20:00:00,1255.63,1259.36,1,373,34851,Exit After X Bars,,None,None,None,None
456_240906006_B,187,XAUUSD,Buy,2014-02-05 12:00:00,2014-02-05 16:00:00,1266.84,1265.41,1,-143,34708,Exit After X Bars,,None,None,None,None
459_240906006_B,187,XAUUSD,Buy,2014-02-20 20:00:00,2014-02-21 00:00:00,1323.47,1322.82,1,-65,34643,Exit After X Bars,,None,None,None,None
460_240906006_B,187,XAUUSD,Buy,2014-02-21 20:00:00,2014-02-24 00:00:00,1325.86,1325.35,1,-51,34592,End Of Friday,,None,None,None,None
461_240906006_B,187,XAUUSD,Buy,2014-02-25 16:00:00,2014-02-25 20:00:00,1339.94,1342.44,1,250,34842,Exit After X Bars,,None,None,None,None
467_240906006_B,187,XAUUSD,Buy,2014-03-06 16:00:00,2014-03-06 20:00:00,1342.5,1348.87,1,637,35479,Exit After X Bars,,None,None,None,None
469_240906006_B,187,XAUUSD,Buy,2014-03-12 04:00:00,2014-03-12 08:00:00,1353.57,1357.11,1,354,35833,Exit After X Bars,,None,None,None,None
474_240906006_B,187,XAUUSD,Buy,2014-03-21 20:00:00,2014-03-24 00:00:00,1336.92,1331.93,1,-499,35334,End Of Friday,,None,None,None,None
485_240906006_B,187,XAUUSD,Buy,2014-04-24 16:00:00,2014-04-24 20:00:00,1289.35,1289.87,1,52,35386,Exit After X Bars,,None,None,None,None
489_240906006_B,187,XAUUSD,Buy,2014-05-02 16:00:00,2014-05-02 20:00:00,1291.68,1298.41,1,673,36059,Exit After X Bars,,None,None,None,None
493_240906006_B,187,XAUUSD,Buy,2014-05-12 12:00:00,2014-05-12 16:00:00,1296.75,1300.66,1,391,36450,Exit After X Bars,,None,None,None,None
494_240906006_B,187,XAUUSD,Buy,2014-05-14 12:00:00,2014-05-14 16:00:00,1304.53,1307.38,1,285,36735,Exit After X Bars,,None,None,None,None
498_240906006_B,187,XAUUSD,Buy,2014-05-22 12:00:00,2014-05-22 16:00:00,1297.07,1300.41,1,334,37069,Exit After X Bars,,None,None,None,None
507_240906006_B,187,XAUUSD,Buy,2014-06-18 12:00:00,2014-06-18 16:00:00,1273.65,1271.69,1,-196,36873,Exit After X Bars,,None,None,None,None
508_240906006_B,187,XAUUSD,Buy,2014-06-24 20:00:00,2014-06-25 00:00:00,1320.69,1318.05,1,-264,36609,Exit After X Bars,,None,None,None,None
511_240906006_B,187,XAUUSD,Buy,2014-06-27 16:00:00,2014-06-27 20:00:00,1319.66,1318.3,1,-136,36473,Exit After X Bars,,None,None,None,None
512_240906006_B,187,XAUUSD,Buy,2014-06-30 20:00:00,2014-07-01 00:00:00,1322.65,1327.15,1,450,36923,Exit After X Bars,,None,None,None,None
513_240906006_B,187,XAUUSD,Buy,2014-07-01 16:00:00,2014-07-01 20:00:00,1329.87,1327.64,1,-223,36700,Exit After X Bars,,None,None,None,None
518_240906006_B,187,XAUUSD,Buy,2014-07-08 12:00:00,2014-07-08 16:00:00,1320.27,1321.99,1,172,36872,Exit After X Bars,,None,None,None,None
522_240906006_B,187,XAUUSD,Buy,2014-07-17 12:00:00,2014-07-17 16:00:00,1304.31,1305.77,1,146,37018,Exit After X Bars,,None,None,None,None
524_240906006_B,187,XAUUSD,Buy,2014-07-25 20:00:00,2014-07-28 00:00:00,1305.32,1307.57,1,225,37243,End Of Friday,,None,None,None,None
528_240906006_B,187,XAUUSD,Buy,2014-08-06 12:00:00,2014-08-06 16:00:00,1296.12,1302.07,1,595,37838,Exit After X Bars,,None,None,None,None
529_240906006_B,187,XAUUSD,Buy,2014-08-14 12:00:00,2014-08-14 16:00:00,1318.08,1314.57,1,-351,37487,Exit After X Bars,,None,None,None,None
536_240906006_B,187,XAUUSD,Buy,2014-08-26 04:00:00,2014-08-26 08:00:00,1283.31,1282.24,1,-107,37380,Exit After X Bars,,None,None,None,None
546_240906006_B,187,XAUUSD,Buy,2014-09-23 12:00:00,2014-09-23 16:00:00,1229.14,1225.72,1,-342,37038,Exit After X Bars,,None,None,None,None
547_240906006_B,187,XAUUSD,Buy,2014-09-26 04:00:00,2014-09-26 08:00:00,1226.78,1222.61,1,-417,36621,Exit After X Bars,,None,None,None,None
549_240906006_B,187,XAUUSD,Buy,2014-10-02 04:00:00,2014-10-02 08:00:00,1220.69,1219.5,1,-119,36502,Exit After X Bars,,None,None,None,None
551_240906006_B,187,XAUUSD,Buy,2014-10-08 08:00:00,2014-10-08 12:00:00,1215.24,1218.23,1,299,36801,Exit After X Bars,,None,None,None,None
552_240906006_B,187,XAUUSD,Buy,2014-10-15 16:00:00,2014-10-15 20:00:00,1239.22,1243.93,1,471,37272,Exit After X Bars,,None,None,None,None
554_240906006_B,187,XAUUSD,Buy,2014-10-20 12:00:00,2014-10-20 16:00:00,1242.77,1244.79,1,202,37474,Exit After X Bars,,None,None,None,None
559_240906006_B,187,XAUUSD,Buy,2014-10-28 12:00:00,2014-10-28 16:00:00,1232.85,1232.63,1,-22,37452,Exit After X Bars,,None,None,None,None
564_240906006_B,187,XAUUSD,Buy,2014-11-04 12:00:00,2014-11-04 16:00:00,1174.79,1169.24,1,-555,36897,Exit After X Bars,,None,None,None,None
566_240906006_B,187,XAUUSD,Buy,2014-11-07 16:00:00,2014-11-07 20:00:00,1168.65,1168.07,1,-58,36839,Exit After X Bars,,None,None,None,None
568_240906006_B,187,XAUUSD,Buy,2014-11-21 12:00:00,2014-11-21 16:00:00,1197.69,1202.94,1,525,37364,Exit After X Bars,,None,None,None,None
574_240906006_B,187,XAUUSD,Buy,2014-12-01 16:00:00,2014-12-01 20:00:00,1194.04,1215.34,1,2130,39494,Exit After X Bars,,None,None,None,None
576_240906006_B,187,XAUUSD,Buy,2014-12-09 12:00:00,2014-12-09 16:00:00,1209.0,1217.28,1,828,40322,Exit After X Bars,,None,None,None,None
580_240906006_B,187,XAUUSD,Buy,2014-12-16 12:00:00,2014-12-16 16:00:00,1221.91,1211.4,1,-1051,39271,Exit After X Bars,,None,None,None,None
582_240906006_B,187,XAUUSD,Buy,2014-12-18 12:00:00,2014-12-18 16:00:00,1204.11,1202.87,1,-124,39147,Exit After X Bars,,None,None,None,None
586_240906006_B,187,XAUUSD,Buy,2014-12-26 04:00:00,2014-12-26 08:00:00,1185.39,1184.79,1,-60,39087,Exit After X Bars,,None,None,None,None
589_240906006_B,187,XAUUSD,Buy,2015-01-09 12:00:00,2015-01-09 16:00:00,1217.4,1214.26,1,-314,38773,Exit After X Bars,,None,None,None,None
591_240906006_B,187,XAUUSD,Buy,2015-01-15 12:00:00,2015-01-15 16:00:00,1245.36,1254.5,1,914,39687,Exit After X Bars,,None,None,None,None
593_240906006_B,187,XAUUSD,Buy,2015-01-22 16:00:00,2015-01-22 20:00:00,1306.12,1300.98,1,-514,39173,Exit After X Bars,,None,None,None,None
600_240906006_B,187,XAUUSD,Buy,2015-02-03 08:00:00,2015-02-03 12:00:00,1285.48,1280.88,1,-460,38713,Exit After X Bars,,None,None,None,None
609_240906006_B,187,XAUUSD,Buy,2015-02-26 08:00:00,2015-02-26 12:00:00,1215.93,1219.14,1,321,39034,Exit After X Bars,,None,None,None,None
620_240906006_B,187,XAUUSD,Buy,2015-04-01 12:00:00,2015-04-01 16:00:00,1191.5,1193.54,1,204,39238,Exit After X Bars,,None,None,None,None
621_240906006_B,187,XAUUSD,Buy,2015-04-06 00:00:00,2015-04-06 04:00:00,1213.16,1217.43,1,427,39665,Exit After X Bars,,None,None,None,None
625_240906006_B,187,XAUUSD,Buy,2015-04-10 12:00:00,2015-04-10 16:00:00,1203.09,1204.96,1,187,39852,Exit After X Bars,,None,None,None,None
628_240906006_B,187,XAUUSD,Buy,2015-04-15 20:00:00,2015-04-16 00:00:00,1201.85,1202.18,1,33,39885,Exit After X Bars,,None,None,None,None
634_240906006_B,187,XAUUSD,Buy,2015-04-27 16:00:00,2015-04-27 20:00:00,1196.56,1206.76,1,1020,40905,Exit After X Bars,,None,None,None,None
637_240906006_B,187,XAUUSD,Buy,2015-05-04 12:00:00,2015-05-04 16:00:00,1185.66,1186.28,1,62,40967,Exit After X Bars,,None,None,None,None
639_240906006_B,187,XAUUSD,Buy,2015-05-12 12:00:00,2015-05-12 16:00:00,1192.02,1195.14,1,312,41279,Exit After X Bars,,None,None,None,None
642_240906006_B,187,XAUUSD,Buy,2015-05-22 08:00:00,2015-05-22 12:00:00,1213.83,1212.43,1,-140,41139,Exit After X Bars,,None,None,None,None
646_240906006_B,187,XAUUSD,Buy,2015-05-29 12:00:00,2015-05-29 16:00:00,1191.11,1189.8,1,-131,41008,Exit After X Bars,,None,None,None,None
650_240906006_B,187,XAUUSD,Buy,2015-06-09 08:00:00,2015-06-09 12:00:00,1179.85,1180.13,1,28,41036,Exit After X Bars,,None,None,None,None
651_240906006_B,187,XAUUSD,Buy,2015-06-15 16:00:00,2015-06-15 20:00:00,1184.66,1188.24,1,358,41394,Exit After X Bars,,None,None,None,None
652_240906006_B,187,XAUUSD,Buy,2015-06-17 20:00:00,2015-06-18 00:00:00,1188.28,1184.86,1,-342,41052,Exit After X Bars,,None,None,None,None
657_240906006_B,187,XAUUSD,Buy,2015-06-29 00:00:00,2015-06-29 04:00:00,1184.23,1185.47,1,123.9,41175.9,Exit After X Bars,,None,None,None,None
661_240906006_B,187,XAUUSD,Buy,2015-07-06 16:00:00,2015-07-06 20:00:00,1171.48,1172.13,1,65,41240.9,Exit After X Bars,,None,None,None,None
674_240906006_B,187,XAUUSD,Buy,2015-08-17 12:00:00,2015-08-17 16:00:00,1121.39,1120.73,1,-66,41174.9,Exit After X Bars,,None,None,None,None
675_240906006_B,187,XAUUSD,Buy,2015-08-19 08:00:00,2015-08-19 12:00:00,1123.15,1122.46,1,-69,41105.9,Exit After X Bars,,None,None,None,None
679_240906006_B,187,XAUUSD,Buy,2015-08-28 16:00:00,2015-08-28 20:00:00,1129.84,1135.19,1,535,41640.9,Exit After X Bars,,None,None,None,None
680_240906006_B,187,XAUUSD,Buy,2015-09-01 04:00:00,2015-09-01 08:00:00,1141.62,1142.28,1,66,41706.9,Exit After X Bars,,None,None,None,None
685_240906006_B,187,XAUUSD,Buy,2015-09-08 16:00:00,2015-09-08 20:00:00,1125.42,1123.54,1,-188,41518.9,Exit After X Bars,,None,None,None,None
690_240906006_B,187,XAUUSD,Buy,2015-09-24 08:00:00,2015-09-24 12:00:00,1137.06,1135.35,1,-171,41347.9,Exit After X Bars,,None,None,None,None
695_240906006_B,187,XAUUSD,Buy,2015-10-02 12:00:00,2015-10-02 16:00:00,1119.55,1131.89,1,1234,42581.9,Exit After X Bars,,None,None,None,None
696_240906006_B,187,XAUUSD,Buy,2015-10-09 08:00:00,2015-10-09 12:00:00,1154.33,1153.75,1,-58,42523.9,Exit After X Bars,,None,None,None,None
697_240906006_B,187,XAUUSD,Buy,2015-10-14 04:00:00,2015-10-14 08:00:00,1169.58,1173.73,1,415,42938.9,Exit After X Bars,,None,None,None,None
700_240906006_B,187,XAUUSD,Buy,2015-10-20 16:00:00,2015-10-20 20:00:00,1178.68,1176.93,1,-175,42763.9,Exit After X Bars,,None,None,None,None
705_240906006_B,187,XAUUSD,Buy,2015-10-28 08:00:00,2015-10-28 12:00:00,1170.1,1172.1,1,200,42963.9,Exit After X Bars,,None,None,None,None
714_240906006_B,187,XAUUSD,Buy,2015-12-01 04:00:00,2015-12-01 08:00:00,1071.91,1072.04,1,13,42976.9,Exit After X Bars,,None,None,None,None
716_240906006_B,187,XAUUSD,Buy,2015-12-04 16:00:00,2015-12-04 20:00:00,1071.79,1083.97,1,1218,44194.9,Exit After X Bars,,None,None,None,None
719_240906006_B,187,XAUUSD,Buy,2015-12-11 16:00:00,2015-12-11 20:00:00,1077.77,1075.16,1,-261,43933.9,Exit After X Bars,,None,None,None,None
722_240906006_B,187,XAUUSD,Buy,2015-12-16 12:00:00,2015-12-16 16:00:00,1069.49,1072.87,1,338,44271.9,Exit After X Bars,,None,None,None,None
724_240906006_B,187,XAUUSD,Buy,2015-12-18 16:00:00,2015-12-18 20:00:00,1070.17,1065.61,1,-456,43815.9,Exit After X Bars,,None,None,None,None
726_240906006_B,187,XAUUSD,Buy,2015-12-24 16:00:00,2015-12-24 20:00:00,1075.81,1076.64,1,83,43898.9,Exit After X Bars,,None,None,None,None
728_240906006_B,187,XAUUSD,Buy,2015-12-29 12:00:00,2015-12-29 16:00:00,1075.16,1070.22,1,-494,43404.9,Exit After X Bars,,None,None,None,None
735_240906006_B,187,XAUUSD,Buy,2016-01-15 12:00:00,2016-01-15 16:00:00,1095.8,1093.84,1,-196,43208.9,Exit After X Bars,,None,None,None,None
737_240906006_B,187,XAUUSD,Buy,2016-01-20 08:00:00,2016-01-20 12:00:00,1094.2,1093.24,1,-96,43112.9,Exit After X Bars,,None,None,None,None
742_240906006_B,187,XAUUSD,Buy,2016-02-02 16:00:00,2016-02-02 20:00:00,1130.38,1125.82,1,-456,42656.9,Exit After X Bars,,None,None,None,None
743_240906006_B,187,XAUUSD,Buy,2016-02-03 12:00:00,2016-02-03 16:00:00,1131.58,1126.3,1,-528,42128.9,Exit After X Bars,,None,None,None,None
744_240906006_B,187,XAUUSD,Buy,2016-02-11 00:00:00,2016-02-11 04:00:00,1199.89,1207.95,1,806,42934.9,Exit After X Bars,,None,None,None,None
748_240906006_B,187,XAUUSD,Buy,2016-02-18 16:00:00,2016-02-18 20:00:00,1214.71,1227.06,1,1235,44169.9,Exit After X Bars,,None,None,None,None
751_240906006_B,187,XAUUSD,Buy,2016-02-23 12:00:00,2016-02-23 16:00:00,1225.44,1217.96,1,-748,43421.9,Exit After X Bars,,None,None,None,None
753_240906006_B,187,XAUUSD,Buy,2016-03-01 00:00:00,2016-03-01 04:00:00,1242.65,1246.43,1,378,43799.9,Exit After X Bars,,None,None,None,None
754_240906006_B,187,XAUUSD,Buy,2016-03-03 16:00:00,2016-03-03 20:00:00,1249.94,1256.9,1,696,44495.9,Exit After X Bars,,None,None,None,None
756_240906006_B,187,XAUUSD,Buy,2016-03-10 16:00:00,2016-03-10 20:00:00,1261.44,1272.46,1,1102,45597.9,Exit After X Bars,,None,None,None,None
760_240906006_B,187,XAUUSD,Buy,2016-03-16 20:00:00,2016-03-16 20:00:00,1238.79,1262.29,1,2350,47947.9,PT,,None,None,None,None
764_240906006_B,187,XAUUSD,Buy,2016-03-29 16:00:00,2016-03-29 20:00:00,1225.51,1235.67,1,1016,48963.9,Exit After X Bars,,None,None,None,None
766_240906006_B,187,XAUUSD,Buy,2016-04-05 12:00:00,2016-04-05 16:00:00,1236.12,1234.45,1,-167,48796.9,Exit After X Bars,,None,None,None,None
770_240906006_B,187,XAUUSD,Buy,2016-04-18 12:00:00,2016-04-18 16:00:00,1237.06,1239.54,1,248,49044.9,Exit After X Bars,,None,None,None,None
773_240906006_B,187,XAUUSD,Buy,2016-04-26 16:00:00,2016-04-26 20:00:00,1242.9,1240.55,1,-235,48809.9,Exit After X Bars,,None,None,None,None
776_240906006_B,187,XAUUSD,Buy,2016-05-06 12:00:00,2016-05-06 16:00:00,1287.07,1291.99,1,492,49301.9,Exit After X Bars,,None,None,None,None
779_240906006_B,187,XAUUSD,Buy,2016-05-12 16:00:00,2016-05-12 20:00:00,1279.65,1271.05,1,-860,48441.9,Exit After X Bars,,None,None,None,None
790_240906006_B,187,XAUUSD,Buy,2016-06-03 12:00:00,2016-06-03 16:00:00,1225.2,1236.96,1,1176,49617.9,Exit After X Bars,,None,None,None,None
791_240906006_B,187,XAUUSD,Buy,2016-06-14 16:00:00,2016-06-14 20:00:00,1287.7,1282.08,1,-562,49055.9,Exit After X Bars,,None,None,None,None
792_240906006_B,187,XAUUSD,Buy,2016-06-15 20:00:00,2016-06-16 00:00:00,1290.48,1291.66,1,118,49173.9,Exit After X Bars,,None,None,None,None
797_240906006_B,187,XAUUSD,Buy,2016-06-24 00:00:00,2016-06-24 04:00:00,1271.67,1271.53,1,-14,49159.9,Exit After X Bars,,None,None,None,None
799_240906006_B,187,XAUUSD,Buy,2016-06-29 16:00:00,2016-06-29 20:00:00,1325.45,1324.88,1,-57,49102.9,Exit After X Bars,,None,None,None,None
800_240906006_B,187,XAUUSD,Buy,2016-07-01 04:00:00,2016-07-01 08:00:00,1328.81,1330.3,1,149,49251.9,Exit After X Bars,,None,None,None,None
801_240906006_B,187,XAUUSD,Buy,2016-07-06 00:00:00,2016-07-06 04:00:00,1358.4,1363.03,1,463,49714.9,Exit After X Bars,,None,None,None,None
812_240906006_B,187,XAUUSD,Buy,2016-07-27 20:00:00,2016-07-28 00:00:00,1334.57,1339.0,1,443,50157.9,Exit After X Bars,,None,None,None,None
816_240906006_B,187,XAUUSD,Buy,2016-08-09 16:00:00,2016-08-09 20:00:00,1338.92,1339.93,1,101,50258.9,Exit After X Bars,,None,None,None,None
818_240906006_B,187,XAUUSD,Buy,2016-08-12 12:00:00,2016-08-12 16:00:00,1354.35,1355.01,1,66,50324.9,Exit After X Bars,,None,None,None,None
819_240906006_B,187,XAUUSD,Buy,2016-08-16 12:00:00,2016-08-16 16:00:00,1357.16,1349.02,1,-814,49510.9,Exit After X Bars,,None,None,None,None
822_240906006_B,187,XAUUSD,Buy,2016-08-23 12:00:00,2016-08-23 16:00:00,1340.65,1343.74,1,309,49819.9,Exit After X Bars,,None,None,None,None
825_240906006_B,187,XAUUSD,Buy,2016-08-26 12:00:00,2016-08-26 16:00:00,1327.47,1331.14,1,367,50186.9,Exit After X Bars,,None,None,None,None
829_240906006_B,187,XAUUSD,Buy,2016-09-02 12:00:00,2016-09-02 16:00:00,1317.16,1324.49,1,733,50919.9,Exit After X Bars,,None,None,None,None
834_240906006_B,187,XAUUSD,Buy,2016-09-15 12:00:00,2016-09-15 16:00:00,1326.39,1320.64,1,-575,50344.9,Exit After X Bars,,None,None,None,None
836_240906006_B,187,XAUUSD,Buy,2016-09-21 04:00:00,2016-09-21 08:00:00,1317.89,1311.51,1,-638,49706.9,Exit After X Bars,,None,None,None,None
840_240906006_B,187,XAUUSD,Buy,2016-09-30 12:00:00,2016-09-30 16:00:00,1326.7,1327.32,1,62,49768.9,Exit After X Bars,,None,None,None,None
848_240906006_B,187,XAUUSD,Buy,2016-10-28 16:00:00,2016-10-28 20:00:00,1273.4,1269.81,1,-359,49409.9,Exit After X Bars,,None,None,None,None
849_240906006_B,187,XAUUSD,Buy,2016-11-01 12:00:00,2016-11-01 16:00:00,1284.85,1286.92,1,207,49616.9,Exit After X Bars,,None,None,None,None
853_240906006_B,187,XAUUSD,Buy,2016-11-09 04:00:00,2016-11-09 04:00:00,1294.28,1317.78,1,2350,51966.9,PT,,None,None,None,None
857_240906006_B,187,XAUUSD,Buy,2016-11-16 00:00:00,2016-11-16 04:00:00,1230.72,1231.18,1,46,52012.9,Exit After X Bars,,None,None,None,None
868_240906006_B,187,XAUUSD,Buy,2017-01-03 16:00:00,2017-01-03 20:00:00,1163.51,1162.01,1,-150,51862.9,Exit After X Bars,,None,None,None,None
870_240906006_B,187,XAUUSD,Buy,2017-01-09 16:00:00,2017-01-09 20:00:00,1183.52,1182.7,1,-82,51780.9,Exit After X Bars,,None,None,None,None
871_240906006_B,187,XAUUSD,Buy,2017-01-10 16:00:00,2017-01-10 20:00:00,1187.5,1184.26,1,-324,51456.9,Exit After X Bars,,None,None,None,None
872_240906006_B,187,XAUUSD,Buy,2017-01-11 20:00:00,2017-01-12 00:00:00,1191.31,1190.5,1,-81,51375.9,Exit After X Bars,,None,None,None,None
874_240906006_B,187,XAUUSD,Buy,2017-01-16 12:00:00,2017-01-16 16:00:00,1202.36,1202.84,1,48,51423.9,Exit After X Bars,,None,None,None,None
877_240906006_B,187,XAUUSD,Buy,2017-01-20 20:00:00,2017-01-23 00:00:00,1207.57,1209.46,1,189,51612.9,End Of Friday,,None,None,None,None
878_240906006_B,187,XAUUSD,Buy,2017-01-23 16:00:00,2017-01-23 20:00:00,1216.58,1215.09,1,-149,51463.9,Exit After X Bars,,None,None,None,None
883_240906006_B,187,XAUUSD,Buy,2017-01-30 12:00:00,2017-01-30 16:00:00,1192.69,1193.3,1,61,51524.9,Exit After X Bars,,None,None,None,None
887_240906006_B,187,XAUUSD,Buy,2017-02-14 12:00:00,2017-02-14 16:00:00,1232.89,1232.82,1,-7,51517.9,Exit After X Bars,,None,None,None,None
888_240906006_B,187,XAUUSD,Buy,2017-02-16 00:00:00,2017-02-16 04:00:00,1235.48,1236.16,1,68,51585.9,Exit After X Bars,,None,None,None,None
891_240906006_B,187,XAUUSD,Buy,2017-02-22 12:00:00,2017-02-22 16:00:00,1239.52,1238.65,1,-87,51498.9,Exit After X Bars,,None,None,None,None
892_240906006_B,187,XAUUSD,Buy,2017-02-23 12:00:00,2017-02-23 16:00:00,1240.9,1248.47,1,757,52255.9,Exit After X Bars,,None,None,None,None
907_240906006_B,187,XAUUSD,Buy,2017-04-03 16:00:00,2017-04-03 20:00:00,1251.04,1252.34,1,130,52385.9,Exit After X Bars,,None,None,None,None
909_240906006_B,187,XAUUSD,Buy,2017-04-07 04:00:00,2017-04-07 08:00:00,1258.15,1263.51,1,536,52921.9,Exit After X Bars,,None,None,None,None
911_240906006_B,187,XAUUSD,Buy,2017-04-11 12:00:00,2017-04-11 16:00:00,1257.74,1260.48,1,274,53195.9,Exit After X Bars,,None,None,None,None
915_240906006_B,187,XAUUSD,Buy,2017-04-21 12:00:00,2017-04-21 16:00:00,1283.83,1282.38,1,-145,53050.9,Exit After X Bars,,None,None,None,None
928_240906006_B,187,XAUUSD,Buy,2017-05-26 08:00:00,2017-05-26 12:00:00,1259.37,1263.49,1,412,53462.9,Exit After X Bars,,None,None,None,None
929_240906006_B,187,XAUUSD,Buy,2017-05-30 04:00:00,2017-05-30 08:00:00,1269.86,1267.78,1,-208,53254.9,Exit After X Bars,,None,None,None,None
930_240906006_B,187,XAUUSD,Buy,2017-05-31 20:00:00,2017-06-01 00:00:00,1270.86,1268.22,1,-264,52990.9,Exit After X Bars,,None,None,None,None
932_240906006_B,187,XAUUSD,Buy,2017-06-02 12:00:00,2017-06-02 16:00:00,1270.95,1273.68,1,273,53263.9,Exit After X Bars,,None,None,None,None
937_240906006_B,187,XAUUSD,Buy,2017-06-14 12:00:00,2017-06-14 16:00:00,1269.55,1276.32,1,677,53940.9,Exit After X Bars,,None,None,None,None
941_240906006_B,187,XAUUSD,Buy,2017-06-22 04:00:00,2017-06-22 08:00:00,1253.77,1252.68,1,-109,53831.9,Exit After X Bars,,None,None,None,None
947_240906006_B,187,XAUUSD,Buy,2017-07-06 00:00:00,2017-07-06 04:00:00,1227.4,1227.31,1,-9,53822.9,Exit After X Bars,,None,None,None,None
949_240906006_B,187,XAUUSD,Buy,2017-07-14 12:00:00,2017-07-14 16:00:00,1228.93,1231.7,1,277,54099.9,Exit After X Bars,,None,None,None,None
950_240906006_B,187,XAUUSD,Buy,2017-07-20 16:00:00,2017-07-20 20:00:00,1244.55,1246.2,1,165,54264.9,Exit After X Bars,,None,None,None,None
952_240906006_B,187,XAUUSD,Buy,2017-07-26 20:00:00,2017-07-27 00:00:00,1258.74,1260.47,1,173,54437.9,Exit After X Bars,,None,None,None,None
954_240906006_B,187,XAUUSD,Buy,2017-07-28 12:00:00,2017-07-28 16:00:00,1265.72,1263.57,1,-215,54222.9,Exit After X Bars,,None,None,None,None
956_240906006_B,187,XAUUSD,Buy,2017-08-01 16:00:00,2017-08-01 20:00:00,1270.85,1272.75,1,190,54412.9,Exit After X Bars,,None,None,None,None
961_240906006_B,187,XAUUSD,Buy,2017-08-08 20:00:00,2017-08-09 00:00:00,1260.29,1260.4,1,11,54423.9,Exit After X Bars,,None,None,None,None
964_240906006_B,187,XAUUSD,Buy,2017-08-16 20:00:00,2017-08-17 00:00:00,1278.84,1283.5,1,466,54889.9,Exit After X Bars,,None,None,None,None
969_240906006_B,187,XAUUSD,Buy,2017-08-25 16:00:00,2017-08-25 20:00:00,1290.49,1292.64,1,215,55104.9,Exit After X Bars,,None,None,None,None
971_240906006_B,187,XAUUSD,Buy,2017-08-31 16:00:00,2017-08-31 20:00:00,1314.11,1316.85,1,274,55378.9,Exit After X Bars,,None,None,None,None
972_240906006_B,187,XAUUSD,Buy,2017-09-05 20:00:00,2017-09-06 00:00:00,1340.75,1339.38,1,-137,55241.9,Exit After X Bars,,None,None,None,None
974_240906006_B,187,XAUUSD,Buy,2017-09-07 12:00:00,2017-09-07 16:00:00,1342.5,1343.87,1,137,55378.9,Exit After X Bars,,None,None,None,None
978_240906006_B,187,XAUUSD,Buy,2017-09-13 12:00:00,2017-09-13 16:00:00,1332.85,1331.65,1,-120,55258.9,Exit After X Bars,,None,None,None,None
988_240906006_B,187,XAUUSD,Buy,2017-10-04 08:00:00,2017-10-04 12:00:00,1277.81,1275.54,1,-227,55031.9,Exit After X Bars,,None,None,None,None
991_240906006_B,187,XAUUSD,Buy,2017-10-19 12:00:00,2017-10-19 16:00:00,1289.17,1284.63,1,-454,54577.9,Exit After X Bars,,None,None,None,None
998_240906006_B,187,XAUUSD,Buy,2017-11-01 12:00:00,2017-11-01 16:00:00,1279.36,1275.13,1,-423,54154.9,Exit After X Bars,,None,None,None,None
1000_240906006_B,187,XAUUSD,Buy,2017-11-06 16:00:00,2017-11-06 20:00:00,1281.09,1280.84,1,-25,54129.9,Exit After X Bars,,None,None,None,None
1003_240906006_B,187,XAUUSD,Buy,2017-11-14 16:00:00,2017-11-14 20:00:00,1280.04,1281.0,1,96,54225.9,Exit After X Bars,,None,None,None,None
1004_240906006_B,187,XAUUSD,Buy,2017-11-17 16:00:00,2017-11-17 20:00:00,1289.86,1293.4,1,354,54579.9,Exit After X Bars,,None,None,None,None
1007_240906006_B,187,XAUUSD,Buy,2017-11-22 12:00:00,2017-11-22 16:00:00,1285.13,1285.34,1,21,54600.9,Exit After X Bars,,None,None,None,None
1011_240906006_B,187,XAUUSD,Buy,2017-12-01 16:00:00,2017-12-01 20:00:00,1285.34,1283.66,1,-168,54432.9,Exit After X Bars,,None,None,None,None
1018_240906006_B,187,XAUUSD,Buy,2017-12-13 20:00:00,2017-12-14 00:00:00,1252.16,1255.03,1,287,54719.9,Exit After X Bars,,None,None,None,None
1019_240906006_B,187,XAUUSD,Buy,2018-01-04 16:00:00,2018-01-04 20:00:00,1319.91,1319.68,1,-23,54696.9,Exit After X Bars,,None,None,None,None
1023_240906006_B,187,XAUUSD,Buy,2018-01-10 12:00:00,2018-01-10 16:00:00,1320.97,1319.7,1,-127,54569.9,Exit After X Bars,,None,None,None,None
1024_240906006_B,187,XAUUSD,Buy,2018-01-12 04:00:00,2018-01-12 08:00:00,1328.26,1328.26,1,0,54569.9,Exit After X Bars,,None,None,None,None
1028_240906006_B,187,XAUUSD,Buy,2018-01-19 20:00:00,2018-01-22 00:00:00,1334.45,1334.04,1,-41,54528.9,End Of Friday,,None,None,None,None
1034_240906006_B,187,XAUUSD,Buy,2018-02-01 20:00:00,2018-02-02 00:00:00,1348.63,1348.64,1,1,54529.9,Exit After X Bars,,None,None,None,None
1048_240906006_B,187,XAUUSD,Buy,2018-03-02 12:00:00,2018-03-02 16:00:00,1323.58,1325.0,1,142,54671.9,Exit After X Bars,,None,None,None,None
1052_240906006_B,187,XAUUSD,Buy,2018-03-13 12:00:00,2018-03-13 16:00:00,1324.76,1324.64,1,-12,54659.9,Exit After X Bars,,None,None,None,None
1056_240906006_B,187,XAUUSD,Buy,2018-03-21 16:00:00,2018-03-21 20:00:00,1320.13,1323.92,1,379,55038.9,Exit After X Bars,,None,None,None,None
1060_240906006_B,187,XAUUSD,Buy,2018-04-04 12:00:00,2018-04-04 16:00:00,1345.5,1347.08,1,158,55196.9,Exit After X Bars,,None,None,None,None
1062_240906006_B,187,XAUUSD,Buy,2018-04-06 16:00:00,2018-04-06 20:00:00,1333.14,1331.36,1,-178,55018.9,Exit After X Bars,,None,None,None,None
1063_240906006_B,187,XAUUSD,Buy,2018-04-09 16:00:00,2018-04-09 20:00:00,1336.08,1335.22,1,-86,54932.9,Exit After X Bars,,None,None,None,None
1067_240906006_B,187,XAUUSD,Buy,2018-04-18 12:00:00,2018-04-18 16:00:00,1349.94,1353.13,1,319,55251.9,Exit After X Bars,,None,None,None,None
1077_240906006_B,187,XAUUSD,Buy,2018-05-03 12:00:00,2018-05-03 16:00:00,1315.91,1315.51,1,-40,55211.9,Exit After X Bars,,None,None,None,None
1078_240906006_B,187,XAUUSD,Buy,2018-05-10 12:00:00,2018-05-10 16:00:00,1318.52,1322.01,1,349,55560.9,Exit After X Bars,,None,None,None,None
1083_240906006_B,187,XAUUSD,Buy,2018-05-22 08:00:00,2018-05-22 12:00:00,1294.99,1293.72,1,-127,55433.9,Exit After X Bars,,None,None,None,None
1087_240906006_B,187,XAUUSD,Buy,2018-06-05 16:00:00,2018-06-05 20:00:00,1298.38,1298.38,1,0,55433.9,Exit After X Bars,,None,None,None,None
1089_240906006_B,187,XAUUSD,Buy,2018-06-11 16:00:00,2018-06-11 20:00:00,1300.85,1300.19,1,-66,55367.9,Exit After X Bars,,None,None,None,None
1091_240906006_B,187,XAUUSD,Buy,2018-06-13 20:00:00,2018-06-14 00:00:00,1300.02,1299.25,1,-77,55290.9,Exit After X Bars,,None,None,None,None
1100_240906006_B,187,XAUUSD,Buy,2018-07-03 16:00:00,2018-07-03 20:00:00,1256.24,1252.72,1,-352,54938.9,Exit After X Bars,,None,None,None,None
1109_240906006_B,187,XAUUSD,Buy,2018-07-20 12:00:00,2018-07-20 16:00:00,1229.5,1229.95,1,45,54983.9,Exit After X Bars,,None,None,None,None
1112_240906006_B,187,XAUUSD,Buy,2018-07-31 16:00:00,2018-07-31 20:00:00,1225.55,1225.98,1,43,55026.9,Exit After X Bars,,None,None,None,None
1122_240906006_B,187,XAUUSD,Buy,2018-08-17 20:00:00,2018-08-20 00:00:00,1183.2,1183.33,1,13,55039.9,End Of Friday,,None,None,None,None
1124_240906006_B,187,XAUUSD,Buy,2018-08-31 08:00:00,2018-08-31 12:00:00,1207.76,1206.3,1,-146,54893.9,Exit After X Bars,,None,None,None,None
1127_240906006_B,187,XAUUSD,Buy,2018-09-06 08:00:00,2018-09-06 12:00:00,1202.3,1202.91,1,61,54954.9,Exit After X Bars,,None,None,None,None
1130_240906006_B,187,XAUUSD,Buy,2018-09-11 20:00:00,2018-09-12 00:00:00,1198.84,1198.01,1,-83,54871.9,Exit After X Bars,,None,None,None,None
1131_240906006_B,187,XAUUSD,Buy,2018-09-12 16:00:00,2018-09-12 20:00:00,1199.73,1203.97,1,424,55295.9,Exit After X Bars,,None,None,None,None
1134_240906006_B,187,XAUUSD,Buy,2018-09-19 12:00:00,2018-09-19 16:00:00,1205.6,1205.23,1,-37,55258.9,Exit After X Bars,,None,None,None,None
1141_240906006_B,187,XAUUSD,Buy,2018-10-02 08:00:00,2018-10-02 12:00:00,1194.35,1193.13,1,-122,55136.9,Exit After X Bars,,None,None,None,None
1144_240906006_B,187,XAUUSD,Buy,2018-10-10 20:00:00,2018-10-11 00:00:00,1192.16,1194.76,1,260,55396.9,Exit After X Bars,,None,None,None,None
1146_240906006_B,187,XAUUSD,Buy,2018-10-18 16:00:00,2018-10-18 20:00:00,1229.87,1227.71,1,-216,55180.9,Exit After X Bars,,None,None,None,None
1147_240906006_B,187,XAUUSD,Buy,2018-10-19 12:00:00,2018-10-19 16:00:00,1230.34,1228.2,1,-214,54966.9,Exit After X Bars,,None,None,None,None
1148_240906006_B,187,XAUUSD,Buy,2018-10-23 08:00:00,2018-10-23 12:00:00,1231.47,1235.63,1,416,55382.9,Exit After X Bars,,None,None,None,None
1150_240906006_B,187,XAUUSD,Buy,2018-10-25 16:00:00,2018-10-25 20:00:00,1234.37,1230.03,1,-434,54948.9,Exit After X Bars,,None,None,None,None
1151_240906006_B,187,XAUUSD,Buy,2018-10-26 16:00:00,2018-10-26 20:00:00,1239.59,1233.81,1,-578,54370.9,Exit After X Bars,,None,None,None,None
1155_240906006_B,187,XAUUSD,Buy,2018-11-07 12:00:00,2018-11-07 16:00:00,1235.43,1228.55,1,-688,53682.9,Exit After X Bars,,None,None,None,None
1160_240906006_B,187,XAUUSD,Buy,2018-11-14 16:00:00,2018-11-14 20:00:00,1205.61,1208.29,1,268,53950.9,Exit After X Bars,,None,None,None,None
1164_240906006_B,187,XAUUSD,Buy,2018-11-28 16:00:00,2018-11-28 20:00:00,1225.48,1221.12,1,-436,53514.9,Exit After X Bars,,None,None,None,None
1166_240906006_B,187,XAUUSD,Buy,2018-12-06 16:00:00,2018-12-06 20:00:00,1239.43,1239.55,1,12,53526.9,Exit After X Bars,,None,None,None,None
1167_240906006_B,187,XAUUSD,Buy,2018-12-07 12:00:00,2018-12-07 16:00:00,1244.72,1243.92,1,-80,53446.9,Exit After X Bars,,None,None,None,None
1173_240906006_B,187,XAUUSD,Buy,2018-12-17 16:00:00,2018-12-17 20:00:00,1243.23,1246.71,1,348,53794.9,Exit After X Bars,,None,None,None,None
1174_240906006_B,187,XAUUSD,Buy,2018-12-19 16:00:00,2018-12-19 20:00:00,1250.81,1252.66,1,185,53979.9,Exit After X Bars,,None,None,None,None
1175_240906006_B,187,XAUUSD,Buy,2019-01-02 04:00:00,2019-01-02 08:00:00,1282.87,1286.16,1,329,54308.9,Exit After X Bars,,None,None,None,None
1176_240906006_B,187,XAUUSD,Buy,2019-01-03 16:00:00,2019-01-03 20:00:00,1289.2,1290.31,1,111,54419.9,Exit After X Bars,,None,None,None,None
1180_240906006_B,187,XAUUSD,Buy,2019-01-09 16:00:00,2019-01-09 20:00:00,1287.54,1289.85,1,231,54650.9,Exit After X Bars,,None,None,None,None
1181_240906006_B,187,XAUUSD,Buy,2019-01-11 08:00:00,2019-01-11 12:00:00,1294.75,1292.19,1,-256,54394.9,Exit After X Bars,,None,None,None,None
1184_240906006_B,187,XAUUSD,Buy,2019-01-17 04:00:00,2019-01-17 08:00:00,1295.1,1292.57,1,-253,54141.9,Exit After X Bars,,None,None,None,None
1187_240906006_B,187,XAUUSD,Buy,2019-01-22 16:00:00,2019-01-22 20:00:00,1283.85,1283.57,1,-28,54113.9,Exit After X Bars,,None,None,None,None
1189_240906006_B,187,XAUUSD,Buy,2019-01-25 12:00:00,2019-01-25 16:00:00,1286.9,1288.55,1,165,54278.9,Exit After X Bars,,None,None,None,None
1192_240906006_B,187,XAUUSD,Buy,2019-02-05 12:00:00,2019-02-05 16:00:00,1315.92,1314.58,1,-134,54144.9,Exit After X Bars,,None,None,None,None
1195_240906006_B,187,XAUUSD,Buy,2019-02-08 12:00:00,2019-02-08 16:00:00,1312.2,1314.73,1,253,54397.9,Exit After X Bars,,None,None,None,None
1197_240906006_B,187,XAUUSD,Buy,2019-02-12 12:00:00,2019-02-12 16:00:00,1314.45,1311.8,1,-265,54132.9,Exit After X Bars,,None,None,None,None
1198_240906006_B,187,XAUUSD,Buy,2019-02-13 16:00:00,2019-02-13 20:00:00,1315.07,1311.68,1,-339,53793.9,Exit After X Bars,,None,None,None,None
1199_240906006_B,187,XAUUSD,Buy,2019-02-15 12:00:00,2019-02-15 16:00:00,1318.78,1317.47,1,-131,53662.9,Exit After X Bars,,None,None,None,None
1209_240906006_B,187,XAUUSD,Buy,2019-03-08 04:00:00,2019-03-08 08:00:00,1290.08,1290.66,1,58,53720.9,Exit After X Bars,,None,None,None,None
1211_240906006_B,187,XAUUSD,Buy,2019-03-20 20:00:00,2019-03-21 00:00:00,1311.82,1312.96,1,114,53834.9,Exit After X Bars,,None,None,None,None
1226_240906006_B,187,XAUUSD,Buy,2019-04-25 16:00:00,2019-04-25 20:00:00,1280.19,1277.74,1,-245,53589.9,Exit After X Bars,,None,None,None,None
1228_240906006_B,187,XAUUSD,Buy,2019-05-03 16:00:00,2019-05-03 20:00:00,1277.38,1280.96,1,358,53947.9,Exit After X Bars,,None,None,None,None
1230_240906006_B,187,XAUUSD,Buy,2019-05-13 12:00:00,2019-05-13 16:00:00,1289.93,1291.42,1,149,54096.9,Exit After X Bars,,None,None,None,None
1235_240906006_B,187,XAUUSD,Buy,2019-05-22 12:00:00,2019-05-22 16:00:00,1276.98,1275.58,1,-140,53956.9,Exit After X Bars,,None,None,None,None
1236_240906006_B,187,XAUUSD,Buy,2019-05-23 12:00:00,2019-05-23 16:00:00,1277.54,1282.7,1,516,54472.9,Exit After X Bars,,None,None,None,None
1238_240906006_B,187,XAUUSD,Buy,2019-05-30 16:00:00,2019-05-30 20:00:00,1285.73,1287.07,1,134,54606.9,Exit After X Bars,,None,None,None,None
1239_240906006_B,187,XAUUSD,Buy,2019-06-07 12:00:00,2019-06-07 16:00:00,1340.5,1341.0,1,50,54656.9,Exit After X Bars,,None,None,None,None
1241_240906006_B,187,XAUUSD,Buy,2019-06-12 08:00:00,2019-06-12 12:00:00,1335.83,1337.58,1,175,54831.9,Exit After X Bars,,None,None,None,None
1242_240906006_B,187,XAUUSD,Buy,2019-06-13 16:00:00,2019-06-13 20:00:00,1338.8,1339.35,1,55,54886.9,Exit After X Bars,,None,None,None,None
1244_240906006_B,187,XAUUSD,Buy,2019-06-19 20:00:00,2019-06-20 00:00:00,1355.07,1360.32,1,525,55411.9,Exit After X Bars,,None,None,None,None
1246_240906006_B,187,XAUUSD,Buy,2019-06-28 00:00:00,2019-06-28 04:00:00,1416.67,1414.25,1,-242,55169.9,Exit After X Bars,,None,None,None,None
1248_240906006_B,187,XAUUSD,Buy,2019-07-02 16:00:00,2019-07-02 20:00:00,1398.1,1404.96,1,686,55855.9,Exit After X Bars,,None,None,None,None
1254_240906006_B,187,XAUUSD,Buy,2019-07-10 12:00:00,2019-07-10 16:00:00,1401.26,1410.09,1,883,56738.9,Exit After X Bars,,None,None,None,None
1257_240906006_B,187,XAUUSD,Buy,2019-07-17 16:00:00,2019-07-17 20:00:00,1417.01,1422.27,1,526,57264.9,Exit After X Bars,,None,None,None,None
1261_240906006_B,187,XAUUSD,Buy,2019-07-25 12:00:00,2019-07-25 16:00:00,1430.27,1424.48,1,-579,56685.9,Exit After X Bars,,None,None,None,None
1263_240906006_B,187,XAUUSD,Buy,2019-07-29 20:00:00,2019-07-30 00:00:00,1425.48,1426.49,1,101,56786.9,Exit After X Bars,,None,None,None,None
1264_240906006_B,187,XAUUSD,Buy,2019-08-01 20:00:00,2019-08-02 00:00:00,1436.41,1444.8,1,839,57625.9,Exit After X Bars,,None,None,None,None
1266_240906006_B,187,XAUUSD,Buy,2019-08-12 20:00:00,2019-08-13 00:00:00,1509.3,1510.78,1,148,57773.9,Exit After X Bars,,None,None,None,None
1269_240906006_B,187,XAUUSD,Buy,2019-08-15 20:00:00,2019-08-16 00:00:00,1525.01,1523.39,1,-162,57611.9,Exit After X Bars,,None,None,None,None
1275_240906006_B,187,XAUUSD,Buy,2019-08-23 16:00:00,2019-08-23 20:00:00,1505.15,1526.85,1,2170,59781.9,Exit After X Bars,,None,None,None,None
1279_240906006_B,187,XAUUSD,Buy,2019-09-03 12:00:00,2019-09-03 16:00:00,1532.26,1532.38,1,12,59793.9,Exit After X Bars,,None,None,None,None
1284_240906006_B,187,XAUUSD,Buy,2019-09-12 08:00:00,2019-09-12 12:00:00,1501.77,1504.38,1,261,60054.9,Exit After X Bars,,None,None,None,None
1290_240906006_B,187,XAUUSD,Buy,2019-10-02 12:00:00,2019-10-02 16:00:00,1487.97,1492.34,1,437,60491.9,Exit After X Bars,,None,None,None,None
1291_240906006_B,187,XAUUSD,Buy,2019-10-09 08:00:00,2019-10-09 12:00:00,1510.41,1505.26,1,-515,59976.9,Exit After X Bars,,None,None,None,None
1295_240906006_B,187,XAUUSD,Buy,2019-10-15 12:00:00,2019-10-15 16:00:00,1497.64,1490.97,1,-667,59309.9,Exit After X Bars,,None,None,None,None
1297_240906006_B,187,XAUUSD,Buy,2019-10-23 16:00:00,2019-10-23 20:00:00,1496.07,1492.28,1,-379,58930.9,Exit After X Bars,,None,None,None,None
1300_240906006_B,187,XAUUSD,Buy,2019-10-30 16:00:00,2019-10-30 20:00:00,1495.16,1494.04,1,-112,58818.9,Exit After X Bars,,None,None,None,None
1307_240906006_B,187,XAUUSD,Buy,2019-11-13 20:00:00,2019-11-14 00:00:00,1466.78,1463.28,1,-350,58468.9,Exit After X Bars,,None,None,None,None
1311_240906006_B,187,XAUUSD,Buy,2019-11-26 20:00:00,2019-11-27 00:00:00,1462.84,1461.1,1,-174,58294.9,Exit After X Bars,,None,None,None,None
1314_240906006_B,187,XAUUSD,Buy,2019-11-29 16:00:00,2019-11-29 20:00:00,1458.69,1463.89,1,520,58814.9,Exit After X Bars,,None,None,None,None
1317_240906006_B,187,XAUUSD,Buy,2019-12-10 12:00:00,2019-12-10 16:00:00,1465.63,1466.97,1,134,58948.9,Exit After X Bars,,None,None,None,None
1318_240906006_B,187,XAUUSD,Buy,2019-12-11 16:00:00,2019-12-11 20:00:00,1469.48,1470.33,1,85,59033.9,Exit After X Bars,,None,None,None,None
1321_240906006_B,187,XAUUSD,Buy,2019-12-19 16:00:00,2019-12-19 20:00:00,1479.87,1479.76,1,-11,59022.9,Exit After X Bars,,None,None,None,None
1323_240906006_B,187,XAUUSD,Buy,2020-01-02 12:00:00,2020-01-02 16:00:00,1526.07,1528.01,1,194,59216.9,Exit After X Bars,,None,None,None,None
1326_240906006_B,187,XAUUSD,Buy,2020-01-10 20:00:00,2020-01-13 00:00:00,1562.04,1561.32,1,-72,59144.9,End Of Friday,,None,None,None,None
1330_240906006_B,187,XAUUSD,Buy,2020-01-17 12:00:00,2020-01-17 16:00:00,1558.26,1555.36,1,-290,58854.9,Exit After X Bars,,None,None,None,None
1333_240906006_B,187,XAUUSD,Buy,2020-01-23 16:00:00,2020-01-23 20:00:00,1560.23,1567.21,1,698,59552.9,Exit After X Bars,,None,None,None,None
1335_240906006_B,187,XAUUSD,Buy,2020-01-30 16:00:00,2020-01-30 20:00:00,1583.52,1584.78,1,126,59678.9,Exit After X Bars,,None,None,None,None
1336_240906006_B,187,XAUUSD,Buy,2020-01-31 16:00:00,2020-01-31 20:00:00,1586.9,1583.5,1,-340,59338.9,Exit After X Bars,,None,None,None,None
1340_240906006_B,187,XAUUSD,Buy,2020-02-06 12:00:00,2020-02-06 16:00:00,1563.1,1563.76,1,66,59404.9,Exit After X Bars,,None,None,None,None
1341_240906006_B,187,XAUUSD,Buy,2020-02-13 04:00:00,2020-02-13 08:00:00,1574.56,1574.09,1,-47,59357.9,Exit After X Bars,,None,None,None,None
1344_240906006_B,187,XAUUSD,Buy,2020-02-27 16:00:00,2020-02-27 20:00:00,1657.28,1640.75,1,-1653,57704.9,Exit After X Bars,,None,None,None,None
1347_240906006_B,187,XAUUSD,Buy,2020-03-03 16:00:00,2020-03-03 16:00:00,1614.05,1637.55,1,2350,60054.9,PT,,None,None,None,None
1358_240906006_B,187,XAUUSD,Buy,2020-04-02 12:00:00,2020-04-02 16:00:00,1602.02,1601.04,1,-98,59956.9,Exit After X Bars,,None,None,None,None
1359_240906006_B,187,XAUUSD,Buy,2020-04-03 20:00:00,2020-04-06 00:00:00,1621.75,1615.58,1,-617,59339.9,End Of Friday,,None,None,None,None
1362_240906006_B,187,XAUUSD,Buy,2020-04-16 12:00:00,2020-04-16 16:00:00,1732.39,1724.86,1,-753,58586.9,Exit After X Bars,,None,None,None,None
1366_240906006_B,187,XAUUSD,Buy,2020-04-22 12:00:00,2020-04-22 16:00:00,1699.08,1705.99,1,691,59277.9,Exit After X Bars,,None,None,None,None
1369_240906006_B,187,XAUUSD,Buy,2020-04-29 20:00:00,2020-04-30 00:00:00,1715.69,1711.6,1,-409,58868.9,Exit After X Bars,,None,None,None,None
1373_240906006_B,187,XAUUSD,Buy,2020-05-07 16:00:00,2020-05-07 20:00:00,1710.57,1715.17,1,460,59328.9,Exit After X Bars,,None,None,None,None
1374_240906006_B,187,XAUUSD,Buy,2020-05-14 16:00:00,2020-05-14 20:00:00,1724.62,1731.25,1,663,59991.9,Exit After X Bars,,None,None,None,None
1380_240906006_B,187,XAUUSD,Buy,2020-05-29 20:00:00,2020-06-01 00:00:00,1736.42,1735.81,1,-61,59930.9,End Of Friday,,None,None,None,None
1384_240906006_B,187,XAUUSD,Buy,2020-06-09 16:00:00,2020-06-09 20:00:00,1717.82,1715.22,1,-260,59670.9,Exit After X Bars,,None,None,None,None
1387_240906006_B,187,XAUUSD,Buy,2020-06-18 08:00:00,2020-06-18 12:00:00,1733.79,1732.86,1,-93,59577.9,Exit After X Bars,,None,None,None,None
1389_240906006_B,187,XAUUSD,Buy,2020-06-26 20:00:00,2020-06-29 00:00:00,1769.65,1774.92,1,527,60104.9,End Of Friday,,None,None,None,None
1390_240906006_B,187,XAUUSD,Buy,2020-06-29 16:00:00,2020-06-29 20:00:00,1773.24,1769.76,1,-348,59756.9,Exit After X Bars,,None,None,None,None
1391_240906006_B,187,XAUUSD,Buy,2020-06-30 16:00:00,2020-06-30 20:00:00,1775.84,1783.36,1,752,60508.9,Exit After X Bars,,None,None,None,None
1395_240906006_B,187,XAUUSD,Buy,2020-07-06 12:00:00,2020-07-06 16:00:00,1777.72,1783.07,1,535,61043.9,Exit After X Bars,,None,None,None,None
1396_240906006_B,187,XAUUSD,Buy,2020-07-07 16:00:00,2020-07-07 20:00:00,1787.64,1795.77,1,813,61856.9,Exit After X Bars,,None,None,None,None
1398_240906006_B,187,XAUUSD,Buy,2020-07-13 16:00:00,2020-07-13 20:00:00,1811.3,1809.68,1,-162,61694.9,Exit After X Bars,,None,None,None,None
1399_240906006_B,187,XAUUSD,Buy,2020-07-15 08:00:00,2020-07-15 12:00:00,1814.36,1812.4,1,-196,61498.9,Exit After X Bars,,None,None,None,None
1402_240906006_B,187,XAUUSD,Buy,2020-07-20 12:00:00,2020-07-20 16:00:00,1812.61,1813.97,1,136,61634.9,Exit After X Bars,,None,None,None,None
1404_240906006_B,187,XAUUSD,Buy,2020-07-31 08:00:00,2020-07-31 12:00:00,1982.19,1976.84,1,-535,61099.9,Exit After X Bars,,None,None,None,None
1406_240906006_B,187,XAUUSD,Buy,2020-08-04 16:00:00,2020-08-04 20:00:00,1978.72,1999.5,1,2078,63177.9,Exit After X Bars,,None,None,None,None
1411_240906006_B,187,XAUUSD,Buy,2020-08-13 16:00:00,2020-08-13 20:00:00,1953.62,1953.66,1,4,63181.9,Exit After X Bars,,None,None,None,None
1416_240906006_B,187,XAUUSD,Buy,2020-08-26 16:00:00,2020-08-26 20:00:00,1939.21,1943.23,1,402,63583.9,Exit After X Bars,,None,None,None,None
1421_240906006_B,187,XAUUSD,Buy,2020-09-09 16:00:00,2020-09-09 20:00:00,1942.59,1948.25,1,566,64149.9,Exit After X Bars,,None,None,None,None
1429_240906006_B,187,XAUUSD,Buy,2020-09-28 16:00:00,2020-09-28 20:00:00,1876.46,1874.47,1,-199,63950.9,Exit After X Bars,,None,None,None,None
1431_240906006_B,187,XAUUSD,Buy,2020-10-08 12:00:00,2020-10-08 16:00:00,1898.73,1898.18,1,-55,63895.9,Exit After X Bars,,None,None,None,None
1436_240906006_B,187,XAUUSD,Buy,2020-10-19 12:00:00,2020-10-19 16:00:00,1914.68,1911.79,1,-289,63606.9,Exit After X Bars,,None,None,None,None
1437_240906006_B,187,XAUUSD,Buy,2020-10-21 04:00:00,2020-10-21 08:00:00,1918.95,1918.98,1,3,63609.9,Exit After X Bars,,None,None,None,None
1441_240906006_B,187,XAUUSD,Buy,2020-10-27 16:00:00,2020-10-27 20:00:00,1909.27,1909.17,1,-10,63599.9,Exit After X Bars,,None,None,None,None
1444_240906006_B,187,XAUUSD,Buy,2020-10-30 12:00:00,2020-10-30 16:00:00,1885.68,1887.35,1,167,63766.9,Exit After X Bars,,None,None,None,None
1448_240906006_B,187,XAUUSD,Buy,2020-11-13 12:00:00,2020-11-13 16:00:00,1886.13,1894.65,1,852,64618.9,Exit After X Bars,,None,None,None,None
1451_240906006_B,187,XAUUSD,Buy,2020-11-20 16:00:00,2020-11-20 20:00:00,1872.91,1872.19,1,-72,64546.9,Exit After X Bars,,None,None,None,None
1457_240906006_B,187,XAUUSD,Buy,2020-12-01 12:00:00,2020-12-01 16:00:00,1813.18,1812.76,1,-42,64504.9,Exit After X Bars,,None,None,None,None
1465_240906006_B,187,XAUUSD,Buy,2020-12-24 16:00:00,2020-12-24 20:00:00,1879.69,1879.57,1,-12,64492.9,Exit After X Bars,,None,None,None,None
1466_240906006_B,187,XAUUSD,Buy,2020-12-28 12:00:00,2020-12-28 16:00:00,1887.41,1887.65,1,24,64516.9,Exit After X Bars,,None,None,None,None
1468_240906006_B,187,XAUUSD,Buy,2020-12-30 16:00:00,2020-12-30 20:00:00,1887.75,1888.73,1,98,64614.9,Exit After X Bars,,None,None,None,None
1473_240906006_B,187,XAUUSD,Buy,2021-01-13 00:00:00,2021-01-13 04:00:00,1857.96,1862.01,1,405,65019.9,Exit After X Bars,,None,None,None,None
1477_240906006_B,187,XAUUSD,Buy,2021-01-28 12:00:00,2021-01-28 16:00:00,1855.27,1856.92,1,165,65184.9,Exit After X Bars,,None,None,None,None
1495_240906006_B,187,XAUUSD,Buy,2021-03-09 12:00:00,2021-03-09 16:00:00,1711.55,1713.35,1,180,65364.9,Exit After X Bars,,None,None,None,None
1501_240906006_B,187,XAUUSD,Buy,2021-03-25 16:00:00,2021-03-25 20:00:00,1738.73,1728.18,1,-1055,64309.9,Exit After X Bars,,None,None,None,None
1505_240906006_B,187,XAUUSD,Buy,2021-03-31 20:00:00,2021-04-01 00:00:00,1715.05,1707.66,1,-739,63570.9,Exit After X Bars,,None,None,None,None
1508_240906006_B,187,XAUUSD,Buy,2021-04-13 16:00:00,2021-04-13 20:00:00,1745.73,1742.5,1,-323,63247.9,Exit After X Bars,,None,None,None,None
1510_240906006_B,187,XAUUSD,Buy,2021-04-15 12:00:00,2021-04-15 16:00:00,1750.07,1746.8,1,-327,62920.9,Exit After X Bars,,None,None,None,None
1511_240906006_B,187,XAUUSD,Buy,2021-04-21 16:00:00,2021-04-21 20:00:00,1790.81,1790.73,1,-8,62912.9,Exit After X Bars,,None,None,None,None
1515_240906006_B,187,XAUUSD,Buy,2021-04-27 12:00:00,2021-04-27 16:00:00,1783.91,1782.93,1,-98,62814.9,Exit After X Bars,,None,None,None,None
1516_240906006_B,187,XAUUSD,Buy,2021-04-29 04:00:00,2021-04-29 08:00:00,1786.92,1785.05,1,-187,62627.9,Exit After X Bars,,None,None,None,None
1518_240906006_B,187,XAUUSD,Buy,2021-05-06 16:00:00,2021-05-06 20:00:00,1799.42,1815.7,1,1628,64255.9,Exit After X Bars,,None,None,None,None
1520_240906006_B,187,XAUUSD,Buy,2021-05-12 16:00:00,2021-05-12 20:00:00,1842.59,1820.23,1,-2236,62019.9,Exit After X Bars,,None,None,None,None
1522_240906006_B,187,XAUUSD,Buy,2021-05-19 16:00:00,2021-05-19 20:00:00,1875.5,1881.86,1,636,62655.9,Exit After X Bars,,None,None,None,None
1524_240906006_B,187,XAUUSD,Buy,2021-05-21 12:00:00,2021-05-21 16:00:00,1884.69,1886.94,1,225,62880.9,Exit After X Bars,,None,None,None,None
1526_240906006_B,187,XAUUSD,Buy,2021-05-25 16:00:00,2021-05-25 20:00:00,1887.94,1895.23,1,729,63609.9,Exit After X Bars,,None,None,None,None
1528_240906006_B,187,XAUUSD,Buy,2021-05-28 20:00:00,2021-05-31 00:00:00,1903.95,1903.34,1,-61,63548.9,End Of Friday,,None,None,None,None
1529_240906006_B,187,XAUUSD,Buy,2021-05-31 12:00:00,2021-05-31 16:00:00,1906.39,1905.12,1,-127,63421.9,Exit After X Bars,,None,None,None,None
1534_240906006_B,187,XAUUSD,Buy,2021-06-07 20:00:00,2021-06-08 00:00:00,1896.71,1897.97,1,126,63547.9,Exit After X Bars,,None,None,None,None
1536_240906006_B,187,XAUUSD,Buy,2021-06-11 04:00:00,2021-06-11 08:00:00,1899.76,1900.08,1,32,63579.9,Exit After X Bars,,None,None,None,None
1545_240906006_B,187,XAUUSD,Buy,2021-07-13 12:00:00,2021-07-13 16:00:00,1811.28,1800.28,1,-1100,62479.9,Exit After X Bars,,None,None,None,None
1546_240906006_B,187,XAUUSD,Buy,2021-07-14 12:00:00,2021-07-14 16:00:00,1817.79,1828.48,1,1069,63548.9,Exit After X Bars,,None,None,None,None
1547_240906006_B,187,XAUUSD,Buy,2021-07-16 00:00:00,2021-07-16 04:00:00,1831.32,1829.19,1,-213,63335.9,Exit After X Bars,,None,None,None,None
1549_240906006_B,187,XAUUSD,Buy,2021-07-20 12:00:00,2021-07-20 16:00:00,1816.78,1822.68,1,590,63925.9,Exit After X Bars,,None,None,None,None
1555_240906006_B,187,XAUUSD,Buy,2021-07-28 20:00:00,2021-07-29 00:00:00,1807.0,1806.93,1,-7,63918.9,Exit After X Bars,,None,None,None,None
1558_240906006_B,187,XAUUSD,Buy,2021-08-04 12:00:00,2021-08-04 16:00:00,1815.21,1827.06,1,1185,65103.9,Exit After X Bars,,None,None,None,None
1563_240906006_B,187,XAUUSD,Buy,2021-08-11 12:00:00,2021-08-11 16:00:00,1739.07,1744.61,1,554,65657.9,Exit After X Bars,,None,None,None,None
1565_240906006_B,187,XAUUSD,Buy,2021-08-26 16:00:00,2021-08-26 20:00:00,1798.07,1792.11,1,-596,65061.9,Exit After X Bars,,None,None,None,None
1566_240906006_B,187,XAUUSD,Buy,2021-08-27 16:00:00,2021-08-27 20:00:00,1799.4,1816.76,1,1736,66797.9,Exit After X Bars,,None,None,None,None
1568_240906006_B,187,XAUUSD,Buy,2021-09-01 12:00:00,2021-09-01 16:00:00,1819.67,1819.32,1,-35,66762.9,Exit After X Bars,,None,None,None,None
1570_240906006_B,187,XAUUSD,Buy,2021-09-03 12:00:00,2021-09-03 16:00:00,1817.45,1823.4,1,595,67357.9,Exit After X Bars,,None,None,None,None
1574_240906006_B,187,XAUUSD,Buy,2021-09-10 08:00:00,2021-09-10 12:00:00,1802.63,1801.59,1,-104,67253.9,Exit After X Bars,,None,None,None,None
1576_240906006_B,187,XAUUSD,Buy,2021-09-14 12:00:00,2021-09-14 16:00:00,1798.81,1797.16,1,-165,67088.9,Exit After X Bars,,None,None,None,None
1579_240906006_B,187,XAUUSD,Buy,2021-09-21 12:00:00,2021-09-21 16:00:00,1768.18,1771.79,1,361,67449.9,Exit After X Bars,,None,None,None,None
1583_240906006_B,187,XAUUSD,Buy,2021-09-30 16:00:00,2021-09-30 20:00:00,1755.63,1758.15,1,252,67701.9,Exit After X Bars,,None,None,None,None
1585_240906006_B,187,XAUUSD,Buy,2021-10-08 12:00:00,2021-10-08 16:00:00,1767.46,1775.77,1,831,68532.9,Exit After X Bars,,None,None,None,None
1586_240906006_B,187,XAUUSD,Buy,2021-10-13 16:00:00,2021-10-13 20:00:00,1782.65,1792.5,1,985,69517.9,Exit After X Bars,,None,None,None,None
1589_240906006_B,187,XAUUSD,Buy,2021-10-20 04:00:00,2021-10-20 08:00:00,1773.85,1774.1,1,25,69542.9,Exit After X Bars,,None,None,None,None
1590_240906006_B,187,XAUUSD,Buy,2021-10-22 08:00:00,2021-10-22 12:00:00,1789.81,1791.03,1,122,69664.9,Exit After X Bars,,None,None,None,None
1593_240906006_B,187,XAUUSD,Buy,2021-10-28 16:00:00,2021-10-28 20:00:00,1800.8,1800.77,1,-3,69661.9,Exit After X Bars,,None,None,None,None
1598_240906006_B,187,XAUUSD,Buy,2021-11-04 12:00:00,2021-11-04 16:00:00,1788.73,1792.52,1,379,70040.9,Exit After X Bars,,None,None,None,None
1599_240906006_B,187,XAUUSD,Buy,2021-11-12 20:00:00,2021-11-15 00:00:00,1866.95,1869.36,1,241,70281.9,End Of Friday,,None,None,None,None
1600_240906006_B,187,XAUUSD,Buy,2021-11-16 08:00:00,2021-11-16 12:00:00,1871.02,1873.17,1,215,70496.9,Exit After X Bars,,None,None,None,None
1607_240906006_B,187,XAUUSD,Buy,2021-11-26 04:00:00,2021-11-26 08:00:00,1797.73,1797.34,1,-39,70457.9,Exit After X Bars,,None,None,None,None
1611_240906006_B,187,XAUUSD,Buy,2021-12-16 16:00:00,2021-12-16 20:00:00,1790.2,1797.2,1,700,71157.9,Exit After X Bars,,None,None,None,None
1614_240906006_B,187,XAUUSD,Buy,2021-12-22 20:00:00,2021-12-23 00:00:00,1801.02,1803.8,1,278,71435.9,Exit After X Bars,,None,None,None,None
1616_240906006_B,187,XAUUSD,Buy,2021-12-30 16:00:00,2021-12-30 20:00:00,1808.43,1813.42,1,499,71934.9,Exit After X Bars,,None,None,None,None
1621_240906006_B,187,XAUUSD,Buy,2022-01-10 12:00:00,2022-01-10 16:00:00,1799.45,1792.91,1,-654,71280.9,Exit After X Bars,,None,None,None,None
1625_240906006_B,187,XAUUSD,Buy,2022-01-19 12:00:00,2022-01-19 16:00:00,1823.28,1823.91,1,63,71343.9,Exit After X Bars,,None,None,None,None
1627_240906006_B,187,XAUUSD,Buy,2022-01-24 20:00:00,2022-01-25 00:00:00,1843.97,1842.67,1,-130,71213.9,Exit After X Bars,,None,None,None,None
1628_240906006_B,187,XAUUSD,Buy,2022-01-25 16:00:00,2022-01-25 20:00:00,1844.93,1849.7,1,477,71690.9,Exit After X Bars,,None,None,None,None
1632_240906006_B,187,XAUUSD,Buy,2022-02-01 04:00:00,2022-02-01 08:00:00,1800.45,1802.6,1,215,71905.9,Exit After X Bars,,None,None,None,None
1633_240906006_B,187,XAUUSD,Buy,2022-02-11 20:00:00,2022-02-14 00:00:00,1842.68,1859.23,1,1655,73560.9,End Of Friday,,None,None,None,None
1635_240906006_B,187,XAUUSD,Buy,2022-02-17 08:00:00,2022-02-17 12:00:00,1880.26,1888.24,1,798,74358.9,Exit After X Bars,,None,None,None,None
1636_240906006_B,187,XAUUSD,Buy,2022-02-21 20:00:00,2022-02-22 00:00:00,1903.22,1908.75,1,553,74911.9,Exit After X Bars,,None,None,None,None
1638_240906006_B,187,XAUUSD,Buy,2022-02-24 04:00:00,2022-02-24 04:00:00,1914.01,1937.51,1,2350,77261.9,PT,,None,None,None,None
1641_240906006_B,187,XAUUSD,Buy,2022-03-01 12:00:00,2022-03-01 16:00:00,1919.41,1916.73,1,-268,76993.9,Exit After X Bars,,None,None,None,None
1643_240906006_B,187,XAUUSD,Buy,2022-03-04 00:00:00,2022-03-04 04:00:00,1948.71,1933.69,1,-1502,75491.9,Exit After X Bars,,None,None,None,None
1651_240906006_B,187,XAUUSD,Buy,2022-03-23 20:00:00,2022-03-24 00:00:00,1943.88,1942.89,1,-99,75392.9,Exit After X Bars,,None,None,None,None
1654_240906006_B,187,XAUUSD,Buy,2022-04-08 16:00:00,2022-04-08 20:00:00,1945.77,1941.28,1,-449,74943.9,Exit After X Bars,,None,None,None,None
1662_240906006_B,187,XAUUSD,Buy,2022-04-29 08:00:00,2022-04-29 12:00:00,1907.61,1913.84,1,623,75566.9,Exit After X Bars,,None,None,None,None
1664_240906006_B,187,XAUUSD,Buy,2022-05-05 00:00:00,2022-05-05 04:00:00,1893.45,1895.71,1,226,75792.9,Exit After X Bars,,None,None,None,None
1670_240906006_B,187,XAUUSD,Buy,2022-05-17 08:00:00,2022-05-17 12:00:00,1829.99,1827.83,1,-216,75576.9,Exit After X Bars,,None,None,None,None
1680_240906006_B,187,XAUUSD,Buy,2022-06-08 16:00:00,2022-06-08 20:00:00,1856.3,1855.32,1,-98,75478.9,Exit After X Bars,,None,None,None,None
1682_240906006_B,187,XAUUSD,Buy,2022-06-10 16:00:00,2022-06-10 20:00:00,1855.74,1871.61,1,1587,77065.9,Exit After X Bars,,None,None,None,None
1685_240906006_B,187,XAUUSD,Buy,2022-06-15 12:00:00,2022-06-15 16:00:00,1832.42,1831.58,1,-84,76981.9,Exit After X Bars,,None,None,None,None
1687_240906006_B,187,XAUUSD,Buy,2022-06-22 12:00:00,2022-06-22 16:00:00,1844.84,1844.59,1,-25,76956.9,Exit After X Bars,,None,None,None,None
1692_240906006_B,187,XAUUSD,Buy,2022-06-29 12:00:00,2022-06-29 16:00:00,1829.81,1831.18,1,137,77093.9,Exit After X Bars,,None,None,None,None
1698_240906006_B,187,XAUUSD,Buy,2022-07-08 16:00:00,2022-07-08 20:00:00,1750.19,1742.24,1,-795,76298.9,Exit After X Bars,,None,None,None,None
1700_240906006_B,187,XAUUSD,Buy,2022-07-21 16:00:00,2022-07-21 20:00:00,1715.46,1711.62,1,-384,75914.9,Exit After X Bars,,None,None,None,None
1704_240906006_B,187,XAUUSD,Buy,2022-08-09 12:00:00,2022-08-09 16:00:00,1790.49,1793.78,1,329,76243.9,Exit After X Bars,,None,None,None,None
1705_240906006_B,187,XAUUSD,Buy,2022-08-10 12:00:00,2022-08-10 16:00:00,1801.03,1797.19,1,-384,75859.9,Exit After X Bars,,None,None,None,None
1707_240906006_B,187,XAUUSD,Buy,2022-08-12 20:00:00,2022-08-15 00:00:00,1799.79,1802.31,1,252,76111.9,End Of Friday,,None,None,None,None
1714_240906006_B,187,XAUUSD,Buy,2022-08-23 16:00:00,2022-08-23 20:00:00,1749.89,1749.64,1,-25,76086.9,Exit After X Bars,,None,None,None,None
1725_240906006_B,187,XAUUSD,Buy,2022-09-21 20:00:00,2022-09-22 00:00:00,1677.76,1673.04,1,-472,75614.9,Exit After X Bars,,None,None,None,None
1729_240906006_B,187,XAUUSD,Buy,2022-09-28 16:00:00,2022-09-28 20:00:00,1643.39,1659.16,1,1577,77191.9,Exit After X Bars,,None,None,None,None
1735_240906006_B,187,XAUUSD,Buy,2022-10-13 12:00:00,2022-10-13 16:00:00,1678.7,1654.55,1,-2415,74776.9,Exit After X Bars,,None,None,None,None
1741_240906006_B,187,XAUUSD,Buy,2022-10-21 16:00:00,2022-10-21 20:00:00,1646.06,1651.3,1,524,75300.9,Exit After X Bars,,None,None,None,None
1744_240906006_B,187,XAUUSD,Buy,2022-11-04 16:00:00,2022-11-04 20:00:00,1670.46,1673.16,1,270,75570.9,Exit After X Bars,,None,None,None,None
1745_240906006_B,187,XAUUSD,Buy,2022-11-15 20:00:00,2022-11-16 00:00:00,1778.06,1777.43,1,-63,75507.9,Exit After X Bars,,None,None,None,None
1750_240906006_B,187,XAUUSD,Buy,2022-11-22 12:00:00,2022-11-22 16:00:00,1748.8,1743.52,1,-528,74979.9,Exit After X Bars,,None,None,None,None
1751_240906006_B,187,XAUUSD,Buy,2022-11-23 20:00:00,2022-11-24 00:00:00,1750.38,1749.33,1,-105,74874.9,Exit After X Bars,,None,None,None,None
1754_240906006_B,187,XAUUSD,Buy,2022-11-30 20:00:00,2022-12-01 00:00:00,1765.13,1768.62,1,349,75223.9,Exit After X Bars,,None,None,None,None
1757_240906006_B,187,XAUUSD,Buy,2022-12-07 16:00:00,2022-12-07 20:00:00,1781.74,1782.96,1,122,75345.9,Exit After X Bars,,None,None,None,None
1758_240906006_B,187,XAUUSD,Buy,2022-12-08 12:00:00,2022-12-08 16:00:00,1791.66,1789.41,1,-225,75120.9,Exit After X Bars,,None,None,None,None
1760_240906006_B,187,XAUUSD,Buy,2022-12-13 12:00:00,2022-12-13 16:00:00,1796.23,1810.86,1,1463,76583.9,Exit After X Bars,,None,None,None,None
1763_240906006_B,187,XAUUSD,Buy,2022-12-20 04:00:00,2022-12-20 08:00:00,1795.82,1788.67,1,-715,75868.9,Exit After X Bars,,None,None,None,None
1768_240906006_B,187,XAUUSD,Buy,2023-01-06 16:00:00,2023-01-06 20:00:00,1859.96,1862.16,1,220,76088.9,Exit After X Bars,,None,None,None,None
1769_240906006_B,187,XAUUSD,Buy,2023-01-12 04:00:00,2023-01-12 08:00:00,1881.9,1883.55,1,165,76253.9,Exit After X Bars,,None,None,None,None
1771_240906006_B,187,XAUUSD,Buy,2023-01-18 12:00:00,2023-01-18 16:00:00,1917.11,1921.2,1,409,76662.9,Exit After X Bars,,None,None,None,None
1772_240906006_B,187,XAUUSD,Buy,2023-01-19 20:00:00,2023-01-20 00:00:00,1927.44,1931.74,1,430,77092.9,Exit After X Bars,,None,None,None,None
1774_240906006_B,187,XAUUSD,Buy,2023-01-24 08:00:00,2023-01-24 12:00:00,1939.45,1936.08,1,-337,76755.9,Exit After X Bars,,None,None,None,None
1775_240906006_B,187,XAUUSD,Buy,2023-01-25 20:00:00,2023-01-26 00:00:00,1943.13,1946.7,1,357,77112.9,Exit After X Bars,,None,None,None,None
1780_240906006_B,187,XAUUSD,Buy,2023-02-01 12:00:00,2023-02-01 16:00:00,1931.64,1929.13,1,-251,76861.9,Exit After X Bars,,None,None,None,None
1784_240906006_B,187,XAUUSD,Buy,2023-02-07 16:00:00,2023-02-07 20:00:00,1882.57,1880.47,1,-210,76651.9,Exit After X Bars,,None,None,None,None
1788_240906006_B,187,XAUUSD,Buy,2023-02-28 16:00:00,2023-02-28 20:00:00,1828.52,1829.15,1,63,76714.9,Exit After X Bars,,None,None,None,None
1791_240906006_B,187,XAUUSD,Buy,2023-03-09 12:00:00,2023-03-09 16:00:00,1825.04,1825.06,1,2,76716.9,Exit After X Bars,,None,None,None,None
1792_240906006_B,187,XAUUSD,Buy,2023-03-15 12:00:00,2023-03-15 16:00:00,1914.45,1927.72,1,1327,78043.9,Exit After X Bars,,None,None,None,None
1795_240906006_B,187,XAUUSD,Buy,2023-03-23 12:00:00,2023-03-23 16:00:00,1980.52,1971.81,1,-871,77172.9,Exit After X Bars,,None,None,None,None
1800_240906006_B,187,XAUUSD,Buy,2023-03-30 12:00:00,2023-03-30 16:00:00,1972.61,1970.18,1,-243,76929.9,Exit After X Bars,,None,None,None,None
1801_240906006_B,187,XAUUSD,Buy,2023-03-31 12:00:00,2023-03-31 16:00:00,1984.79,1979.55,1,-524,76405.9,Exit After X Bars,,None,None,None,None
1803_240906006_B,187,XAUUSD,Buy,2023-04-04 16:00:00,2023-04-04 16:00:00,1991.04,2014.54,1,2350,78755.9,PT,,None,None,None,None
1806_240906006_B,187,XAUUSD,Buy,2023-04-11 16:00:00,2023-04-11 20:00:00,2005.14,2006.04,1,90,78845.9,Exit After X Bars,,None,None,None,None
1811_240906006_B,187,XAUUSD,Buy,2023-04-20 12:00:00,2023-04-20 16:00:00,2008.76,2006.61,1,-215,78630.9,Exit After X Bars,,None,None,None,None
1813_240906006_B,187,XAUUSD,Buy,2023-04-26 16:00:00,2023-04-26 20:00:00,2006.04,1986.49,1,-1955,76675.9,Exit After X Bars,,None,None,None,None
1816_240906006_B,187,XAUUSD,Buy,2023-05-01 12:00:00,2023-05-01 16:00:00,1996.55,2004.07,1,752,77427.9,Exit After X Bars,,None,None,None,None
1819_240906006_B,187,XAUUSD,Buy,2023-05-09 12:00:00,2023-05-09 16:00:00,2029.94,2026.93,1,-301,77126.9,Exit After X Bars,,None,None,None,None
1820_240906006_B,187,XAUUSD,Buy,2023-05-10 12:00:00,2023-05-10 16:00:00,2038.4,2045.58,1,718,77844.9,Exit After X Bars,,None,None,None,None
1828_240906006_B,187,XAUUSD,Buy,2023-05-24 12:00:00,2023-05-24 16:00:00,1983.65,1979.84,1,-381,77463.9,Exit After X Bars,,None,None,None,None
1832_240906006_B,187,XAUUSD,Buy,2023-06-09 12:00:00,2023-06-09 16:00:00,1971.42,1962.82,1,-860,76603.9,Exit After X Bars,,None,None,None,None
1836_240906006_B,187,XAUUSD,Buy,2023-06-16 08:00:00,2023-06-16 12:00:00,1962.05,1963.01,1,96,76699.9,Exit After X Bars,,None,None,None,None
1841_240906006_B,187,XAUUSD,Buy,2023-06-23 16:00:00,2023-06-23 20:00:00,1934.91,1918.59,1,-1632,75067.9,Exit After X Bars,,None,None,None,None
1844_240906006_B,187,XAUUSD,Buy,2023-06-30 16:00:00,2023-06-30 20:00:00,1917.46,1919.9,1,244,75311.9,Exit After X Bars,,None,None,None,None
1846_240906006_B,187,XAUUSD,Buy,2023-07-07 16:00:00,2023-07-07 20:00:00,1928.1,1926.79,1,-131,75180.9,Exit After X Bars,,None,None,None,None
1851_240906006_B,187,XAUUSD,Buy,2023-07-26 08:00:00,2023-07-26 12:00:00,1968.22,1972.0,1,378,75558.9,Exit After X Bars,,None,None,None,None
1854_240906006_B,187,XAUUSD,Buy,2023-07-31 12:00:00,2023-07-31 16:00:00,1964.2,1965.36,1,116,75674.9,Exit After X Bars,,None,None,None,None
1858_240906006_B,187,XAUUSD,Buy,2023-08-04 12:00:00,2023-08-04 16:00:00,1939.47,1938.92,1,-55,75619.9,Exit After X Bars,,None,None,None,None
1863_240906006_B,187,XAUUSD,Buy,2023-09-01 12:00:00,2023-09-01 16:00:00,1948.15,1949.82,1,167,75786.9,Exit After X Bars,,None,None,None,None
1868_240906006_B,187,XAUUSD,Buy,2023-09-08 12:00:00,2023-09-08 16:00:00,1924.57,1920.33,1,-424,75362.9,Exit After X Bars,,None,None,None,None
1872_240906006_B,187,XAUUSD,Buy,2023-09-15 04:00:00,2023-09-15 08:00:00,1916.71,1916.0,1,-71,75291.9,Exit After X Bars,,None,None,None,None
1882_240906006_B,187,XAUUSD,Buy,2023-10-06 16:00:00,2023-10-06 20:00:00,1833.84,1829.1,1,-474,74817.9,Exit After X Bars,,None,None,None,None
1885_240906006_B,187,XAUUSD,Buy,2023-10-25 16:00:00,2023-10-25 20:00:00,1981.81,1978.15,1,-366,74451.9,Exit After X Bars,,None,None,None,None
1886_240906006_B,187,XAUUSD,Buy,2023-10-26 20:00:00,2023-10-27 00:00:00,1988.34,1984.49,1,-385,74066.9,Exit After X Bars,,None,None,None,None
1887_240906006_B,187,XAUUSD,Buy,2023-10-27 20:00:00,2023-10-30 00:00:00,1994.16,2004.14,1,998,75064.9,End Of Friday,,None,None,None,None
1889_240906006_B,187,XAUUSD,Buy,2023-10-31 16:00:00,2023-10-31 20:00:00,2006.13,1990.73,1,-1540,73524.9,Exit After X Bars,,None,None,None,None
1892_240906006_B,187,XAUUSD,Buy,2023-11-03 12:00:00,2023-11-03 16:00:00,1991.37,2000.05,1,868,74392.9,Exit After X Bars,,None,None,None,None
1898_240906006_B,187,XAUUSD,Buy,2023-11-14 16:00:00,2023-11-14 20:00:00,1961.96,1962.07,1,11,74403.9,Exit After X Bars,,None,None,None,None
1900_240906006_B,187,XAUUSD,Buy,2023-11-24 12:00:00,2023-11-24 16:00:00,1999.11,1999.55,1,44,74447.9,Exit After X Bars,,None,None,None,None
1902_240906006_B,187,XAUUSD,Buy,2023-12-01 16:00:00,2023-12-01 20:00:00,2048.57,2067.21,1,1864,76311.9,Exit After X Bars,,None,None,None,None
1906_240906006_B,187,XAUUSD,Buy,2023-12-07 12:00:00,2023-12-07 16:00:00,2036.66,2037.07,1,41,76352.9,Exit After X Bars,,None,None,None,None
1910_240906006_B,187,XAUUSD,Buy,2023-12-13 20:00:00,2023-12-13 20:00:00,1997.41,2020.91,1,2350,78702.9,PT,,None,None,None,None
1916_240906006_B,187,XAUUSD,Buy,2024-01-05 16:00:00,2024-01-05 20:00:00,2051.94,2041.84,1,-1010,77692.9,Exit After X Bars,,None,None,None,None
1919_240906006_B,187,XAUUSD,Buy,2024-01-11 12:00:00,2024-01-11 16:00:00,2042.95,2029.37,1,-1358,76334.9,Exit After X Bars,,None,None,None,None
1922_240906006_B,187,XAUUSD,Buy,2024-01-19 12:00:00,2024-01-19 16:00:00,2034.24,2035.14,1,90,76424.9,Exit After X Bars,,None,None,None,None
1927_240906006_B,187,XAUUSD,Buy,2024-02-07 16:00:00,2024-02-07 20:00:00,2039.17,2035.56,1,-361,76063.9,Exit After X Bars,,None,None,None,None
1931_240906006_B,187,XAUUSD,Buy,2024-02-13 12:00:00,2024-02-13 16:00:00,2028.08,2004.31,1,-2377,73686.9,Exit After X Bars,,None,None,None,None
1933_240906006_B,187,XAUUSD,Buy,2024-02-15 12:00:00,2024-02-15 16:00:00,1996.59,2003.72,1,713,74399.9,Exit After X Bars,,None,None,None,None
1934_240906006_B,187,XAUUSD,Buy,2024-02-23 16:00:00,2024-02-23 20:00:00,2035.59,2037.91,1,232,74631.9,Exit After X Bars,,None,None,None,None
1936_240906006_B,187,XAUUSD,Buy,2024-02-29 12:00:00,2024-02-29 16:00:00,2038.35,2047.56,1,921,75552.9,Exit After X Bars,,None,None,None,None
1944_240906006_B,187,XAUUSD,Buy,2024-03-20 16:00:00,2024-03-20 20:00:00,2163.56,2157.61,1,-595,74957.9,Exit After X Bars,,None,None,None,None
1947_240906006_B,187,XAUUSD,Buy,2024-03-26 12:00:00,2024-03-26 16:00:00,2181.85,2187.85,1,600,75557.9,Exit After X Bars,,None,None,None,None
1948_240906006_B,187,XAUUSD,Buy,2024-03-28 12:00:00,2024-03-28 16:00:00,2200.69,2215.62,1,1493,77050.9,Exit After X Bars,,None,None,None,None
1949_240906006_B,187,XAUUSD,Buy,2024-04-05 16:00:00,2024-04-05 20:00:00,2307.53,2327.17,1,1964,79014.9,Exit After X Bars,,None,None,None,None
1951_240906006_B,187,XAUUSD,Buy,2024-04-11 20:00:00,2024-04-12 00:00:00,2360.86,2371.5,1,1064,80078.9,Exit After X Bars,,None,None,None,None
1953_240906006_B,187,XAUUSD,Buy,2024-04-16 16:00:00,2024-04-16 20:00:00,2389.85,2397.41,1,756,80834.9,Exit After X Bars,,None,None,None,None
1955_240906006_B,187,XAUUSD,Buy,2024-04-19 04:00:00,2024-04-19 08:00:00,2397.36,2383.48,1,-1388,79446.9,Exit After X Bars,,None,None,None,None
1958_240906006_B,187,XAUUSD,Buy,2024-04-24 16:00:00,2024-04-24 20:00:00,2335.02,2324.97,1,-1005,78441.9,Exit After X Bars,,None,None,None,None
1959_240906006_B,187,XAUUSD,Buy,2024-04-25 16:00:00,2024-04-25 20:00:00,2338.08,2328.62,1,-946,77495.9,Exit After X Bars,,None,None,None,None
1966_240906006_B,187,XAUUSD,Buy,2024-05-27 12:00:00,2024-05-27 16:00:00,2349.02,2347.06,1,-196,77299.9,Exit After X Bars,,None,None,None,None
1967_240906006_B,187,XAUUSD,Buy,2024-05-28 16:00:00,2024-05-28 20:00:00,2358.99,2356.51,1,-248,77051.9,Exit After X Bars,,None,None,None,None
1971_240906006_B,187,XAUUSD,Buy,2024-06-06 04:00:00,2024-06-06 08:00:00,2358.46,2369.29,1,1083,78134.9,Exit After X Bars,,None,None,None,None
1974_240906006_B,187,XAUUSD,Buy,2024-06-11 12:00:00,2024-06-11 16:00:00,2314.4,2317.84,1,344,78478.9,Exit After X Bars,,None,None,None,None
1977_240906006_B,187,XAUUSD,Buy,2024-06-25 12:00:00,2024-06-25 16:00:00,2335.85,2324.05,1,-1180,77298.9,Exit After X Bars,,None,None,None,None
1979_240906006_B,187,XAUUSD,Buy,2024-06-27 12:00:00,2024-06-27 16:00:00,2322.2,2322.74,1,54,77352.9,Exit After X Bars,,None,None,None,None
1985_240906006_B,187,XAUUSD,Buy,2024-07-24 04:00:00,2024-07-24 08:00:00,2413.13,2417.71,1,458,77810.9,Exit After X Bars,,None,None,None,None
1988_240906006_B,187,XAUUSD,Buy,2024-07-30 16:00:00,2024-07-30 20:00:00,2392.52,2399.83,1,731,78541.9,Exit After X Bars,,None,None,None,None
1992_240906006_B,187,XAUUSD,Buy,2024-08-08 12:00:00,2024-08-08 16:00:00,2408.43,2407.93,1,-50,78491.9,Exit After X Bars,,None,None,None,None
1995_240906006_B,187,XAUUSD,Buy,2024-08-16 12:00:00,2024-08-16 16:00:00,2471.03,2491.56,1,2053,80544.9,Exit After X Bars,,None,None,None,None
1998_240906006_B,187,XAUUSD,Buy,2024-08-23 16:00:00,2024-08-23 20:00:00,2515.51,2510.2,1,-531,80013.9,Exit After X Bars,,None,None,None,None
1999_240906006_B,187,XAUUSD,Buy,2024-08-26 20:00:00,2024-08-27 00:00:00,2521.61,2517.44,1,-417,79596.9,Exit After X Bars,,None,None,None,None
2000_240906006_B,187,XAUUSD,Buy,2024-08-28 00:00:00,2024-08-28 04:00:00,2527.82,2524.28,1,-354,79242.9,Exit After X Bars,,None,None,None,None
2001_240906006_B,187,XAUUSD,Buy,2024-08-29 16:00:00,2024-08-29 20:00:00,2526.54,2525.14,1,-140,79102.9,Exit After X Bars,,None,None,None,None
