orderId,strategyRunId,symbol,orderType,openTime,closeTime,openPrice,closePrice,size,profit,balance,closeType,comment,sl,tp,swap,commission
1_241023001_B,194,XAUUSD,Buy,2010-05-11 13:00:00,2010-05-11 21:00:00,1212.47,1227.97,0.1,154.39,10154.39,PT,,None,None,None,None
5_241023001_B,194,XAUUSD,Buy,2010-07-13 15:00:00,2010-07-13 22:00:00,1212.57,1211.07,0.1,-15.61,10138.79,TrailingStop,,None,None,None,None
7_241023001_B,194,XAUUSD,Buy,2010-07-22 16:00:00,2010-07-22 19:00:00,1197.38,1194.09,0.1,-33.5,10105.29,TrailingStop,,None,None,None,None
9_241023001_B,194,XAUUSD,Buy,2010-08-12 15:00:00,2010-08-13 15:00:00,1209.17,1211.86,0.1,26.3,10131.58,TrailingStop,,None,None,None,None
10_241023001_B,194,XAUUSD,Buy,2010-08-18 18:00:00,2010-08-19 18:00:00,1228.09,1231.07,0.1,29.19,10160.77,TrailingStop,,None,None,None,None
11_241023001_B,194,XAUUSD,Buy,2010-08-24 17:00:00,2010-08-25 15:00:00,1231.33,1233.09,0.1,16.98,10177.75,TrailingStop,,None,None,None,None
13_241023001_B,194,XAUUSD,Buy,2010-08-31 15:00:00,2010-09-01 13:00:00,1238.13,1253.63,0.1,154.38,10332.14,PT,,None,None,None,None
14_241023001_B,194,XAUUSD,Buy,2010-09-07 15:00:00,2010-09-08 15:00:00,1252.84,1256.0,0.1,30.97,10363.11,TrailingStop,,None,None,None,None
15_241023001_B,194,XAUUSD,Buy,2010-09-14 16:00:00,2010-09-14 19:00:00,1261.84,1269.03,0.1,71.27,10434.38,TrailingStop,,None,None,None,None
16_241023001_B,194,XAUUSD,Buy,2010-09-21 21:00:00,2010-09-22 17:00:00,1283.16,1288.5,0.1,52.76,10487.14,TrailingStop,,None,None,None,None
17_241023001_B,194,XAUUSD,Buy,2010-10-05 10:00:00,2010-10-05 17:00:00,1319.74,1335.24,0.1,154.34,10641.48,PT,,None,None,None,None
18_241023001_B,194,XAUUSD,Buy,2010-10-13 04:00:00,2010-10-13 17:00:00,1354.85,1370.35,0.1,154.32,10795.8,PT,,None,None,None,None
21_241023001_B,194,XAUUSD,Buy,2010-10-28 18:00:00,2010-10-29 10:00:00,1343.15,1337.5,0.1,-57.17,10738.63,TrailingStop,,None,None,None,None
24_241023001_B,194,XAUUSD,Buy,2010-11-30 11:00:00,2010-11-30 21:00:00,1374.93,1382.12,0.1,71.21,10809.84,TrailingStop,,None,None,None,None
25_241023001_B,194,XAUUSD,Buy,2010-12-13 15:00:00,2010-12-14 15:00:00,1394.23,1400.92,0.1,66.2,10876.04,TrailingStop,,None,None,None,None
28_241023001_B,194,XAUUSD,Buy,2010-12-27 07:00:00,2010-12-27 15:00:00,1384.8,1379.58,0.1,-52.89,10823.15,SL,,None,None,None,None
30_241023001_B,194,XAUUSD,Buy,2011-01-11 10:00:00,2011-01-11 16:00:00,1379.79,1378.66,0.1,-11.99,10811.16,TrailingStop,,None,None,None,None
33_241023001_B,194,XAUUSD,Buy,2011-02-08 09:00:00,2011-02-09 01:00:00,1358.03,1362.14,0.1,40.42,10851.58,TrailingStop,,None,None,None,None
34_241023001_B,194,XAUUSD,Buy,2011-02-11 15:00:00,2011-02-11 19:00:00,1366.9,1359.69,0.1,-72.78,10778.8,SL,,None,None,None,None
35_241023001_B,194,XAUUSD,Buy,2011-03-07 13:00:00,2011-03-07 16:00:00,1440.17,1437.23,0.1,-30.12,10748.68,TrailingStop,,None,None,None,None
39_241023001_B,194,XAUUSD,Buy,2011-03-18 01:00:00,2011-03-18 15:00:00,1406.02,1421.52,0.1,154.3,10902.98,PT,,None,None,None,None
40_241023001_B,194,XAUUSD,Buy,2011-04-15 01:00:00,2011-04-15 06:00:00,1476.26,1472.42,0.1,-39.14,10863.84,TrailingStop,,None,None,None,None
41_241023001_B,194,XAUUSD,Buy,2011-04-27 20:00:00,2011-04-28 02:00:00,1518.11,1524.32,0.1,61.34,10925.18,TrailingStop,,None,None,None,None
44_241023001_B,194,XAUUSD,Buy,2011-05-20 10:00:00,2011-05-20 16:00:00,1504.38,1491.31,0.1,-131.45,10793.73,SL,,None,None,None,None
47_241023001_B,194,XAUUSD,Buy,2011-07-05 21:00:00,2011-07-06 13:00:00,1513.88,1513.52,0.1,-4.36,10789.37,TrailingStop,,None,None,None,None
48_241023001_B,194,XAUUSD,Buy,2011-07-22 16:00:00,2011-07-22 19:00:00,1604.47,1599.02,0.1,-55.3,10734.07,TrailingStop,,None,None,None,None
49_241023001_B,194,XAUUSD,Buy,2011-08-02 14:00:00,2011-08-02 22:00:00,1632.51,1648.01,0.1,154.18,10888.25,PT,,None,None,None,None
54_241023001_B,194,XAUUSD,Buy,2011-10-07 06:00:00,2011-10-07 19:00:00,1664.18,1630.37,0.1,-338.93,10549.32,SL,,None,None,None,None
55_241023001_B,194,XAUUSD,Buy,2011-10-17 10:00:00,2011-10-17 14:00:00,1691.98,1683.7,0.1,-83.65,10465.67,TrailingStop,,None,None,None,None
57_241023001_B,194,XAUUSD,Buy,2011-10-25 17:00:00,2011-10-25 17:00:00,1665.14,1680.64,0.1,154.17,10619.84,PT,,None,None,None,None
58_241023001_B,194,XAUUSD,Buy,2011-11-03 14:00:00,2011-11-03 17:00:00,1752.39,1749.97,0.1,-25.08,10594.76,TrailingStop,,None,None,None,None
61_241023001_B,194,XAUUSD,Buy,2011-11-28 03:00:00,2011-11-28 11:00:00,1701.84,1717.34,0.1,154.15,10748.91,PT,,None,None,None,None
62_241023001_B,194,XAUUSD,Buy,2011-11-30 13:00:00,2011-11-30 15:00:00,1720.13,1735.63,0.1,154.14,10903.05,PT,,None,None,None,None
66_241023001_B,194,XAUUSD,Buy,2012-01-10 13:00:00,2012-01-11 09:00:00,1630.87,1646.37,0.1,154.18,11057.24,PT,,None,None,None,None
67_241023001_B,194,XAUUSD,Buy,2012-01-17 09:00:00,2012-01-17 16:00:00,1662.0,1658.21,0.1,-38.73,11018.51,TrailingStop,,None,None,None,None
68_241023001_B,194,XAUUSD,Buy,2012-01-23 06:00:00,2012-01-23 16:00:00,1670.05,1667.81,0.1,-23.24,10995.27,TrailingStop,,None,None,None,None
69_241023001_B,194,XAUUSD,Buy,2012-01-25 19:00:00,2012-01-25 20:00:00,1679.55,1695.05,0.1,154.16,11149.43,PT,,None,None,None,None
71_241023001_B,194,XAUUSD,Buy,2012-02-15 16:00:00,2012-02-15 19:00:00,1733.3,1727.01,0.1,-63.77,11085.67,TrailingStop,,None,None,None,None
72_241023001_B,194,XAUUSD,Buy,2012-02-20 03:00:00,2012-02-21 17:00:00,1737.34,1747.64,0.1,102.13,11187.8,Exit After X Bars,,None,None,None,None
74_241023001_B,194,XAUUSD,Buy,2012-02-28 15:00:00,2012-02-28 20:00:00,1782.8,1781.38,0.1,-15.09,11172.71,TrailingStop,,None,None,None,None
76_241023001_B,194,XAUUSD,Buy,2012-03-09 17:00:00,2012-03-12 07:00:00,1703.9,1706.27,0.1,22.85,11195.55,TrailingStop,,None,None,None,None
79_241023001_B,194,XAUUSD,Buy,2012-03-23 17:00:00,2012-03-26 07:00:00,1661.85,1661.53,0.1,-4.03,11191.52,TrailingStop,,None,None,None,None
81_241023001_B,194,XAUUSD,Buy,2012-04-12 16:00:00,2012-04-12 20:00:00,1662.52,1678.02,0.1,154.17,11345.69,PT,,None,None,None,None
83_241023001_B,194,XAUUSD,Buy,2012-04-19 16:00:00,2012-04-19 17:00:00,1654.31,1645.16,0.1,-92.33,11253.36,SL,,None,None,None,None
84_241023001_B,194,XAUUSD,Buy,2012-04-24 16:00:00,2012-04-25 12:00:00,1646.85,1638.25,0.1,-86.82,11166.54,SL,,None,None,None,None
85_241023001_B,194,XAUUSD,Buy,2012-05-01 02:00:00,2012-05-01 17:00:00,1667.35,1663.58,0.1,-38.53,11128.01,TrailingStop,,None,None,None,None
90_241023001_B,194,XAUUSD,Buy,2012-06-01 15:00:00,2012-06-01 16:00:00,1573.33,1588.83,0.1,154.21,11282.22,PT,,None,None,None,None
91_241023001_B,194,XAUUSD,Buy,2012-06-19 10:00:00,2012-06-19 19:00:00,1632.47,1617.94,0.1,-146.12,11136.1,SL,,None,None,None,None
93_241023001_B,194,XAUUSD,Buy,2012-06-29 15:00:00,2012-06-29 20:00:00,1587.35,1602.85,0.1,154.21,11290.31,PT,,None,None,None,None
94_241023001_B,194,XAUUSD,Buy,2012-07-13 13:00:00,2012-07-16 03:00:00,1583.15,1586.9,0.1,36.71,11327.02,TrailingStop,,None,None,None,None
95_241023001_B,194,XAUUSD,Buy,2012-08-09 20:00:00,2012-08-10 10:00:00,1618.45,1611.26,0.1,-72.71,11254.31,SL,,None,None,None,None
96_241023001_B,194,XAUUSD,Buy,2012-08-10 16:00:00,2012-08-13 00:00:00,1618.35,1618.22,0.1,-2.11,11252.2,TrailingStop,,None,None,None,None
98_241023001_B,194,XAUUSD,Buy,2012-08-20 18:00:00,2012-08-21 15:00:00,1619.66,1635.16,0.1,154.19,11406.39,PT,,None,None,None,None
99_241023001_B,194,XAUUSD,Buy,2012-08-31 18:00:00,2012-08-31 22:00:00,1676.77,1692.27,0.1,154.16,11560.55,PT,,None,None,None,None
100_241023001_B,194,XAUUSD,Buy,2012-09-06 04:00:00,2012-09-06 15:00:00,1698.9,1705.07,0.1,60.85,11621.4,TrailingStop,,None,None,None,None
101_241023001_B,194,XAUUSD,Buy,2012-09-07 15:00:00,2012-09-07 16:00:00,1713.68,1729.18,0.1,154.14,11775.54,PT,,None,None,None,None
102_241023001_B,194,XAUUSD,Buy,2012-09-19 08:00:00,2012-09-19 15:00:00,1777.75,1766.65,0.1,-111.89,11663.66,SL,,None,None,None,None
103_241023001_B,194,XAUUSD,Buy,2012-09-21 15:00:00,2012-09-21 17:00:00,1779.35,1780.01,0.1,5.71,11669.37,TrailingStop,,None,None,None,None
105_241023001_B,194,XAUUSD,Buy,2012-09-27 18:00:00,2012-09-28 15:00:00,1774.99,1776.03,0.1,9.51,11678.88,TrailingStop,,None,None,None,None
106_241023001_B,194,XAUUSD,Buy,2012-10-01 15:00:00,2012-10-01 17:00:00,1783.16,1780.76,0.1,-24.89,11653.99,TrailingStop,,None,None,None,None
109_241023001_B,194,XAUUSD,Buy,2012-10-31 11:00:00,2012-10-31 20:00:00,1717.25,1719.58,0.1,22.44,11676.43,TrailingStop,,None,None,None,None
110_241023001_B,194,XAUUSD,Buy,2012-11-07 06:00:00,2012-11-07 14:00:00,1726.92,1718.84,0.1,-81.66,11594.77,SL,,None,None,None,None
111_241023001_B,194,XAUUSD,Buy,2012-11-19 17:00:00,2012-11-20 00:00:00,1733.93,1728.8,0.1,-52.17,11542.6,TrailingStop,,None,None,None,None
114_241023001_B,194,XAUUSD,Buy,2012-12-07 16:00:00,2012-12-11 02:00:00,1703.17,1710.02,0.1,67.65,11610.25,TrailingStop,,None,None,None,None
116_241023001_B,194,XAUUSD,Buy,2012-12-18 03:00:00,2012-12-18 13:00:00,1700.46,1697.78,0.1,-27.65,11582.6,TrailingStop,,None,None,None,None
119_241023001_B,194,XAUUSD,Buy,2012-12-26 10:00:00,2012-12-26 18:00:00,1659.02,1660.67,0.1,15.67,11598.27,TrailingStop,,None,None,None,None
120_241023001_B,194,XAUUSD,Buy,2013-01-02 03:00:00,2013-01-02 15:00:00,1675.7,1691.2,0.1,154.16,11752.43,PT,,None,None,None,None
121_241023001_B,194,XAUUSD,Buy,2013-01-17 17:00:00,2013-01-17 22:00:00,1684.8,1688.38,0.1,34.96,11787.39,TrailingStop,,None,None,None,None
126_241023001_B,194,XAUUSD,Buy,2013-03-15 17:00:00,2013-03-18 04:00:00,1599.23,1598.94,0.1,-3.7,11783.69,TrailingStop,,None,None,None,None
128_241023001_B,194,XAUUSD,Buy,2013-03-27 17:00:00,2013-03-28 13:00:00,1605.97,1601.98,0.1,-40.7,11742.98,TrailingStop,,None,None,None,None
131_241023001_B,194,XAUUSD,Buy,2013-04-18 12:00:00,2013-04-19 08:00:00,1395.04,1410.54,0.1,154.3,11897.29,PT,,None,None,None,None
134_241023001_B,194,XAUUSD,Buy,2013-05-28 18:00:00,2013-05-28 19:00:00,1396.57,1385.24,0.1,-114,11783.29,SL,,None,None,None,None
135_241023001_B,194,XAUUSD,Buy,2013-06-06 18:00:00,2013-06-07 14:00:00,1410.52,1408.88,0.1,-17.11,11766.18,TrailingStop,,None,None,None,None
136_241023001_B,194,XAUUSD,Buy,2013-06-12 17:00:00,2013-06-12 21:00:00,1389.02,1386.65,0.1,-24.39,11741.79,TrailingStop,,None,None,None,None
140_241023001_B,194,XAUUSD,Buy,2013-07-09 08:00:00,2013-07-09 17:00:00,1257.36,1245.82,0.1,-116.03,11625.76,SL,,None,None,None,None
141_241023001_B,194,XAUUSD,Buy,2013-07-31 04:00:00,2013-07-31 14:00:00,1338.26,1328.05,0.1,-102.77,11522.99,SL,,None,None,None,None
143_241023001_B,194,XAUUSD,Buy,2013-08-12 01:00:00,2013-08-12 13:00:00,1320.49,1324.73,0.1,41.74,11564.73,TrailingStop,,None,None,None,None
144_241023001_B,194,XAUUSD,Buy,2013-08-15 02:00:00,2013-08-15 14:00:00,1341.32,1335.37,0.1,-60.17,11504.56,TrailingStop,,None,None,None,None
146_241023001_B,194,XAUUSD,Buy,2013-08-22 17:00:00,2013-08-23 17:00:00,1378.99,1394.49,0.1,154.31,11658.87,PT,,None,None,None,None
151_241023001_B,194,XAUUSD,Buy,2013-09-18 21:00:00,2013-09-18 21:00:00,1323.84,1339.34,0.1,154.34,11813.21,PT,,None,None,None,None
153_241023001_B,194,XAUUSD,Buy,2013-10-17 10:00:00,2013-10-17 10:00:00,1289.92,1305.42,0.1,154.36,11967.56,PT,,None,None,None,None
154_241023001_B,194,XAUUSD,Buy,2013-10-22 15:00:00,2013-10-22 17:00:00,1324.02,1339.52,0.1,154.34,12121.9,PT,,None,None,None,None
156_241023001_B,194,XAUUSD,Buy,2013-11-06 13:00:00,2013-11-06 16:00:00,1322.5,1314.8,0.1,-77.66,12044.24,SL,,None,None,None,None
159_241023001_B,194,XAUUSD,Buy,2013-11-25 21:00:00,2013-11-26 14:00:00,1248.95,1248.57,0.1,-4.42,12039.82,TrailingStop,,None,None,None,None
161_241023001_B,194,XAUUSD,Buy,2013-12-06 16:00:00,2013-12-06 21:00:00,1243.44,1228.25,0.1,-152.52,11887.29,SL,,None,None,None,None
162_241023001_B,194,XAUUSD,Buy,2014-01-02 04:00:00,2014-01-02 10:00:00,1218.97,1220.14,0.1,11.09,11898.38,TrailingStop,,None,None,None,None
163_241023001_B,194,XAUUSD,Buy,2014-01-10 15:00:00,2014-01-13 11:00:00,1245.24,1245.7,0.1,3.98,11902.36,TrailingStop,,None,None,None,None
164_241023001_B,194,XAUUSD,Buy,2014-01-17 18:00:00,2014-01-21 03:00:00,1255.04,1252.78,0.1,-23.23,11879.13,TrailingStop,,None,None,None,None
165_241023001_B,194,XAUUSD,Buy,2014-01-23 17:00:00,2014-01-24 04:00:00,1261.2,1259.76,0.1,-15.03,11864.1,TrailingStop,,None,None,None,None
166_241023001_B,194,XAUUSD,Buy,2014-01-29 14:00:00,2014-01-29 19:00:00,1261.42,1261.59,0.1,1.07,11865.17,TrailingStop,,None,None,None,None
167_241023001_B,194,XAUUSD,Buy,2014-02-05 15:00:00,2014-02-05 16:00:00,1270.14,1258.11,0.1,-120.94,11744.24,SL,,None,None,None,None
169_241023001_B,194,XAUUSD,Buy,2014-02-20 21:00:00,2014-02-21 03:00:00,1322.75,1318.87,0.1,-39.46,11704.78,TrailingStop,,None,None,None,None
170_241023001_B,194,XAUUSD,Buy,2014-03-03 01:00:00,2014-03-03 11:00:00,1336.13,1344.17,0.1,79.73,11784.51,TrailingStop,,None,None,None,None
174_241023001_B,194,XAUUSD,Buy,2014-04-24 16:00:00,2014-04-25 17:00:00,1288.95,1304.45,0.1,154.36,11938.86,PT,,None,None,None,None
175_241023001_B,194,XAUUSD,Buy,2014-05-02 17:00:00,2014-05-05 04:00:00,1292.79,1308.29,0.1,154.35,12093.22,PT,,None,None,None,None
176_241023001_B,194,XAUUSD,Buy,2014-05-12 12:00:00,2014-05-12 20:00:00,1294.35,1295.96,0.1,15.45,12108.67,TrailingStop,,None,None,None,None
181_241023001_B,194,XAUUSD,Buy,2014-06-05 15:00:00,2014-06-05 16:00:00,1249.01,1251.34,0.1,22.68,12131.35,TrailingStop,,None,None,None,None
182_241023001_B,194,XAUUSD,Buy,2014-06-10 15:00:00,2014-06-11 01:00:00,1256.96,1258.07,0.1,10.47,12141.82,TrailingStop,,None,None,None,None
184_241023001_B,194,XAUUSD,Buy,2014-06-30 20:00:00,2014-07-01 09:00:00,1322.25,1324.81,0.1,24.94,12166.76,TrailingStop,,None,None,None,None
185_241023001_B,194,XAUUSD,Buy,2014-07-08 14:00:00,2014-07-08 17:00:00,1323.12,1320.58,0.1,-26.06,12140.7,TrailingStop,,None,None,None,None
188_241023001_B,194,XAUUSD,Buy,2014-07-29 10:00:00,2014-07-29 16:00:00,1311.18,1304.31,0.1,-69.36,12071.34,SL,,None,None,None,None
189_241023001_B,194,XAUUSD,Buy,2014-08-06 15:00:00,2014-08-07 10:00:00,1295.36,1304.4,0.1,89.75,12161.09,TrailingStop,,None,None,None,None
190_241023001_B,194,XAUUSD,Buy,2014-08-14 11:00:00,2014-08-14 13:00:00,1317.82,1310.22,0.1,-76.66,12084.43,SL,,None,None,None,None
194_241023001_B,194,XAUUSD,Buy,2014-09-23 13:00:00,2014-09-23 15:00:00,1228.49,1227.82,0.1,-7.31,12077.12,TrailingStop,,None,None,None,None
196_241023001_B,194,XAUUSD,Buy,2014-10-08 22:00:00,2014-10-09 16:00:00,1222.31,1225.91,0.1,35.39,12112.51,TrailingStop,,None,None,None,None
197_241023001_B,194,XAUUSD,Buy,2014-10-13 04:00:00,2014-10-13 11:00:00,1233.31,1229.1,0.1,-42.72,12069.79,TrailingStop,,None,None,None,None
198_241023001_B,194,XAUUSD,Buy,2014-10-15 15:00:00,2014-10-15 22:00:00,1238.17,1238.77,0.1,5.38,12075.17,TrailingStop,,None,None,None,None
199_241023001_B,194,XAUUSD,Buy,2014-10-20 14:00:00,2014-10-21 13:00:00,1245.15,1247.38,0.1,21.68,12096.85,TrailingStop,,None,None,None,None
200_241023001_B,194,XAUUSD,Buy,2014-10-28 15:00:00,2014-10-28 17:00:00,1234.3,1227.94,0.1,-64.22,12032.63,SL,,None,None,None,None
203_241023001_B,194,XAUUSD,Buy,2014-11-07 15:00:00,2014-11-07 17:00:00,1149.5,1165.0,0.1,154.43,12187.06,PT,,None,None,None,None
204_241023001_B,194,XAUUSD,Buy,2014-11-21 15:00:00,2014-11-21 18:00:00,1204.6,1197.8,0.1,-68.6,12118.46,TrailingStop,,None,None,None,None
206_241023001_B,194,XAUUSD,Buy,2014-12-01 18:00:00,2014-12-01 19:00:00,1201.63,1217.13,0.1,154.4,12272.85,PT,,None,None,None,None
207_241023001_B,194,XAUUSD,Buy,2014-12-09 14:00:00,2014-12-09 17:00:00,1213.3,1228.8,0.1,154.39,12427.25,PT,,None,None,None,None
212_241023001_B,194,XAUUSD,Buy,2015-01-09 15:00:00,2015-01-12 10:00:00,1218.57,1223.57,0.1,49.39,12476.64,TrailingStop,,None,None,None,None
213_241023001_B,194,XAUUSD,Buy,2015-01-14 16:00:00,2015-01-14 21:00:00,1244.09,1232.79,0.1,-113.62,12363.02,SL,,None,None,None,None
214_241023001_B,194,XAUUSD,Buy,2015-01-22 18:00:00,2015-01-23 08:00:00,1305.24,1293.47,0.1,-118.35,12244.66,SL,,None,None,None,None
223_241023001_B,194,XAUUSD,Buy,2015-03-05 17:00:00,2015-03-05 19:00:00,1208.93,1201.59,0.1,-74,12170.66,SL,,None,None,None,None
225_241023001_B,194,XAUUSD,Buy,2015-03-18 21:00:00,2015-03-19 10:00:00,1164.05,1168.43,0.1,43.22,12213.88,TrailingStop,,None,None,None,None
228_241023001_B,194,XAUUSD,Buy,2015-05-12 13:00:00,2015-05-12 16:00:00,1197.61,1190.54,0.1,-71.3,12142.58,SL,,None,None,None,None
230_241023001_B,194,XAUUSD,Buy,2015-05-22 10:00:00,2015-05-22 15:00:00,1213.37,1209.67,0.1,-37.61,12104.97,TrailingStop,,None,None,None,None
232_241023001_B,194,XAUUSD,Buy,2015-06-01 16:00:00,2015-06-01 17:00:00,1193.87,1199.81,0.1,58.8,12163.77,TrailingStop,,None,None,None,None
234_241023001_B,194,XAUUSD,Buy,2015-06-17 21:00:00,2015-06-18 15:00:00,1187.87,1203.37,0.1,154.41,12318.18,PT,,None,None,None,None
236_241023001_B,194,XAUUSD,Buy,2015-06-29 01:00:00,2015-06-29 04:00:00,1184.83,1181.96,0.1,-29.3,12288.88,TrailingStop,,None,None,None,None
238_241023001_B,194,XAUUSD,Buy,2015-07-06 01:00:00,2015-07-06 04:00:00,1175.05,1169.94,0.1,-51.69,12237.19,SL,,None,None,None,None
245_241023001_B,194,XAUUSD,Buy,2015-07-31 16:00:00,2015-07-31 17:00:00,1101.85,1093.35,0.1,-85.55,12151.64,SL,,None,None,None,None
246_241023001_B,194,XAUUSD,Buy,2015-08-07 10:00:00,2015-08-07 14:00:00,1097.69,1089.75,0.1,-79.95,12071.69,SL,,None,None,None,None
247_241023001_B,194,XAUUSD,Buy,2015-08-19 16:00:00,2015-08-20 11:00:00,1126.81,1136.59,0.1,97.24,12168.93,TrailingStop,,None,None,None,None
250_241023001_B,194,XAUUSD,Buy,2015-09-16 12:00:00,2015-09-16 20:00:00,1110.42,1119.86,0.1,93.84,12262.77,TrailingStop,,None,None,None,None
251_241023001_B,194,XAUUSD,Buy,2015-09-24 16:00:00,2015-09-24 17:00:00,1139.89,1155.39,0.1,154.43,12417.2,PT,,None,None,None,None
253_241023001_B,194,XAUUSD,Buy,2015-10-09 10:00:00,2015-10-09 16:00:00,1153.63,1151.59,0.1,-20.98,12396.23,TrailingStop,,None,None,None,None
254_241023001_B,194,XAUUSD,Buy,2015-10-13 23:00:00,2015-10-14 12:00:00,1169.0,1170.02,0.1,9.62,12405.84,TrailingStop,,None,None,None,None
256_241023001_B,194,XAUUSD,Buy,2015-10-28 08:00:00,2015-10-28 20:00:00,1169.64,1176.75,0.1,70.52,12476.36,TrailingStop,,None,None,None,None
259_241023001_B,194,XAUUSD,Buy,2015-11-16 03:00:00,2015-11-16 10:00:00,1093.55,1093.4,0.1,-2.05,12474.31,TrailingStop,,None,None,None,None
262_241023001_B,194,XAUUSD,Buy,2015-12-04 16:00:00,2015-12-07 13:00:00,1074.63,1082.0,0.1,73.16,12547.47,TrailingStop,,None,None,None,None
263_241023001_B,194,XAUUSD,Buy,2015-12-11 16:00:00,2015-12-14 01:00:00,1076.43,1072.87,0.1,-36.14,12511.33,TrailingStop,,None,None,None,None
266_241023001_B,194,XAUUSD,Buy,2016-01-04 15:00:00,2016-01-04 17:00:00,1075.3,1076.85,0.1,14.96,12526.3,TrailingStop,,None,None,None,None
268_241023001_B,194,XAUUSD,Buy,2016-01-19 10:00:00,2016-01-19 12:00:00,1093.31,1087.32,0.1,-60.45,12465.85,SL,,None,None,None,None
269_241023001_B,194,XAUUSD,Buy,2016-02-11 01:00:00,2016-02-11 10:00:00,1198.88,1214.38,0.1,154.4,12620.25,PT,,None,None,None,None
271_241023001_B,194,XAUUSD,Buy,2016-02-24 12:00:00,2016-02-24 16:00:00,1234.53,1250.03,0.1,154.38,12774.63,PT,,None,None,None,None
273_241023001_B,194,XAUUSD,Buy,2016-03-03 16:00:00,2016-03-03 22:00:00,1248.46,1263.96,0.1,154.38,12929.01,PT,,None,None,None,None
274_241023001_B,194,XAUUSD,Buy,2016-03-11 03:00:00,2016-03-11 10:00:00,1278.04,1264.62,0.1,-134.84,12794.17,SL,,None,None,None,None
279_241023001_B,194,XAUUSD,Buy,2016-04-19 09:00:00,2016-04-20 04:00:00,1241.58,1257.08,0.1,154.38,12948.55,PT,,None,None,None,None
287_241023001_B,194,XAUUSD,Buy,2016-06-03 15:00:00,2016-06-03 15:00:00,1217.63,1233.13,0.1,154.39,13102.94,PT,,None,None,None,None
288_241023001_B,194,XAUUSD,Buy,2016-06-08 04:00:00,2016-06-08 16:00:00,1248.63,1264.13,0.1,154.38,13257.32,PT,,None,None,None,None
290_241023001_B,194,XAUUSD,Buy,2016-06-24 05:00:00,2016-06-24 06:00:00,1292.22,1307.72,0.1,154.35,13411.67,PT,,None,None,None,None
291_241023001_B,194,XAUUSD,Buy,2016-07-01 08:00:00,2016-07-04 01:00:00,1335.29,1337.09,0.1,17.33,13429,TrailingStop,,None,None,None,None
295_241023001_B,194,XAUUSD,Buy,2016-07-27 21:00:00,2016-07-28 17:00:00,1333.73,1337.91,0.1,41.13,13470.13,TrailingStop,,None,None,None,None
296_241023001_B,194,XAUUSD,Buy,2016-07-29 15:00:00,2016-08-01 01:00:00,1345.53,1347.48,0.1,18.83,13488.96,TrailingStop,,None,None,None,None
299_241023001_B,194,XAUUSD,Buy,2016-08-16 13:00:00,2016-08-16 15:00:00,1353.28,1348.57,0.1,-47.78,13441.19,TrailingStop,,None,None,None,None
305_241023001_B,194,XAUUSD,Buy,2016-09-21 09:00:00,2016-09-21 16:00:00,1317.89,1324.12,0.1,61.64,13502.83,TrailingStop,,None,None,None,None
308_241023001_B,194,XAUUSD,Buy,2016-10-18 09:00:00,2016-10-18 16:00:00,1262.23,1258.25,0.1,-40.43,13462.4,TrailingStop,,None,None,None,None
309_241023001_B,194,XAUUSD,Buy,2016-10-25 18:00:00,2016-10-26 13:00:00,1274.37,1272.3,0.1,-21.34,13441.06,TrailingStop,,None,None,None,None
310_241023001_B,194,XAUUSD,Buy,2016-10-28 16:00:00,2016-10-28 21:00:00,1272.78,1278.63,0.1,57.86,13498.92,TrailingStop,,None,None,None,None
311_241023001_B,194,XAUUSD,Buy,2016-11-09 04:00:00,2016-11-09 05:00:00,1307.17,1322.67,0.1,154.35,13653.27,PT,,None,None,None,None
313_241023001_B,194,XAUUSD,Buy,2016-11-28 02:00:00,2016-11-28 12:00:00,1190.77,1189.37,0.1,-14.6,13638.67,TrailingStop,,None,None,None,None
314_241023001_B,194,XAUUSD,Buy,2016-12-07 16:00:00,2016-12-07 21:00:00,1177.96,1173.09,0.1,-49.29,13589.38,TrailingStop,,None,None,None,None
318_241023001_B,194,XAUUSD,Buy,2016-12-27 04:00:00,2016-12-27 16:00:00,1137.06,1140.07,0.1,29.53,13618.92,TrailingStop,,None,None,None,None
319_241023001_B,194,XAUUSD,Buy,2017-01-03 18:00:00,2017-01-04 21:00:00,1163.2,1161.06,0.1,-21.98,13596.93,TrailingStop,,None,None,None,None
320_241023001_B,194,XAUUSD,Buy,2017-01-11 20:00:00,2017-01-11 22:00:00,1190.61,1189.78,0.1,-8.9,13588.04,TrailingStop,,None,None,None,None
321_241023001_B,194,XAUUSD,Buy,2017-01-23 03:00:00,2017-01-23 09:00:00,1217.51,1213.13,0.1,-44.41,13543.63,TrailingStop,,None,None,None,None
322_241023001_B,194,XAUUSD,Buy,2017-02-06 03:00:00,2017-02-07 09:00:00,1225.29,1230.4,0.1,50.49,13594.12,TrailingStop,,None,None,None,None
323_241023001_B,194,XAUUSD,Buy,2017-02-16 01:00:00,2017-02-17 16:00:00,1234.48,1241.78,0.1,72.38,13666.5,Exit After X Bars,,None,None,None,None
324_241023001_B,194,XAUUSD,Buy,2017-02-23 14:00:00,2017-02-24 15:00:00,1243.75,1259.25,0.1,154.38,13820.88,PT,,None,None,None,None
326_241023001_B,194,XAUUSD,Buy,2017-03-15 21:00:00,2017-03-16 08:00:00,1211.13,1226.63,0.1,154.39,13975.27,PT,,None,None,None,None
327_241023001_B,194,XAUUSD,Buy,2017-03-21 16:00:00,2017-03-21 21:00:00,1235.47,1243.52,0.1,79.88,14055.16,TrailingStop,,None,None,None,None
329_241023001_B,194,XAUUSD,Buy,2017-04-04 01:00:00,2017-04-04 16:00:00,1254.61,1256.84,0.1,21.67,14076.83,TrailingStop,,None,None,None,None
330_241023001_B,194,XAUUSD,Buy,2017-04-07 04:00:00,2017-04-07 16:00:00,1261.25,1262.39,0.1,10.77,14087.6,TrailingStop,,None,None,None,None
331_241023001_B,194,XAUUSD,Buy,2017-04-11 17:00:00,2017-04-11 19:00:00,1270.53,1268.87,0.1,-17.24,14070.36,TrailingStop,,None,None,None,None
334_241023001_B,194,XAUUSD,Buy,2017-05-01 17:00:00,2017-05-01 18:00:00,1268.52,1263.52,0.1,-50.63,14019.73,SL,,None,None,None,None
336_241023001_B,194,XAUUSD,Buy,2017-05-26 09:00:00,2017-05-29 07:00:00,1259.63,1265.41,0.1,57.17,14076.9,TrailingStop,,None,None,None,None
337_241023001_B,194,XAUUSD,Buy,2017-05-31 18:00:00,2017-05-31 22:00:00,1268.99,1268.57,0.1,-4.83,14072.06,TrailingStop,,None,None,None,None
338_241023001_B,194,XAUUSD,Buy,2017-06-02 15:00:00,2017-06-05 19:00:00,1270.28,1277.83,0.1,74.86,14146.93,TrailingStop,,None,None,None,None
340_241023001_B,194,XAUUSD,Buy,2017-06-14 05:00:00,2017-06-14 14:00:00,1270.35,1265.03,0.1,-53.84,14093.09,SL,,None,None,None,None
345_241023001_B,194,XAUUSD,Buy,2017-07-14 15:00:00,2017-07-14 17:00:00,1224.42,1228.07,0.1,35.89,14128.98,TrailingStop,,None,None,None,None
346_241023001_B,194,XAUUSD,Buy,2017-07-20 17:00:00,2017-07-20 22:00:00,1243.98,1242.85,0.1,-11.92,14117.06,TrailingStop,,None,None,None,None
347_241023001_B,194,XAUUSD,Buy,2017-07-26 22:00:00,2017-07-27 17:00:00,1258.79,1260.53,0.1,16.77,14133.83,TrailingStop,,None,None,None,None
348_241023001_B,194,XAUUSD,Buy,2017-08-01 16:00:00,2017-08-01 22:00:00,1271.13,1269.44,0.1,-17.54,14116.29,TrailingStop,,None,None,None,None
350_241023001_B,194,XAUUSD,Buy,2017-08-18 10:00:00,2017-08-18 17:00:00,1292.01,1293.61,0.1,15.35,14131.65,TrailingStop,,None,None,None,None
352_241023001_B,194,XAUUSD,Buy,2017-08-31 17:00:00,2017-09-01 04:00:00,1313.64,1318.91,0.1,52.04,14183.69,TrailingStop,,None,None,None,None
353_241023001_B,194,XAUUSD,Buy,2017-09-05 20:00:00,2017-09-05 23:00:00,1339.59,1338.82,0.1,-8.37,14175.32,TrailingStop,,None,None,None,None
356_241023001_B,194,XAUUSD,Buy,2017-09-25 17:00:00,2017-09-26 09:00:00,1298.69,1308.83,0.1,100.75,14276.07,TrailingStop,,None,None,None,None
358_241023001_B,194,XAUUSD,Buy,2017-10-09 05:00:00,2017-10-09 10:00:00,1282.17,1280.4,0.1,-18.34,14257.73,TrailingStop,,None,None,None,None
362_241023001_B,194,XAUUSD,Buy,2017-11-01 12:00:00,2017-11-01 15:00:00,1278.77,1275.65,0.1,-31.84,14225.89,TrailingStop,,None,None,None,None
364_241023001_B,194,XAUUSD,Buy,2017-11-14 17:00:00,2017-11-15 16:00:00,1279.72,1284.4,0.1,46.16,14272.05,TrailingStop,,None,None,None,None
365_241023001_B,194,XAUUSD,Buy,2017-11-17 18:00:00,2017-11-20 09:00:00,1289.45,1290.44,0.1,9.26,14281.31,TrailingStop,,None,None,None,None
366_241023001_B,194,XAUUSD,Buy,2017-11-27 10:00:00,2017-11-27 16:00:00,1293.5,1295.17,0.1,16.05,14297.36,TrailingStop,,None,None,None,None
371_241023001_B,194,XAUUSD,Buy,2017-12-13 21:00:00,2017-12-14 10:00:00,1252.31,1254.75,0.1,23.77,14321.13,TrailingStop,,None,None,None,None
372_241023001_B,194,XAUUSD,Buy,2018-01-10 12:00:00,2018-01-10 15:00:00,1322.1,1319.97,0.1,-21.96,14299.17,TrailingStop,,None,None,None,None
375_241023001_B,194,XAUUSD,Buy,2018-02-01 22:00:00,2018-02-02 12:00:00,1348.88,1345.04,0.1,-39.07,14260.1,TrailingStop,,None,None,None,None
377_241023001_B,194,XAUUSD,Buy,2018-02-14 16:00:00,2018-02-14 17:00:00,1330.99,1346.49,0.1,154.33,14414.43,PT,,None,None,None,None
381_241023001_B,194,XAUUSD,Buy,2018-03-21 21:00:00,2018-03-22 05:00:00,1329.99,1330.04,0.1,-0.16,14414.27,TrailingStop,,None,None,None,None
383_241023001_B,194,XAUUSD,Buy,2018-04-11 14:00:00,2018-04-11 18:00:00,1348.22,1363.72,0.1,154.33,14568.59,PT,,None,None,None,None
385_241023001_B,194,XAUUSD,Buy,2018-04-18 14:00:00,2018-04-18 16:00:00,1350.44,1348.82,0.1,-16.88,14551.72,TrailingStop,,None,None,None,None
388_241023001_B,194,XAUUSD,Buy,2018-05-10 15:00:00,2018-05-10 16:00:00,1318.89,1318.16,0.1,-7.96,14543.76,TrailingStop,,None,None,None,None
392_241023001_B,194,XAUUSD,Buy,2018-06-05 18:00:00,2018-06-06 12:00:00,1298.02,1295.67,0.1,-24.15,14519.61,TrailingStop,,None,None,None,None
395_241023001_B,194,XAUUSD,Buy,2018-06-13 22:00:00,2018-06-14 16:00:00,1300.47,1304.31,0.1,37.75,14557.36,TrailingStop,,None,None,None,None
399_241023001_B,194,XAUUSD,Buy,2018-07-03 17:00:00,2018-07-03 19:00:00,1255.57,1253.12,0.1,-25.13,14532.23,TrailingStop,,None,None,None,None
400_241023001_B,194,XAUUSD,Buy,2018-07-09 09:00:00,2018-07-09 17:00:00,1261.05,1261.96,0.1,8.47,14540.7,TrailingStop,,None,None,None,None
403_241023001_B,194,XAUUSD,Buy,2018-07-26 04:00:00,2018-07-26 10:00:00,1235.08,1228.2,0.1,-69.42,14471.28,SL,,None,None,None,None
405_241023001_B,194,XAUUSD,Buy,2018-07-31 19:00:00,2018-07-31 23:00:00,1225.03,1222.38,0.1,-27.11,14444.17,TrailingStop,,None,None,None,None
407_241023001_B,194,XAUUSD,Buy,2018-08-10 17:00:00,2018-08-10 18:00:00,1217.24,1212.15,0.1,-51.51,14392.66,SL,,None,None,None,None
409_241023001_B,194,XAUUSD,Buy,2018-08-24 17:00:00,2018-08-27 04:00:00,1201.56,1204.49,0.1,28.7,14421.36,TrailingStop,,None,None,None,None
410_241023001_B,194,XAUUSD,Buy,2018-08-30 15:00:00,2018-08-30 16:00:00,1207.23,1201.36,0.1,-59.3,14362.06,SL,,None,None,None,None
412_241023001_B,194,XAUUSD,Buy,2018-09-06 12:00:00,2018-09-06 18:00:00,1203.81,1202.09,0.1,-17.8,14344.26,TrailingStop,,None,None,None,None
414_241023001_B,194,XAUUSD,Buy,2018-09-11 23:00:00,2018-09-13 05:00:00,1198.44,1204.31,0.1,58.1,14402.36,TrailingStop,,None,None,None,None
416_241023001_B,194,XAUUSD,Buy,2018-10-02 16:00:00,2018-10-02 19:00:00,1203.27,1203.61,0.1,2.8,14405.16,TrailingStop,,None,None,None,None
418_241023001_B,194,XAUUSD,Buy,2018-10-11 13:00:00,2018-10-11 20:00:00,1205.76,1221.26,0.1,154.4,14559.55,PT,,None,None,None,None
420_241023001_B,194,XAUUSD,Buy,2018-10-23 10:00:00,2018-10-23 17:00:00,1230.75,1234.43,0.1,36.18,14595.74,TrailingStop,,None,None,None,None
422_241023001_B,194,XAUUSD,Buy,2018-11-06 12:00:00,2018-11-06 16:00:00,1236.35,1230.2,0.1,-62.12,14533.62,SL,,None,None,None,None
425_241023001_B,194,XAUUSD,Buy,2018-11-29 14:00:00,2018-11-29 20:00:00,1227.96,1223.38,0.1,-46.41,14487.21,SL,,None,None,None,None
426_241023001_B,194,XAUUSD,Buy,2018-12-03 09:00:00,2018-12-03 13:00:00,1228.92,1228.53,0.1,-4.51,14482.69,TrailingStop,,None,None,None,None
428_241023001_B,194,XAUUSD,Buy,2018-12-17 19:00:00,2018-12-18 08:00:00,1247.18,1245.62,0.1,-16.22,14466.47,TrailingStop,,None,None,None,None
429_241023001_B,194,XAUUSD,Buy,2019-01-10 04:00:00,2019-01-10 11:00:00,1295.0,1293.23,0.1,-18.35,14448.12,TrailingStop,,None,None,None,None
430_241023001_B,194,XAUUSD,Buy,2019-01-25 15:00:00,2019-01-25 23:00:00,1286.44,1301.94,0.1,154.36,14602.48,PT,,None,None,None,None
433_241023001_B,194,XAUUSD,Buy,2019-02-13 17:00:00,2019-02-13 20:00:00,1315.57,1310.86,0.1,-47.76,14554.72,SL,,None,None,None,None
436_241023001_B,194,XAUUSD,Buy,2019-03-08 07:00:00,2019-03-11 01:00:00,1290.89,1296.51,0.1,55.55,14610.27,TrailingStop,,None,None,None,None
437_241023001_B,194,XAUUSD,Buy,2019-03-19 16:00:00,2019-03-20 02:00:00,1311.17,1304.98,0.1,-62.56,14547.72,SL,,None,None,None,None
440_241023001_B,194,XAUUSD,Buy,2019-04-22 06:00:00,2019-04-22 16:00:00,1279.69,1275.04,0.1,-47.14,14500.58,SL,,None,None,None,None
441_241023001_B,194,XAUUSD,Buy,2019-04-25 16:00:00,2019-04-25 18:00:00,1279.77,1278.81,0.1,-10.24,14490.34,TrailingStop,,None,None,None,None
442_241023001_B,194,XAUUSD,Buy,2019-05-01 21:00:00,2019-05-01 21:00:00,1286.12,1281.29,0.1,-48.94,14441.39,SL,,None,None,None,None
444_241023001_B,194,XAUUSD,Buy,2019-05-23 15:00:00,2019-05-23 16:00:00,1278.95,1280.07,0.1,10.56,14451.96,TrailingStop,,None,None,None,None
446_241023001_B,194,XAUUSD,Buy,2019-05-30 18:00:00,2019-05-31 14:00:00,1285.46,1295.98,0.1,104.56,14556.51,TrailingStop,,None,None,None,None
447_241023001_B,194,XAUUSD,Buy,2019-06-14 05:00:00,2019-06-14 15:00:00,1348.2,1351.2,0.1,29.33,14585.84,TrailingStop,,None,None,None,None
448_241023001_B,194,XAUUSD,Buy,2019-06-19 23:00:00,2019-06-20 03:00:00,1358.09,1373.59,0.1,154.32,14740.16,PT,,None,None,None,None
450_241023001_B,194,XAUUSD,Buy,2019-07-03 01:00:00,2019-07-03 04:00:00,1424.57,1426.91,0.1,22.69,14762.85,TrailingStop,,None,None,None,None
452_241023001_B,194,XAUUSD,Buy,2019-07-10 15:00:00,2019-07-10 18:00:00,1407.51,1403.9,0.1,-36.8,14726.04,TrailingStop,,None,None,None,None
453_241023001_B,194,XAUUSD,Buy,2019-07-17 17:00:00,2019-07-18 04:00:00,1419.7,1423.35,0.1,35.79,14761.83,TrailingStop,,None,None,None,None
454_241023001_B,194,XAUUSD,Buy,2019-07-23 17:00:00,2019-07-23 18:00:00,1429.96,1421.27,0.1,-87.61,14674.22,SL,,None,None,None,None
455_241023001_B,194,XAUUSD,Buy,2019-07-30 12:00:00,2019-07-31 17:00:00,1429.45,1427.81,0.1,-17.11,14657.1,TrailingStop,,None,None,None,None
456_241023001_B,194,XAUUSD,Buy,2019-08-01 20:00:00,2019-08-02 01:00:00,1433.17,1448.67,0.1,154.28,14811.39,PT,,None,None,None,None
457_241023001_B,194,XAUUSD,Buy,2019-08-12 14:00:00,2019-08-13 09:00:00,1508.95,1524.45,0.1,154.25,14965.63,PT,,None,None,None,None
459_241023001_B,194,XAUUSD,Buy,2019-08-23 16:00:00,2019-08-23 18:00:00,1508.03,1523.53,0.1,154.25,15119.88,PT,,None,None,None,None
460_241023001_B,194,XAUUSD,Buy,2019-09-03 18:00:00,2019-09-03 22:00:00,1546.81,1542.33,0.1,-45.57,15074.31,TrailingStop,,None,None,None,None
462_241023001_B,194,XAUUSD,Buy,2019-09-18 20:00:00,2019-09-18 21:00:00,1512.07,1501.61,0.1,-105.36,14968.95,SL,,None,None,None,None
463_241023001_B,194,XAUUSD,Buy,2019-10-03 17:00:00,2019-10-03 18:00:00,1512.24,1506.87,0.1,-54.46,14914.49,TrailingStop,,None,None,None,None
464_241023001_B,194,XAUUSD,Buy,2019-10-10 01:00:00,2019-10-10 09:00:00,1515.66,1504.76,0.1,-109.76,14804.74,SL,,None,None,None,None
465_241023001_B,194,XAUUSD,Buy,2019-10-23 10:00:00,2019-10-23 13:00:00,1494.01,1490.34,0.1,-37.45,14767.29,TrailingStop,,None,None,None,None
467_241023001_B,194,XAUUSD,Buy,2019-10-30 22:00:00,2019-10-31 16:00:00,1494.72,1510.22,0.1,154.25,14921.54,PT,,None,None,None,None
470_241023001_B,194,XAUUSD,Buy,2019-11-18 16:00:00,2019-11-19 10:00:00,1471.25,1468.34,0.1,-29.84,14891.71,TrailingStop,,None,None,None,None
472_241023001_B,194,XAUUSD,Buy,2019-11-29 16:00:00,2019-12-02 02:00:00,1458.21,1460.67,0.1,23.87,14915.58,TrailingStop,,None,None,None,None
473_241023001_B,194,XAUUSD,Buy,2019-12-06 15:00:00,2019-12-06 15:00:00,1480.31,1474.36,0.1,-60.24,14855.34,SL,,None,None,None,None
475_241023001_B,194,XAUUSD,Buy,2019-12-19 19:00:00,2019-12-20 10:00:00,1480.49,1477.59,0.1,-29.74,14825.6,TrailingStop,,None,None,None,None
476_241023001_B,194,XAUUSD,Buy,2020-01-08 01:00:00,2020-01-08 02:00:00,1585.63,1601.13,0.1,154.21,14979.8,PT,,None,None,None,None
477_241023001_B,194,XAUUSD,Buy,2020-01-23 01:00:00,2020-01-23 09:00:00,1562.71,1553.65,0.1,-91.38,14888.42,SL,,None,None,None,None
479_241023001_B,194,XAUUSD,Buy,2020-01-31 17:00:00,2020-01-31 18:00:00,1585.89,1582.83,0.1,-31.39,14857.03,TrailingStop,,None,None,None,None
481_241023001_B,194,XAUUSD,Buy,2020-02-13 12:00:00,2020-02-17 04:00:00,1576.93,1582.05,0.1,50.41,14907.44,Exit After X Bars,,None,None,None,None
483_241023001_B,194,XAUUSD,Buy,2020-03-05 16:00:00,2020-03-06 02:00:00,1660.37,1675.87,0.1,154.17,15061.61,PT,,None,None,None,None
485_241023001_B,194,XAUUSD,Buy,2020-03-23 19:00:00,2020-03-24 01:00:00,1546.25,1561.75,0.1,154.23,15215.84,PT,,None,None,None,None
487_241023001_B,194,XAUUSD,Buy,2020-04-06 14:00:00,2020-04-06 20:00:00,1639.46,1654.96,0.1,154.18,15370.02,PT,,None,None,None,None
488_241023001_B,194,XAUUSD,Buy,2020-04-09 16:00:00,2020-04-13 01:00:00,1674.83,1690.33,0.1,154.16,15524.18,PT,,None,None,None,None
491_241023001_B,194,XAUUSD,Buy,2020-04-22 12:00:00,2020-04-22 20:00:00,1702.14,1717.64,0.1,154.15,15678.33,PT,,None,None,None,None
492_241023001_B,194,XAUUSD,Buy,2020-05-07 19:00:00,2020-05-08 15:00:00,1713.23,1712.55,0.1,-7.66,15670.67,TrailingStop,,None,None,None,None
493_241023001_B,194,XAUUSD,Buy,2020-05-14 16:00:00,2020-05-15 15:00:00,1723.15,1738.65,0.1,154.14,15824.81,PT,,None,None,None,None
496_241023001_B,194,XAUUSD,Buy,2020-06-01 01:00:00,2020-06-01 11:00:00,1739.96,1735.97,0.1,-40.77,15784.04,TrailingStop,,None,None,None,None
497_241023001_B,194,XAUUSD,Buy,2020-06-10 14:00:00,2020-06-10 18:00:00,1721.86,1715.99,0.1,-59.56,15724.48,TrailingStop,,None,None,None,None
498_241023001_B,194,XAUUSD,Buy,2020-06-19 18:00:00,2020-06-22 04:00:00,1742.95,1758.45,0.1,154.13,15878.61,PT,,None,None,None,None
500_241023001_B,194,XAUUSD,Buy,2020-06-30 17:00:00,2020-07-01 13:00:00,1775.75,1781.1,0.1,52.61,15931.22,TrailingStop,,None,None,None,None
501_241023001_B,194,XAUUSD,Buy,2020-07-06 09:00:00,2020-07-07 10:00:00,1777.05,1780.24,0.1,31.01,15962.23,TrailingStop,,None,None,None,None
502_241023001_B,194,XAUUSD,Buy,2020-07-15 11:00:00,2020-07-16 19:00:00,1813.2,1802.01,0.1,-112.81,15849.42,SL,,None,None,None,None
504_241023001_B,194,XAUUSD,Buy,2020-08-17 15:00:00,2020-08-17 17:00:00,1962.08,1977.58,0.1,154.02,16003.44,PT,,None,None,None,None
506_241023001_B,194,XAUUSD,Buy,2020-08-24 15:00:00,2020-08-24 21:00:00,1955.13,1926.63,0.1,-285.98,15717.47,SL,,None,None,None,None
507_241023001_B,194,XAUUSD,Buy,2020-08-27 16:00:00,2020-08-27 16:00:00,1961.79,1942.27,0.1,-196.18,15521.29,SL,,None,None,None,None
509_241023001_B,194,XAUUSD,Buy,2020-09-08 20:00:00,2020-09-09 04:00:00,1941.27,1926.44,0.1,-149.27,15372.01,SL,,None,None,None,None
510_241023001_B,194,XAUUSD,Buy,2020-09-15 05:00:00,2020-09-15 16:00:00,1966.4,1961.99,0.1,-45.08,15326.93,TrailingStop,,None,None,None,None
513_241023001_B,194,XAUUSD,Buy,2020-09-28 16:00:00,2020-09-29 17:00:00,1875.08,1890.58,0.1,154.06,15480.99,PT,,None,None,None,None
514_241023001_B,194,XAUUSD,Buy,2020-10-05 17:00:00,2020-10-06 18:00:00,1916.98,1908.98,0.1,-80.96,15400.04,TrailingStop,,None,None,None,None
516_241023001_B,194,XAUUSD,Buy,2020-10-19 13:00:00,2020-10-19 22:00:00,1913.81,1900.85,0.1,-130.56,15269.48,SL,,None,None,None,None
517_241023001_B,194,XAUUSD,Buy,2020-10-21 05:00:00,2020-10-22 03:00:00,1918.34,1919.68,0.1,12.44,15281.92,TrailingStop,,None,None,None,None
523_241023001_B,194,XAUUSD,Buy,2020-12-02 10:00:00,2020-12-02 14:00:00,1818.09,1821.23,0.1,30.49,15312.41,TrailingStop,,None,None,None,None
524_241023001_B,194,XAUUSD,Buy,2020-12-07 16:00:00,2020-12-07 17:00:00,1848.09,1863.59,0.1,154.08,15466.49,PT,,None,None,None,None
526_241023001_B,194,XAUUSD,Buy,2020-12-28 01:00:00,2020-12-28 04:00:00,1884.24,1899.74,0.1,154.06,15620.54,PT,,None,None,None,None
529_241023001_B,194,XAUUSD,Buy,2021-01-20 16:00:00,2021-01-21 15:00:00,1862.89,1865.17,0.1,21.87,15642.41,TrailingStop,,None,None,None,None
531_241023001_B,194,XAUUSD,Buy,2021-01-28 16:00:00,2021-01-28 18:00:00,1861.64,1849.4,0.1,-123.33,15519.08,SL,,None,None,None,None
533_241023001_B,194,XAUUSD,Buy,2021-02-09 10:00:00,2021-02-09 16:00:00,1844.79,1838.31,0.1,-65.72,15453.36,TrailingStop,,None,None,None,None
537_241023001_B,194,XAUUSD,Buy,2021-03-16 17:00:00,2021-03-17 17:00:00,1739.74,1725.69,0.1,-141.37,15311.99,SL,,None,None,None,None
539_241023001_B,194,XAUUSD,Buy,2021-04-29 03:00:00,2021-04-29 09:00:00,1785.46,1782.73,0.1,-28.19,15283.8,TrailingStop,,None,None,None,None
540_241023001_B,194,XAUUSD,Buy,2021-05-06 16:00:00,2021-05-06 17:00:00,1798.88,1814.38,0.1,154.1,15437.9,PT,,None,None,None,None
541_241023001_B,194,XAUUSD,Buy,2021-05-14 23:00:00,2021-05-17 14:00:00,1845.3,1846.27,0.1,8.78,15446.67,TrailingStop,,None,None,None,None
542_241023001_B,194,XAUUSD,Buy,2021-05-20 05:00:00,2021-05-20 12:00:00,1874.85,1867.49,0.1,-74.54,15372.14,TrailingStop,,None,None,None,None
543_241023001_B,194,XAUUSD,Buy,2021-05-25 09:00:00,2021-05-26 04:00:00,1886.88,1902.38,0.1,154.06,15526.19,PT,,None,None,None,None
544_241023001_B,194,XAUUSD,Buy,2021-06-10 22:00:00,2021-06-11 11:00:00,1898.92,1894.67,0.1,-43.45,15482.75,TrailingStop,,None,None,None,None
546_241023001_B,194,XAUUSD,Buy,2021-07-02 15:00:00,2021-07-02 17:00:00,1790.27,1779.77,0.1,-105.9,15376.85,SL,,None,None,None,None
549_241023001_B,194,XAUUSD,Buy,2021-07-29 04:00:00,2021-07-29 14:00:00,1811.4,1826.9,0.1,154.09,15530.94,PT,,None,None,None,None
550_241023001_B,194,XAUUSD,Buy,2021-08-04 16:00:00,2021-08-04 17:00:00,1831.25,1820.82,0.1,-105.22,15425.73,SL,,None,None,None,None
551_241023001_B,194,XAUUSD,Buy,2021-08-23 05:00:00,2021-08-23 16:00:00,1788.28,1803.78,0.1,154.11,15579.83,PT,,None,None,None,None
552_241023001_B,194,XAUUSD,Buy,2021-08-27 17:00:00,2021-08-30 05:00:00,1809.47,1814.67,0.1,51.1,15630.93,TrailingStop,,None,None,None,None
554_241023001_B,194,XAUUSD,Buy,2021-09-14 17:00:00,2021-09-15 11:00:00,1803.75,1799.49,0.1,-43.5,15587.43,TrailingStop,,None,None,None,None
556_241023001_B,194,XAUUSD,Buy,2021-09-20 17:00:00,2021-09-22 09:00:00,1767.42,1777.66,0.1,101.52,15688.94,Exit After X Bars,,None,None,None,None
558_241023001_B,194,XAUUSD,Buy,2021-10-04 17:00:00,2021-10-05 05:00:00,1764.18,1761.7,0.1,-25.68,15663.26,TrailingStop,,None,None,None,None
559_241023001_B,194,XAUUSD,Buy,2021-10-13 16:00:00,2021-10-14 05:00:00,1781.23,1787.31,0.1,59.91,15723.17,TrailingStop,,None,None,None,None
562_241023001_B,194,XAUUSD,Buy,2021-11-04 16:00:00,2021-11-05 03:00:00,1796.29,1790.06,0.1,-63.2,15659.97,TrailingStop,,None,None,None,None
565_241023001_B,194,XAUUSD,Buy,2021-12-07 18:00:00,2021-12-08 13:00:00,1787.64,1785.27,0.1,-24.59,15635.38,TrailingStop,,None,None,None,None
567_241023001_B,194,XAUUSD,Buy,2021-12-16 16:00:00,2021-12-17 08:00:00,1791.46,1806.96,0.1,154.1,15789.48,PT,,None,None,None,None
569_241023001_B,194,XAUUSD,Buy,2021-12-31 09:00:00,2022-01-03 05:00:00,1820.1,1825.28,0.1,50.89,15840.37,TrailingStop,,None,None,None,None
573_241023001_B,194,XAUUSD,Buy,2022-01-19 15:00:00,2022-01-19 17:00:00,1823.09,1838.59,0.1,154.09,15994.46,PT,,None,None,None,None
574_241023001_B,194,XAUUSD,Buy,2022-01-25 16:00:00,2022-01-25 17:00:00,1847.8,1844.33,0.1,-35.62,15958.84,TrailingStop,,None,None,None,None
576_241023001_B,194,XAUUSD,Buy,2022-02-02 17:00:00,2022-02-03 09:00:00,1808.64,1804.15,0.1,-45.8,15913.03,TrailingStop,,None,None,None,None
577_241023001_B,194,XAUUSD,Buy,2022-02-10 17:00:00,2022-02-10 19:00:00,1835.71,1836.33,0.1,5.28,15918.32,TrailingStop,,None,None,None,None
578_241023001_B,194,XAUUSD,Buy,2022-02-17 05:00:00,2022-02-17 10:00:00,1874.02,1889.52,0.1,154.06,16072.38,PT,,None,None,None,None
581_241023001_B,194,XAUUSD,Buy,2022-03-24 14:00:00,2022-03-24 15:00:00,1949.75,1947.22,0.1,-26.27,16046.1,TrailingStop,,None,None,None,None
583_241023001_B,194,XAUUSD,Buy,2022-04-08 17:00:00,2022-04-11 14:00:00,1944.46,1959.96,0.1,154.03,16200.13,PT,,None,None,None,None
588_241023001_B,194,XAUUSD,Buy,2022-05-19 15:00:00,2022-05-20 05:00:00,1836.0,1836.81,0.1,7.18,16207.31,TrailingStop,,None,None,None,None
590_241023001_B,194,XAUUSD,Buy,2022-06-02 16:00:00,2022-06-03 07:00:00,1863.88,1866.64,0.1,26.67,16233.98,TrailingStop,,None,None,None,None
591_241023001_B,194,XAUUSD,Buy,2022-06-22 15:00:00,2022-06-22 16:00:00,1846.0,1836.14,0.1,-99.52,16134.46,SL,,None,None,None,None
595_241023001_B,194,XAUUSD,Buy,2022-07-08 17:00:00,2022-07-11 10:00:00,1749.01,1737.12,0.1,-119.77,16014.68,SL,,None,None,None,None
596_241023001_B,194,XAUUSD,Buy,2022-07-21 18:00:00,2022-07-22 16:00:00,1718.32,1733.82,0.1,154.14,16168.83,PT,,None,None,None,None
597_241023001_B,194,XAUUSD,Buy,2022-07-27 21:00:00,2022-07-28 13:00:00,1736.17,1738.78,0.1,25.23,16194.06,TrailingStop,,None,None,None,None
598_241023001_B,194,XAUUSD,Buy,2022-08-04 15:00:00,2022-08-05 11:00:00,1787.93,1787.11,0.1,-9.09,16184.96,TrailingStop,,None,None,None,None
602_241023001_B,194,XAUUSD,Buy,2022-09-07 20:00:00,2022-09-08 15:00:00,1715.67,1717.22,0.1,14.64,16199.61,TrailingStop,,None,None,None,None
605_241023001_B,194,XAUUSD,Buy,2022-10-24 01:00:00,2022-10-24 05:00:00,1660.71,1652.74,0.1,-80.53,16119.08,TrailingStop,,None,None,None,None
606_241023001_B,194,XAUUSD,Buy,2022-10-26 10:00:00,2022-10-26 15:00:00,1670.75,1665.03,0.1,-58.04,16061.04,TrailingStop,,None,None,None,None
607_241023001_B,194,XAUUSD,Buy,2022-11-04 17:00:00,2022-11-07 01:00:00,1669.26,1672.72,0.1,33.77,16094.8,TrailingStop,,None,None,None,None
608_241023001_B,194,XAUUSD,Buy,2022-11-08 17:00:00,2022-11-08 17:00:00,1681.76,1697.26,0.1,154.16,16248.96,PT,,None,None,None,None
610_241023001_B,194,XAUUSD,Buy,2022-11-23 21:00:00,2022-11-25 09:00:00,1749.6,1753.39,0.1,37.03,16285.99,TrailingStop,,None,None,None,None
611_241023001_B,194,XAUUSD,Buy,2022-11-28 10:00:00,2022-11-28 14:00:00,1758.47,1754.55,0.1,-40.08,16245.91,TrailingStop,,None,None,None,None
612_241023001_B,194,XAUUSD,Buy,2022-12-13 15:00:00,2022-12-13 16:00:00,1806.0,1821.5,0.1,154.1,16400.01,PT,,None,None,None,None
613_241023001_B,194,XAUUSD,Buy,2022-12-20 17:00:00,2022-12-22 09:00:00,1814.04,1814.59,0.1,4.59,16404.6,Exit After X Bars,,None,None,None,None
614_241023001_B,194,XAUUSD,Buy,2022-12-27 17:00:00,2022-12-27 19:00:00,1823.69,1817.96,0.1,-58.21,16346.39,TrailingStop,,None,None,None,None
615_241023001_B,194,XAUUSD,Buy,2023-01-03 04:00:00,2023-01-03 09:00:00,1833.22,1848.72,0.1,154.08,16500.47,PT,,None,None,None,None
616_241023001_B,194,XAUUSD,Buy,2023-01-06 19:00:00,2023-01-09 09:00:00,1865.04,1880.54,0.1,154.07,16654.54,PT,,None,None,None,None
617_241023001_B,194,XAUUSD,Buy,2023-01-12 03:00:00,2023-01-12 15:00:00,1880.64,1880.56,0.1,-1.74,16652.8,TrailingStop,,None,None,None,None
618_241023001_B,194,XAUUSD,Buy,2023-01-19 21:00:00,2023-01-20 06:00:00,1928.89,1925.66,0.1,-33.26,16619.54,TrailingStop,,None,None,None,None
619_241023001_B,194,XAUUSD,Buy,2023-01-24 04:00:00,2023-01-24 15:00:00,1937.44,1932.87,0.1,-46.67,16572.87,TrailingStop,,None,None,None,None
620_241023001_B,194,XAUUSD,Buy,2023-02-01 21:00:00,2023-02-01 22:00:00,1934.43,1949.93,0.1,154.03,16726.9,PT,,None,None,None,None
623_241023001_B,194,XAUUSD,Buy,2023-03-10 16:00:00,2023-03-10 18:00:00,1858.17,1856.42,0.1,-18.43,16708.47,TrailingStop,,None,None,None,None
626_241023001_B,194,XAUUSD,Buy,2023-03-30 15:00:00,2023-03-31 10:00:00,1974.22,1976.1,0.1,17.81,16726.28,TrailingStop,,None,None,None,None
627_241023001_B,194,XAUUSD,Buy,2023-04-03 17:00:00,2023-04-04 04:00:00,1987.49,1979.0,0.1,-85.89,16640.39,TrailingStop,,None,None,None,None
628_241023001_B,194,XAUUSD,Buy,2023-04-13 15:00:00,2023-04-13 17:00:00,2031.97,2047.47,0.1,153.98,16794.37,PT,,None,None,None,None
630_241023001_B,194,XAUUSD,Buy,2023-05-02 17:00:00,2023-05-03 15:00:00,2009.2,2010.81,0.1,15.1,16809.47,TrailingStop,,None,None,None,None
633_241023001_B,194,XAUUSD,Buy,2023-05-24 14:00:00,2023-05-24 17:00:00,1982.51,1970.53,0.1,-120.79,16688.68,SL,,None,None,None,None
635_241023001_B,194,XAUUSD,Buy,2023-05-30 12:00:00,2023-05-30 16:00:00,1949.58,1953.39,0.1,37.13,16725.8,TrailingStop,,None,None,None,None
639_241023001_B,194,XAUUSD,Buy,2023-06-15 17:00:00,2023-06-16 16:00:00,1960.21,1958.59,0.1,-17.18,16708.62,TrailingStop,,None,None,None,None
643_241023001_B,194,XAUUSD,Buy,2023-07-07 18:00:00,2023-07-10 07:00:00,1934.91,1921.06,0.1,-139.47,16569.15,SL,,None,None,None,None
644_241023001_B,194,XAUUSD,Buy,2023-07-18 10:00:00,2023-07-18 17:00:00,1963.59,1979.09,0.1,154.02,16723.17,PT,,None,None,None,None
649_241023001_B,194,XAUUSD,Buy,2023-08-21 15:00:00,2023-08-21 16:00:00,1896.68,1892.05,0.1,-47.25,16675.92,TrailingStop,,None,None,None,None
652_241023001_B,194,XAUUSD,Buy,2023-09-15 17:00:00,2023-09-15 22:00:00,1930.56,1923.59,0.1,-70.67,16605.26,SL,,None,None,None,None
653_241023001_B,194,XAUUSD,Buy,2023-09-20 16:00:00,2023-09-20 21:00:00,1937.28,1942.41,0.1,50.33,16655.59,TrailingStop,,None,None,None,None
655_241023001_B,194,XAUUSD,Buy,2023-10-06 17:00:00,2023-10-09 01:00:00,1829.11,1847.41,0.1,182.04,16837.63,PT,,None,None,None,None
658_241023001_B,194,XAUUSD,Buy,2023-11-21 05:00:00,2023-11-21 18:00:00,1993.34,1998.79,0.1,53.5,16891.13,TrailingStop,,None,None,None,None
659_241023001_B,194,XAUUSD,Buy,2023-12-01 17:00:00,2023-12-01 19:00:00,2051.86,2067.36,0.1,153.97,17045.1,PT,,None,None,None,None
661_241023001_B,194,XAUUSD,Buy,2023-12-13 21:00:00,2023-12-13 21:00:00,1996.63,2012.13,0.1,154,17199.11,PT,,None,None,None,None
662_241023001_B,194,XAUUSD,Buy,2023-12-22 01:00:00,2023-12-22 14:00:00,2049.01,2063.28,0.1,141.64,17340.74,PT,,None,None,None,None
664_241023001_B,194,XAUUSD,Buy,2024-01-05 17:00:00,2024-01-05 18:00:00,2050.86,2047.51,0.1,-34.53,17306.21,TrailingStop,,None,None,None,None
665_241023001_B,194,XAUUSD,Buy,2024-01-11 15:00:00,2024-01-11 15:00:00,2041.9,2030.65,0.1,-113.52,17192.69,SL,,None,None,None,None
672_241023001_B,194,XAUUSD,Buy,2024-02-29 15:00:00,2024-02-29 23:00:00,2039.38,2043.09,0.1,36.08,17228.77,TrailingStop,,None,None,None,None
674_241023001_B,194,XAUUSD,Buy,2024-03-20 21:00:00,2024-03-20 22:00:00,2172.61,2188.11,0.1,153.91,17382.69,PT,,None,None,None,None
675_241023001_B,194,XAUUSD,Buy,2024-03-28 19:00:00,2024-04-01 01:00:00,2222.88,2238.44,0.1,154.44,17537.13,PT,,None,None,None,None
676_241023001_B,194,XAUUSD,Buy,2024-04-05 17:00:00,2024-04-05 18:00:00,2305.43,2320.93,0.1,153.85,17690.97,PT,,None,None,None,None
677_241023001_B,194,XAUUSD,Buy,2024-04-11 21:00:00,2024-04-12 04:00:00,2365.19,2380.69,0.1,153.82,17844.79,PT,,None,None,None,None
679_241023001_B,194,XAUUSD,Buy,2024-04-25 17:00:00,2024-04-26 16:00:00,2337.13,2336.97,0.1,-2.77,17842.02,TrailingStop,,None,None,None,None
681_241023001_B,194,XAUUSD,Buy,2024-05-09 17:00:00,2024-05-09 23:00:00,2329.79,2345.29,0.1,153.84,17995.86,PT,,None,None,None,None
682_241023001_B,194,XAUUSD,Buy,2024-05-15 15:00:00,2024-05-15 16:00:00,2378.36,2361.24,0.1,-172.39,17823.47,SL,,None,None,None,None
686_241023001_B,194,XAUUSD,Buy,2024-06-18 20:00:00,2024-06-20 11:00:00,2332.49,2335.83,0.1,32.23,17855.7,TrailingStop,,None,None,None,None
687_241023001_B,194,XAUUSD,Buy,2024-07-03 09:00:00,2024-07-03 15:00:00,2339.64,2355.14,0.1,153.83,18009.53,PT,,None,None,None,None
689_241023001_B,194,XAUUSD,Buy,2024-08-16 15:00:00,2024-08-16 16:00:00,2476.84,2492.34,0.1,153.76,18163.29,PT,,None,None,None,None
690_241023001_B,194,XAUUSD,Buy,2024-08-28 02:00:00,2024-08-28 07:00:00,2526.71,2512.82,0.1,-140.16,18023.13,SL,,None,None,None,None
691_241023001_B,194,XAUUSD,Buy,2024-09-05 09:00:00,2024-09-05 15:00:00,2507.13,2522.63,0.1,153.75,18176.88,PT,,None,None,None,None
692_241023001_B,194,XAUUSD,Buy,2024-09-18 21:00:00,2024-09-18 22:00:00,2589.51,2568.96,0.1,-206.79,17970.08,SL,,None,None,None,None
693_241023001_B,194,XAUUSD,Buy,2024-10-04 05:00:00,2024-10-04 12:00:00,2663.19,2657.42,0.1,-59.03,17911.05,TrailingStop,,None,None,None,None
694_241023001_B,194,XAUUSD,Buy,2024-10-11 18:00:00,2024-10-11 23:00:00,2659.47,2656.83,0.1,-27.68,17883.37,EndTest,,None,None,None,None
